nid,Is,Os,S,V,D
0,28,28,56,0.7384632415714754,"[1, 1, 0, 0, 0, 0, 0, 0, 0, 0]"
1,8,8,16,0.2084882885902951,"[0, 1, 1, 0, 0, 0, 0, 0, 0, 0]"
2,12,12,24,0.6096303655672743,"[0, 0, 1, 1, 0, 0, 0, 0, 0, 0]"
3,8,8,16,0.19790757372088907,"[0, 0, 0, 1, 1, 0, 0, 0, 0, 0]"
4,11,11,22,0.4283634638757017,"[0, 0, 0, 0, 1, 1, 0, 0, 0, 0]"
5,13,13,26,0.6732674779341131,"[0, 0, 0, 0, 0, 1, 1, 0, 0, 0]"
6,17,17,34,0.4508450564847951,"[0, 0, 0, 0, 0, 0, 1, 1, 0, 0]"
7,3,3,6,0.5406070154119789,"[0, 0, 0, 0, 0, 0, 0, 1, 1, 0]"
8,4,4,8,0.7491926621231401,"[0, 0, 0, 0, 0, 0, 0, 0, 1, 1]"
9,281,281,562,0.9792193045943272,"[0, 1, 1, 0, 0, 1, 1, 1, 0, 1]"
10,4,4,8,0.23745018286035957,"[1, 1, 1, 1, 0, 0, 0, 0, 0, 0]"
11,3,3,6,0.29159226289918905,"[1, 1, 0, 0, 0, 0, 0, 0, 0, 0]"
12,63,63,126,0.6545626586760066,"[1, 0, 0, 0, 1, 0, 0, 1, 1, 0]"
13,14,14,28,0.13442190098926288,"[0, 0, 1, 1, 0, 1, 1, 0, 0, 0]"
14,19,19,38,0.7993274213418703,"[0, 0, 0, 0, 1, 1, 0, 0, 1, 0]"
15,127,127,254,0.7254116900013935,"[1, 1, 1, 1, 1, 1, 1, 1, 0, 1]"
16,11,11,22,0.26353758154905216,"[0, 0, 0, 1, 0, 0, 1, 1, 1, 0]"
17,1,1,2,0.40918608218914165,"[1, 1, 0, 1, 0, 1, 0, 0, 0, 0]"
18,163,163,326,0.8950183880744974,"[0, 1, 1, 1, 1, 1, 1, 0, 0, 1]"
19,17,17,34,0.2561448414754218,"[0, 0, 0, 1, 1, 0, 1, 0, 0, 0]"
20,14,14,28,0.3999175547721816,"[0, 1, 0, 0, 0, 1, 1, 1, 1, 1]"
21,3,3,6,0.43926578022654994,"[0, 0, 1, 0, 1, 0, 0, 0, 0, 0]"
22,5,5,10,0.2195488941425664,"[1, 0, 1, 1, 0, 0, 1, 0, 1, 1]"
23,378,378,756,0.862179759502663,"[1, 1, 1, 1, 0, 1, 0, 1, 1, 1]"
24,144,144,288,0.7991304027134857,"[1, 1, 1, 1, 0, 0, 1, 1, 1, 1]"
25,9,9,18,0.6660671081984699,"[0, 1, 1, 1, 1, 0, 0, 1, 0, 0]"
26,13,13,26,0.23538755330186412,"[0, 0, 0, 0, 1, 1, 1, 1, 0, 0]"
27,2,2,4,0.41470398627141425,"[1, 0, 0, 0, 0, 1, 1, 1, 1, 0]"
28,19,19,38,0.5747534841892974,"[1, 0, 1, 1, 0, 1, 1, 1, 0, 0]"
29,25,25,50,0.7901491052359213,"[1, 0, 1, 0, 1, 1, 0, 0, 1, 0]"
30,13,13,26,0.5006629170752642,"[1, 0, 0, 1, 0, 0, 0, 1, 1, 0]"
31,14,14,28,0.9599863842818628,"[0, 1, 0, 1, 1, 1, 0, 0, 1, 0]"
32,157,157,314,0.9721190576882707,"[1, 0, 1, 0, 1, 1, 1, 0, 1, 1]"
33,67,67,134,0.5146477087636577,"[0, 1, 0, 0, 1, 1, 1, 1, 0, 1]"
34,9,9,18,0.603431397139381,"[1, 0, 1, 0, 0, 1, 1, 0, 0, 1]"
35,1,1,2,0.01579149652343048,"[0, 0, 0, 0, 0, 0, 0, 0, 1, 0]"
36,14,14,28,0.4088199207073494,"[0, 0, 1, 1, 0, 0, 0, 1, 1, 1]"
37,102,102,204,0.030233280553165653,"[1, 1, 1, 0, 1, 1, 1, 1, 1, 0]"
38,59,59,118,0.03621167750052412,"[0, 1, 0, 0, 1, 1, 0, 1, 1, 1]"
39,7,7,14,0.25658595934627426,"[0, 0, 1, 1, 0, 0, 0, 0, 0, 0]"
40,12,12,24,0.315082512073649,"[0, 0, 1, 1, 0, 0, 1, 0, 1, 0]"
41,3,3,6,0.8441924144298152,"[0, 1, 0, 0, 0, 1, 1, 1, 0, 0]"
42,1,1,2,0.5774925876909782,"[0, 1, 0, 1, 0, 1, 0, 1, 0, 1]"
43,48,48,96,0.7981954873018564,"[1, 1, 1, 0, 1, 1, 1, 0, 1, 0]"
44,120,120,240,0.30325187826373523,"[0, 1, 1, 1, 1, 1, 1, 0, 0, 1]"
45,5,5,10,0.4959667007390143,"[1, 1, 1, 1, 0, 0, 1, 1, 0, 0]"
46,20,20,40,0.8160238493601578,"[1, 1, 1, 0, 1, 0, 0, 0, 0, 0]"
47,109,109,218,0.18510823772309415,"[1, 0, 0, 1, 1, 1, 1, 1, 1, 1]"
48,5,5,10,0.5953780833157842,"[1, 1, 0, 0, 0, 0, 0, 0, 0, 0]"
49,2,2,4,0.9565665669551731,"[1, 1, 1, 0, 1, 1, 1, 1, 0, 0]"
50,13,13,26,0.6503018287384935,"[1, 0, 0, 1, 1, 0, 0, 0, 0, 0]"
51,29,29,58,0.9198497624766901,"[1, 1, 1, 0, 1, 0, 0, 1, 0, 1]"
52,4,4,8,0.9624716531448194,"[1, 1, 0, 1, 0, 0, 0, 1, 0, 0]"
53,1,1,2,0.6072756637722585,"[0, 1, 1, 1, 0, 1, 0, 0, 1, 0]"
54,2,2,4,0.824278225409543,"[0, 1, 0, 0, 0, 0, 0, 0, 1, 0]"
55,31,31,62,0.07425341551475373,"[1, 0, 1, 0, 1, 0, 0, 0, 0, 1]"
56,42,42,84,0.028170113703682054,"[0, 1, 0, 0, 1, 1, 0, 1, 1, 0]"
57,138,138,276,0.8783569000215924,"[0, 0, 0, 0, 1, 1, 1, 1, 1, 1]"
58,2,2,4,0.3201594060594223,"[1, 0, 0, 1, 0, 0, 0, 1, 0, 1]"
59,13,13,26,0.32356263018976905,"[1, 1, 0, 1, 0, 1, 0, 1, 1, 0]"
60,1,1,2,0.221569909187467,"[0, 1, 0, 0, 0, 0, 0, 0, 0, 1]"
61,3,3,6,0.030388101610509977,"[1, 0, 0, 1, 1, 1, 0, 1, 1, 1]"
62,1,1,2,0.7009241155690543,"[0, 0, 1, 0, 0, 1, 0, 0, 1, 1]"
63,10,10,20,0.42180456958972,"[1, 0, 0, 1, 0, 1, 0, 1, 1, 0]"
64,15,15,30,0.4904876669191963,"[1, 1, 0, 0, 0, 1, 1, 0, 0, 0]"
65,7,7,14,0.9413496313221353,"[0, 0, 0, 0, 0, 0, 1, 0, 1, 0]"
66,15,15,30,0.9711548458958614,"[1, 0, 1, 1, 0, 0, 1, 1, 1, 0]"
67,29,29,58,0.5685392693714745,"[1, 0, 1, 1, 1, 0, 1, 1, 0, 0]"
68,2,2,4,0.879689094585636,"[1, 0, 0, 0, 0, 0, 0, 1, 0, 0]"
69,74,74,148,0.04780831470088165,"[1, 1, 1, 1, 1, 0, 0, 1, 1, 0]"
70,4,4,8,0.25039488911443286,"[0, 1, 0, 1, 1, 1, 1, 1, 0, 0]"
71,6,6,12,0.34217742587675937,"[0, 0, 0, 1, 1, 1, 1, 1, 1, 1]"
72,4,4,8,0.30714761488900344,"[0, 0, 1, 1, 0, 0, 0, 1, 1, 0]"
73,9,9,18,0.2128432321216771,"[1, 0, 1, 1, 0, 1, 1, 0, 0, 0]"
74,54,54,108,0.9694543887122927,"[0, 1, 1, 1, 0, 1, 1, 0, 0, 1]"
75,27,27,54,0.3657582062976925,"[1, 0, 1, 1, 1, 1, 1, 1, 0, 0]"
76,3,3,6,0.0027993246549888884,"[0, 0, 1, 1, 0, 1, 0, 1, 0, 1]"
77,14,14,28,0.29058029136950003,"[0, 1, 1, 1, 0, 0, 0, 0, 1, 1]"
78,1,1,2,0.8073692936943926,"[0, 0, 0, 1, 1, 0, 1, 0, 0, 0]"
79,1,1,2,0.9449176420669202,"[1, 1, 1, 0, 1, 0, 0, 1, 1, 1]"
80,1,1,2,0.1916064205542487,"[0, 0, 0, 0, 0, 1, 1, 1, 0, 0]"
81,34,34,68,0.0639260665928969,"[1, 1, 1, 0, 1, 0, 1, 0, 1, 1]"
82,36,36,72,0.49832499004354447,"[1, 0, 0, 1, 1, 0, 1, 0, 1, 0]"
83,28,28,56,0.5638569291742724,"[0, 0, 1, 1, 0, 1, 1, 0, 1, 0]"
84,30,30,60,0.39891561539827636,"[1, 0, 1, 1, 0, 0, 1, 1, 0, 0]"
85,2,2,4,0.5201109635232071,"[0, 1, 0, 1, 0, 1, 1, 0, 0, 1]"
86,1,1,2,0.9040320200169933,"[1, 1, 0, 1, 1, 0, 0, 0, 0, 1]"
87,1,1,2,0.9968023035403573,"[0, 0, 0, 0, 1, 1, 0, 0, 0, 1]"
88,129,129,258,0.2895028350722971,"[0, 0, 1, 0, 1, 1, 1, 1, 1, 1]"
89,8,8,16,0.3695051199062631,"[0, 0, 1, 0, 0, 0, 1, 0, 1, 1]"
90,3,3,6,0.7540358792072126,"[0, 0, 1, 0, 0, 0, 0, 1, 1, 0]"
91,185,185,370,0.4629332390603207,"[0, 1, 1, 1, 1, 1, 1, 1, 0, 1]"
92,2,2,4,0.2112016707550416,"[1, 1, 0, 1, 0, 0, 1, 0, 0, 0]"
93,56,56,112,0.2144080032646708,"[1, 1, 0, 1, 0, 1, 0, 1, 1, 1]"
94,32,32,64,0.9037478609843681,"[1, 1, 1, 0, 1, 0, 1, 1, 1, 0]"
95,37,37,74,0.3682490746566369,"[1, 1, 1, 0, 1, 1, 0, 1, 1, 0]"
96,17,17,34,0.04791271465915725,"[1, 1, 1, 1, 0, 0, 1, 0, 1, 1]"
97,65,65,130,0.6337969976650719,"[0, 1, 1, 1, 0, 0, 0, 1, 0, 1]"
98,32,32,64,0.21776127984244686,"[1, 1, 1, 0, 0, 1, 1, 0, 1, 1]"
99,1,1,2,0.4212963449571697,"[0, 1, 0, 0, 1, 0, 1, 1, 0, 0]"
100,1,1,2,0.5004124960045101,"[1, 0, 0, 1, 0, 0, 0, 0, 0, 0]"
101,6,6,12,0.48802029982199735,"[1, 0, 1, 1, 0, 1, 0, 0, 0, 0]"
102,4,4,8,0.23038187443767966,"[1, 1, 1, 0, 0, 1, 0, 1, 1, 1]"
103,4,4,8,0.3586271273575087,"[1, 1, 0, 1, 1, 1, 0, 1, 0, 1]"
104,3,3,6,0.6833841887302162,"[0, 0, 1, 0, 0, 0, 1, 0, 0, 1]"
105,56,56,112,0.3188994843592662,"[1, 0, 1, 0, 0, 1, 0, 1, 1, 1]"
106,19,19,38,0.46436168585711446,"[0, 0, 0, 1, 1, 1, 1, 1, 0, 0]"
107,2,2,4,0.3171518405445073,"[0, 0, 0, 0, 0, 0, 1, 0, 1, 1]"
108,35,35,70,0.4536663080567548,"[1, 0, 1, 1, 1, 1, 1, 0, 1, 0]"
109,2,2,4,0.3040624601253087,"[0, 0, 0, 1, 1, 1, 0, 0, 0, 0]"
110,8,8,16,0.20258297934794822,"[0, 0, 0, 1, 1, 1, 1, 1, 0, 0]"
111,97,97,194,0.483142422373933,"[0, 1, 1, 1, 1, 0, 1, 0, 1, 1]"
112,26,26,52,0.8512137492088525,"[1, 0, 0, 0, 1, 1, 1, 1, 1, 1]"
113,10,10,20,0.9635269569369329,"[1, 0, 1, 1, 1, 1, 1, 1, 0, 0]"
114,21,21,42,0.36039789792366483,"[1, 1, 1, 0, 0, 1, 0, 0, 1, 1]"
115,1,1,2,0.13617973023060725,"[0, 1, 0, 0, 0, 0, 0, 0, 0, 0]"
116,9,9,18,0.011580341434636487,"[0, 1, 0, 0, 0, 1, 0, 1, 1, 0]"
117,3,3,6,0.7038896285830298,"[1, 0, 1, 1, 0, 0, 0, 1, 0, 0]"
118,3,3,6,0.345610560106579,"[1, 1, 1, 0, 1, 1, 1, 0, 0, 0]"
119,79,79,158,0.40797752373662755,"[1, 1, 1, 1, 1, 1, 1, 1, 0, 0]"
120,4,4,8,0.19673386248946823,"[0, 1, 1, 1, 0, 0, 1, 0, 0, 1]"
121,1,1,2,0.7901341200621723,"[0, 0, 0, 0, 0, 0, 0, 0, 0, 1]"
122,10,10,20,0.360256337358814,"[1, 1, 1, 1, 1, 1, 1, 0, 1, 1]"
123,1,1,2,0.1002424439181534,"[0, 0, 1, 1, 0, 1, 1, 1, 1, 0]"
124,2,2,4,0.02996207251748717,"[1, 1, 1, 0, 0, 0, 1, 0, 1, 0]"
125,80,80,160,0.1503816298881291,"[0, 1, 0, 0, 1, 0, 1, 0, 1, 1]"
126,15,15,30,0.21007892499392322,"[1, 1, 0, 1, 0, 1, 1, 0, 1, 0]"
127,12,12,24,0.06750419438553579,"[0, 1, 1, 1, 1, 1, 0, 0, 0, 1]"
128,89,89,178,0.08370295026568686,"[1, 1, 0, 1, 0, 1, 1, 1, 1, 1]"
129,20,20,40,0.3024164800162328,"[1, 0, 0, 1, 1, 1, 1, 1, 1, 0]"
130,7,7,14,0.06228360866009908,"[1, 1, 0, 1, 1, 0, 1, 1, 0, 1]"
131,6,6,12,0.2994485762586552,"[0, 1, 1, 0, 1, 0, 0, 1, 1, 0]"
132,7,7,14,0.8313666468011327,"[0, 1, 1, 0, 1, 1, 1, 1, 0, 1]"
133,1,1,2,0.8692766275102869,"[1, 0, 1, 0, 0, 0, 0, 0, 0, 0]"
134,7,7,14,0.9465176960411761,"[0, 1, 0, 1, 0, 0, 1, 0, 0, 0]"
135,20,20,40,0.26050079124152004,"[1, 1, 0, 1, 0, 1, 1, 0, 0, 1]"
136,10,10,20,0.8820585260739424,"[1, 1, 0, 0, 0, 1, 0, 0, 0, 1]"
137,1,1,2,0.7399937825266221,"[0, 0, 0, 0, 1, 0, 0, 1, 0, 1]"
138,1,1,2,0.7012592615606335,"[0, 0, 1, 0, 0, 1, 1, 0, 1, 1]"
139,1,1,2,0.6843232673730222,"[0, 0, 0, 1, 0, 0, 1, 0, 0, 1]"
140,8,8,16,0.05659494099901774,"[1, 1, 0, 1, 0, 1, 1, 1, 1, 0]"
141,36,36,72,0.5072254482242842,"[0, 1, 1, 1, 0, 0, 1, 1, 1, 0]"
142,3,3,6,0.6998714750776698,"[1, 1, 0, 1, 1, 0, 1, 1, 1, 1]"
143,1,1,2,0.40073614498314103,"[0, 0, 0, 0, 0, 0, 0, 0, 0, 1]"
144,26,26,52,0.038560885156807445,"[0, 0, 1, 1, 0, 1, 1, 1, 1, 1]"
145,7,7,14,0.8251928687177551,"[0, 1, 1, 1, 1, 1, 0, 0, 0, 1]"
146,19,19,38,0.14931668098266349,"[1, 1, 1, 0, 0, 1, 1, 0, 0, 1]"
147,8,8,16,0.1878103005776275,"[1, 0, 1, 1, 0, 0, 1, 0, 0, 1]"
148,25,25,50,0.2790022511385657,"[1, 1, 1, 0, 1, 1, 1, 1, 1, 0]"
149,2,2,4,0.1020376820138521,"[0, 0, 0, 0, 0, 1, 0, 0, 1, 1]"
150,5,5,10,0.3380982455973818,"[0, 1, 1, 1, 0, 1, 1, 1, 0, 0]"
151,4,4,8,0.47557214812845483,"[0, 1, 0, 1, 0, 0, 0, 1, 1, 0]"
152,2,2,4,0.035575500643752256,"[0, 0, 1, 0, 1, 0, 0, 1, 0, 1]"
153,3,3,6,0.7664738717513204,"[0, 0, 1, 1, 1, 1, 1, 1, 0, 1]"
154,7,7,14,0.5557167808834181,"[1, 0, 1, 0, 0, 0, 0, 1, 0, 0]"
155,1,1,2,0.09477884244967871,"[1, 1, 0, 0, 0, 0, 1, 0, 0, 1]"
156,6,6,12,0.11135227279056459,"[1, 0, 0, 1, 0, 1, 0, 1, 1, 0]"
157,13,13,26,0.485338052321197,"[1, 0, 1, 0, 0, 1, 0, 0, 1, 1]"
158,2,2,4,0.17187055903779525,"[1, 1, 0, 1, 1, 0, 1, 0, 1, 1]"
159,7,7,14,0.6198934204947059,"[1, 1, 1, 0, 0, 0, 0, 1, 0, 0]"
160,19,19,38,0.5704371663254797,"[1, 0, 1, 0, 1, 1, 0, 1, 1, 1]"
161,19,19,38,0.039596262727156106,"[0, 1, 1, 1, 0, 1, 1, 1, 0, 0]"
162,1,1,2,0.5536955421149309,"[1, 1, 0, 1, 1, 0, 1, 0, 0, 0]"
163,22,22,44,0.8944679027118023,"[1, 1, 1, 1, 1, 1, 1, 0, 0, 0]"
164,4,4,8,0.17723521194631642,"[1, 0, 1, 1, 0, 1, 0, 0, 0, 0]"
165,14,14,28,0.18514003026718562,"[0, 0, 0, 1, 0, 0, 0, 0, 1, 1]"
166,5,5,10,0.682915065136333,"[1, 0, 0, 1, 1, 0, 0, 1, 0, 1]"
167,4,4,8,0.563062560547224,"[0, 0, 0, 1, 1, 0, 0, 1, 1, 0]"
168,9,9,18,0.5255980383362705,"[1, 1, 0, 1, 1, 1, 1, 0, 1, 1]"
169,2,2,4,0.3963149439705874,"[0, 0, 0, 0, 1, 0, 1, 1, 0, 0]"
170,1,1,2,0.19658197610246642,"[0, 0, 0, 0, 1, 0, 0, 1, 0, 1]"
171,6,6,12,0.353557939022603,"[0, 0, 1, 0, 0, 0, 0, 1, 0, 1]"
172,4,4,8,0.6352928463093869,"[0, 0, 0, 1, 0, 0, 1, 1, 0, 1]"
173,9,9,18,0.750900259392348,"[1, 1, 0, 1, 1, 0, 1, 1, 0, 0]"
174,3,3,6,0.4742707895625047,"[0, 0, 1, 1, 1, 1, 1, 1, 1, 0]"
175,21,21,42,0.24725063676128622,"[1, 1, 0, 0, 1, 0, 1, 1, 0, 1]"
176,8,8,16,0.978159835400827,"[0, 0, 1, 1, 1, 0, 1, 0, 0, 0]"
177,3,3,6,0.6793271458482538,"[1, 0, 1, 1, 0, 1, 0, 0, 1, 0]"
178,58,58,116,0.931754182877623,"[1, 1, 0, 1, 1, 1, 0, 0, 1, 0]"
179,3,3,6,0.41528044790386365,"[0, 0, 1, 1, 1, 1, 0, 0, 0, 0]"
180,18,18,36,0.02449118140900841,"[0, 1, 0, 1, 1, 0, 1, 1, 0, 0]"
181,5,5,10,0.3027230235283698,"[0, 1, 0, 1, 0, 0, 1, 0, 0, 0]"
182,5,5,10,0.5534353705216213,"[0, 1, 0, 1, 1, 0, 0, 1, 1, 0]"
183,11,11,22,0.9130487023413194,"[0, 1, 1, 1, 1, 1, 1, 1, 0, 1]"
184,2,2,4,0.7018081366366962,"[0, 1, 0, 0, 0, 1, 0, 1, 1, 0]"
185,19,19,38,0.7038175529044872,"[0, 1, 0, 0, 1, 0, 0, 0, 1, 1]"
186,3,3,6,0.7819989156260839,"[0, 0, 0, 1, 1, 1, 0, 0, 0, 0]"
187,6,6,12,0.7588750428604141,"[0, 0, 1, 1, 1, 1, 0, 1, 1, 1]"
188,26,26,52,0.33101694136040416,"[1, 1, 1, 0, 0, 1, 1, 0, 0, 0]"
189,4,4,8,0.5822587883179653,"[1, 1, 0, 0, 0, 0, 0, 0, 0, 1]"
190,38,38,76,0.7607787258554558,"[1, 1, 0, 1, 1, 1, 0, 1, 1, 1]"
191,38,38,76,0.9588017986421725,"[1, 0, 1, 0, 0, 1, 1, 1, 0, 1]"
192,8,8,16,0.8852169257827471,"[0, 1, 1, 0, 0, 1, 0, 0, 1, 0]"
193,21,21,42,0.10329058740888009,"[0, 0, 1, 0, 0, 1, 1, 1, 1, 1]"
194,1,1,2,0.916226310343342,"[0, 1, 0, 0, 0, 0, 0, 0, 0, 1]"
195,2,2,4,0.8971851057789934,"[0, 1, 0, 0, 1, 0, 1, 0, 0, 1]"
196,10,10,20,0.3050362222080284,"[1, 1, 1, 0, 0, 0, 0, 0, 1, 1]"
197,3,3,6,0.17632441182861758,"[0, 1, 1, 1, 0, 1, 0, 1, 1, 0]"
198,1,1,2,0.5862003338983683,"[1, 1, 1, 0, 0, 0, 1, 0, 1, 0]"
199,7,7,14,0.14992189434921732,"[0, 1, 1, 1, 0, 0, 1, 1, 0, 1]"
200,10,10,20,0.39301961177177425,"[1, 1, 0, 1, 1, 0, 0, 0, 0, 0]"
201,7,7,14,0.6925626872104905,"[0, 1, 0, 1, 1, 0, 0, 0, 1, 1]"
202,10,10,20,0.47046373382770157,"[1, 1, 0, 0, 0, 1, 1, 1, 0, 1]"
203,2,2,4,0.9525669262459352,"[1, 0, 1, 1, 1, 1, 0, 0, 1, 1]"
204,3,3,6,0.1342951161197764,"[1, 1, 0, 0, 1, 0, 0, 1, 1, 1]"
205,1,1,2,0.5168409788032589,"[0, 0, 0, 0, 0, 1, 0, 1, 0, 1]"
206,60,60,120,0.5781816225507183,"[1, 1, 1, 0, 1, 1, 0, 1, 1, 0]"
207,6,6,12,0.03447443725792798,"[0, 0, 0, 1, 1, 1, 0, 1, 1, 1]"
208,4,4,8,0.44864119776126343,"[1, 0, 1, 1, 0, 0, 0, 1, 0, 0]"
209,22,22,44,0.6086056014076034,"[0, 1, 1, 0, 1, 0, 1, 1, 1, 1]"
210,8,8,16,0.3904991520569213,"[1, 1, 0, 1, 1, 0, 0, 0, 0, 0]"
211,7,7,14,0.46252960113999164,"[1, 0, 1, 0, 1, 0, 0, 0, 1, 1]"
212,3,3,6,0.7756252717317332,"[1, 1, 0, 1, 0, 1, 0, 0, 1, 0]"
213,12,12,24,0.39141227850566496,"[0, 0, 1, 1, 0, 0, 0, 1, 1, 1]"
214,2,2,4,0.9620375619316455,"[1, 0, 0, 1, 1, 0, 1, 1, 0, 0]"
215,8,8,16,0.06592385881996476,"[0, 0, 1, 1, 0, 1, 1, 1, 0, 0]"
216,1,1,2,0.23188678563491305,"[0, 1, 0, 0, 1, 1, 1, 0, 0, 1]"
217,2,2,4,0.21962985491168907,"[0, 1, 1, 1, 1, 0, 1, 1, 1, 1]"
218,1,1,2,0.9259791644539318,"[0, 0, 1, 0, 1, 1, 0, 1, 1, 1]"
219,10,10,20,0.759922460111893,"[1, 0, 0, 1, 0, 0, 0, 1, 1, 1]"
220,13,13,26,0.4046274010589038,"[1, 0, 1, 1, 0, 0, 0, 1, 1, 1]"
221,29,29,58,0.40398352423441075,"[1, 1, 1, 1, 1, 1, 1, 1, 0, 1]"
222,3,3,6,0.7001679617603174,"[1, 1, 1, 1, 0, 0, 1, 1, 1, 1]"
223,1,1,2,0.5875535818103446,"[0, 0, 0, 1, 1, 1, 1, 1, 0, 1]"
224,3,3,6,0.25933867816186973,"[0, 1, 1, 0, 0, 0, 1, 0, 0, 1]"
225,7,7,14,0.15200769213327503,"[1, 0, 0, 1, 1, 0, 1, 0, 1, 0]"
226,1,1,2,0.7077475688072404,"[0, 0, 1, 1, 0, 0, 0, 0, 0, 0]"
227,4,4,8,0.9379199748742658,"[1, 0, 1, 1, 0, 0, 1, 1, 0, 0]"
228,8,8,16,0.7940567032269341,"[1, 0, 0, 0, 1, 0, 0, 0, 0, 1]"
229,2,2,4,0.5560781239920891,"[0, 0, 1, 0, 0, 0, 0, 0, 1, 0]"
230,1,1,2,0.03133602022452764,"[1, 0, 0, 0, 1, 1, 0, 0, 0, 1]"
231,8,8,16,0.7722070371652423,"[0, 0, 1, 1, 0, 0, 0, 1, 1, 0]"
232,2,2,4,0.049612143241759,"[1, 1, 0, 0, 1, 1, 1, 1, 0, 0]"
233,1,1,2,0.808641731896595,"[1, 1, 0, 0, 0, 1, 0, 1, 0, 0]"
234,5,5,10,0.20348073021623458,"[0, 0, 1, 0, 0, 0, 0, 1, 0, 1]"
235,2,2,4,0.0897466351511712,"[0, 1, 1, 0, 1, 1, 1, 0, 1, 0]"
236,14,14,28,0.6458718107920807,"[1, 0, 1, 0, 1, 0, 1, 0, 1, 1]"
237,2,2,4,0.24900186097197685,"[0, 0, 0, 0, 0, 0, 0, 0, 0, 1]"
238,2,2,4,0.40963204643013307,"[0, 1, 0, 0, 0, 1, 0, 0, 1, 0]"
239,2,2,4,0.4562342348096793,"[1, 0, 1, 1, 1, 1, 1, 0, 0, 1]"
240,8,8,16,0.8924031902229911,"[1, 0, 1, 0, 1, 1, 0, 0, 1, 1]"
241,32,32,64,0.7033510342642779,"[0, 1, 0, 0, 0, 1, 0, 0, 1, 1]"
242,12,12,24,0.5944802156260586,"[0, 1, 1, 1, 1, 1, 0, 1, 0, 1]"
243,1,1,2,0.9165187091453103,"[0, 0, 1, 0, 0, 1, 1, 0, 0, 1]"
244,12,12,24,0.49303769726656743,"[0, 0, 1, 1, 0, 1, 0, 1, 0, 1]"
245,41,41,82,0.479433094302658,"[1, 1, 1, 1, 0, 1, 0, 1, 0, 1]"
246,4,4,8,0.7681468658310173,"[0, 0, 0, 0, 1, 1, 0, 0, 1, 1]"
247,3,3,6,0.8310457077818814,"[0, 0, 0, 0, 0, 1, 1, 1, 0, 0]"
248,1,1,2,0.5321796391856051,"[1, 0, 0, 0, 0, 1, 1, 1, 0, 0]"
249,1,1,2,0.15198374742697685,"[0, 1, 0, 0, 0, 0, 1, 0, 0, 0]"
250,8,8,16,0.0897458794078857,"[0, 1, 0, 1, 0, 1, 0, 1, 1, 1]"
251,7,7,14,0.057471988588027156,"[0, 0, 0, 0, 0, 0, 1, 1, 1, 1]"
252,2,2,4,0.8734902036179532,"[1, 1, 0, 0, 1, 0, 0, 0, 1, 0]"
253,6,6,12,0.7697709750091922,"[1, 0, 1, 1, 0, 0, 0, 0, 0, 0]"
254,7,7,14,0.3977914025270948,"[0, 0, 1, 1, 0, 1, 1, 1, 0, 0]"
255,2,2,4,0.7771149517006465,"[0, 0, 0, 1, 0, 1, 1, 1, 0, 1]"
256,2,2,4,0.8680151991683285,"[1, 0, 0, 0, 0, 0, 1, 0, 1, 0]"
257,4,4,8,0.4254664220474862,"[0, 0, 1, 0, 1, 0, 0, 1, 0, 1]"
258,4,4,8,0.35040065582681823,"[0, 0, 1, 1, 0, 1, 1, 1, 1, 1]"
259,1,1,2,0.4964975242615093,"[0, 0, 1, 0, 1, 0, 0, 1, 0, 1]"
260,6,6,12,0.13106255632141506,"[0, 1, 1, 1, 1, 1, 1, 0, 0, 0]"
261,2,2,4,0.8263794466942099,"[0, 1, 1, 0, 1, 0, 1, 1, 0, 0]"
262,26,26,52,0.776786564488487,"[0, 1, 1, 0, 1, 1, 0, 1, 1, 1]"
263,3,3,6,0.8885797825462771,"[1, 0, 1, 1, 0, 1, 1, 0, 1, 0]"
264,14,14,28,0.3235174837936491,"[1, 1, 0, 1, 0, 0, 0, 1, 1, 1]"
265,22,22,44,0.4985933350249061,"[1, 1, 1, 1, 0, 1, 1, 0, 1, 0]"
266,1,1,2,0.32696454612122805,"[0, 0, 1, 1, 0, 0, 0, 0, 1, 1]"
267,27,27,54,0.30672538684356254,"[1, 1, 1, 1, 0, 0, 0, 0, 0, 1]"
268,1,1,2,0.10414160492649183,"[0, 0, 1, 1, 1, 0, 0, 0, 0, 1]"
269,7,7,14,0.1884044862394194,"[1, 0, 0, 0, 0, 1, 1, 0, 0, 0]"
270,10,10,20,0.8941537747641148,"[0, 0, 1, 1, 1, 1, 0, 0, 1, 1]"
271,3,3,6,0.49260682085544016,"[0, 0, 1, 0, 1, 0, 0, 1, 1, 0]"
272,12,12,24,0.03149218651586194,"[0, 1, 0, 0, 1, 1, 0, 1, 1, 0]"
273,2,2,4,0.40242837124409003,"[0, 0, 1, 1, 0, 1, 0, 1, 0, 0]"
274,4,4,8,0.128808136208588,"[0, 0, 1, 1, 0, 0, 0, 0, 1, 0]"
275,3,3,6,0.014480444307656493,"[1, 1, 0, 0, 0, 0, 0, 0, 0, 0]"
276,2,2,4,0.7958107660233409,"[0, 1, 1, 1, 0, 0, 1, 0, 0, 0]"
277,9,9,18,0.40648424074578815,"[0, 0, 1, 1, 1, 0, 1, 0, 1, 1]"
278,9,9,18,0.2179882063221087,"[1, 1, 1, 1, 0, 1, 1, 1, 1, 1]"
279,2,2,4,0.6121463062512377,"[0, 1, 0, 0, 1, 1, 0, 0, 0, 0]"
280,6,6,12,0.08555385482826294,"[0, 0, 1, 1, 1, 1, 0, 1, 1, 0]"
281,4,4,8,0.981600460539241,"[0, 1, 1, 1, 0, 0, 1, 1, 0, 0]"
282,6,6,12,0.2966692231401906,"[1, 1, 0, 1, 1, 1, 1, 0, 1, 1]"
283,9,9,18,0.7118289678820757,"[1, 0, 0, 0, 0, 0, 0, 1, 1, 1]"
284,30,30,60,0.37141873634716915,"[1, 1, 0, 1, 1, 1, 1, 1, 1, 1]"
285,1,1,2,0.8542671224927534,"[0, 1, 0, 0, 0, 0, 1, 1, 1, 1]"
286,6,6,12,0.7439773103292454,"[0, 1, 1, 0, 1, 0, 1, 1, 1, 0]"
287,9,9,18,0.7379296303133944,"[0, 1, 0, 0, 1, 1, 1, 0, 0, 1]"
288,24,24,48,0.09369363149873644,"[0, 1, 1, 1, 0, 1, 1, 1, 1, 0]"
289,18,18,36,0.15813921054458036,"[0, 1, 0, 0, 1, 1, 0, 0, 1, 1]"
290,1,1,2,0.9203020919392096,"[1, 1, 0, 0, 0, 0, 0, 1, 0, 0]"
291,2,2,4,0.6350661669053632,"[0, 0, 1, 0, 0, 0, 0, 1, 1, 0]"
292,1,1,2,0.37173968525261414,"[1, 0, 1, 1, 1, 0, 0, 1, 0, 1]"
293,6,6,12,0.5025083387712646,"[1, 1, 0, 0, 1, 0, 0, 1, 1, 1]"
294,1,1,2,0.1555332484590034,"[1, 0, 0, 0, 0, 1, 0, 0, 0, 1]"
295,2,2,4,0.06526008326637667,"[0, 0, 1, 0, 0, 1, 0, 0, 0, 0]"
296,2,2,4,0.16289021556334127,"[1, 1, 1, 0, 1, 0, 0, 1, 0, 0]"
297,2,2,4,0.7057793626450398,"[0, 0, 0, 1, 0, 0, 0, 0, 0, 1]"
298,2,2,4,0.5157484525758902,"[0, 0, 1, 0, 1, 0, 0, 0, 0, 0]"
299,44,44,88,0.543742785747684,"[1, 1, 0, 1, 0, 0, 0, 1, 1, 1]"
300,27,27,54,0.22245352437674593,"[1, 0, 0, 1, 1, 1, 0, 0, 0, 1]"
301,1,1,2,0.2142614309727574,"[1, 0, 0, 0, 0, 1, 0, 1, 0, 0]"
302,1,1,2,0.9743607714449837,"[0, 0, 0, 1, 1, 1, 0, 0, 0, 0]"
303,6,6,12,0.7717004516990494,"[0, 1, 0, 0, 1, 1, 1, 1, 0, 0]"
304,1,1,2,0.7945681124863785,"[0, 1, 0, 0, 0, 1, 1, 1, 0, 0]"
305,1,1,2,0.021586718032693297,"[1, 1, 1, 0, 0, 1, 0, 0, 1, 0]"
306,9,9,18,0.4404565425210054,"[1, 0, 1, 1, 1, 0, 1, 1, 0, 1]"
307,6,6,12,0.6874201665481053,"[1, 1, 1, 1, 1, 0, 1, 0, 0, 0]"
308,2,2,4,0.27009237054345614,"[0, 1, 1, 0, 1, 1, 1, 1, 1, 0]"
309,1,1,2,0.27396023751950493,"[1, 1, 1, 0, 0, 0, 0, 0, 0, 1]"
310,2,2,4,0.4474463037899201,"[1, 0, 0, 0, 0, 0, 0, 0, 1, 1]"
311,31,31,62,0.8837066497582813,"[1, 1, 0, 1, 1, 1, 1, 1, 1, 1]"
312,2,2,4,0.44241732964782665,"[0, 0, 0, 1, 0, 0, 1, 1, 0, 1]"
313,5,5,10,0.7987032587189121,"[1, 0, 0, 0, 1, 0, 0, 0, 1, 1]"
314,7,7,14,0.7110299591374311,"[0, 0, 1, 0, 1, 1, 1, 1, 0, 0]"
315,35,35,70,0.7866558644106197,"[1, 0, 0, 0, 1, 0, 1, 1, 1, 0]"
316,10,10,20,0.14364960287517947,"[1, 1, 1, 0, 1, 1, 0, 0, 1, 0]"
317,4,4,8,0.3931646256213659,"[1, 0, 0, 1, 1, 1, 0, 1, 0, 0]"
318,3,3,6,0.5476590354734077,"[1, 0, 0, 0, 0, 1, 1, 1, 0, 0]"
319,8,8,16,0.0791503252545207,"[0, 0, 1, 1, 0, 1, 1, 1, 0, 0]"
320,3,3,6,0.6666851017204722,"[0, 0, 1, 1, 0, 0, 1, 1, 1, 0]"
321,3,3,6,0.6410027377337035,"[1, 0, 1, 0, 0, 0, 0, 0, 1, 1]"
322,1,1,2,0.5541308102367978,"[0, 0, 0, 0, 0, 0, 1, 0, 1, 0]"
323,1,1,2,0.9190100026449064,"[0, 0, 1, 1, 0, 1, 0, 0, 0, 1]"
324,7,7,14,0.7209736392079817,"[1, 1, 1, 1, 1, 1, 1, 1, 0, 1]"
325,10,10,20,0.0542787878535721,"[1, 0, 1, 1, 0, 0, 1, 0, 0, 1]"
326,7,7,14,0.7303169243576406,"[0, 1, 1, 0, 0, 1, 0, 1, 0, 0]"
327,2,2,4,0.23371426114253835,"[1, 0, 0, 0, 1, 1, 0, 0, 1, 0]"
328,5,5,10,0.781305394129209,"[0, 0, 0, 0, 0, 1, 1, 0, 1, 0]"
329,20,20,40,0.7457668277661151,"[1, 1, 0, 1, 1, 0, 1, 0, 1, 1]"
330,3,3,6,0.45426846434466117,"[0, 0, 0, 0, 1, 0, 0, 1, 1, 1]"
331,1,1,2,0.3901892323687024,"[0, 0, 1, 0, 1, 1, 0, 1, 1, 0]"
332,2,2,4,0.5651604622868063,"[1, 1, 0, 1, 0, 0, 0, 1, 0, 1]"
333,3,3,6,0.707073632255437,"[1, 1, 1, 1, 1, 1, 1, 1, 1, 0]"
334,6,6,12,0.820577944306193,"[0, 0, 0, 1, 1, 0, 0, 0, 1, 1]"
335,1,1,2,0.3228088104317819,"[1, 1, 0, 1, 0, 1, 1, 1, 1, 0]"
336,47,47,94,0.9169179622238584,"[1, 0, 1, 1, 1, 0, 0, 0, 1, 1]"
337,14,14,28,0.4579111133525583,"[0, 1, 1, 0, 1, 1, 1, 0, 0, 1]"
338,3,3,6,0.07458193497969656,"[1, 0, 1, 1, 0, 1, 1, 1, 1, 1]"
339,7,7,14,0.08783180574017235,"[0, 1, 1, 0, 0, 1, 1, 1, 1, 1]"
340,3,3,6,0.29479405066430686,"[0, 0, 1, 0, 0, 0, 1, 1, 1, 0]"
341,20,20,40,0.333878799840718,"[0, 1, 1, 0, 1, 0, 0, 1, 1, 0]"
342,2,2,4,0.33063874859579157,"[1, 0, 1, 0, 0, 0, 0, 1, 1, 0]"
343,2,2,4,0.8662258213212752,"[0, 1, 0, 1, 0, 0, 0, 1, 0, 0]"
344,8,8,16,0.45541519249002405,"[0, 1, 1, 0, 0, 0, 0, 1, 1, 0]"
345,2,2,4,0.18093941926497858,"[1, 1, 0, 1, 0, 0, 0, 1, 1, 0]"
346,1,1,2,0.7189672215758808,"[0, 0, 0, 0, 1, 0, 0, 0, 1, 1]"
347,2,2,4,0.20158620272182126,"[1, 0, 0, 1, 0, 0, 1, 1, 0, 1]"
348,7,7,14,0.02759823092173397,"[0, 1, 1, 1, 1, 0, 0, 1, 0, 1]"
349,4,4,8,0.29203236333206894,"[0, 0, 1, 0, 0, 1, 0, 0, 0, 1]"
350,11,11,22,0.8068306625063492,"[0, 0, 0, 1, 0, 1, 0, 0, 1, 1]"
351,16,16,32,0.9242993644093417,"[0, 0, 0, 0, 1, 0, 1, 1, 1, 0]"
352,4,4,8,0.634271344417042,"[0, 1, 0, 1, 0, 0, 1, 1, 0, 0]"
353,1,1,2,0.4868707363674667,"[1, 1, 1, 0, 0, 1, 1, 1, 0, 0]"
354,1,1,2,0.9209177351077461,"[0, 0, 1, 0, 0, 0, 0, 0, 1, 0]"
355,9,9,18,0.6064194612924989,"[0, 1, 1, 0, 0, 1, 0, 1, 1, 0]"
356,5,5,10,0.06814312303089021,"[1, 1, 0, 1, 1, 1, 1, 0, 0, 1]"
357,2,2,4,0.8327634288040231,"[1, 0, 0, 1, 1, 0, 0, 0, 0, 0]"
358,8,8,16,0.7478850021434306,"[0, 1, 0, 1, 1, 0, 1, 0, 0, 1]"
359,23,23,46,0.1339338706963651,"[0, 1, 1, 1, 0, 1, 1, 1, 1, 1]"
360,6,6,12,0.42939520685655164,"[1, 1, 1, 1, 0, 1, 1, 0, 0, 0]"
361,8,8,16,0.6922572896255405,"[0, 0, 1, 1, 1, 1, 1, 0, 0, 1]"
362,14,14,28,0.9715049354928287,"[1, 0, 0, 0, 1, 1, 1, 0, 1, 1]"
363,1,1,2,0.4628797677969668,"[0, 0, 1, 1, 0, 0, 0, 0, 0, 0]"
364,6,6,12,0.9271340427186158,"[0, 1, 1, 1, 1, 0, 0, 0, 0, 0]"
365,4,4,8,0.37458554199858807,"[1, 0, 0, 0, 1, 0, 1, 0, 0, 0]"
366,9,9,18,0.8011139743787004,"[0, 1, 0, 0, 1, 0, 0, 0, 0, 1]"
367,2,2,4,0.3583554779831236,"[1, 0, 1, 1, 0, 1, 1, 0, 0, 0]"
368,5,5,10,0.6449786333108787,"[0, 0, 0, 1, 1, 1, 0, 1, 0, 1]"
369,5,5,10,0.6323610200292669,"[0, 0, 1, 1, 0, 0, 1, 1, 1, 1]"
370,5,5,10,0.02733865903097399,"[0, 1, 1, 1, 0, 0, 0, 0, 0, 1]"
371,10,10,20,0.33171452385261424,"[1, 1, 1, 1, 1, 0, 1, 0, 1, 0]"
372,10,10,20,0.5530490466941599,"[1, 1, 1, 0, 0, 1, 1, 0, 0, 1]"
373,7,7,14,0.1959143219994347,"[0, 1, 0, 1, 0, 0, 0, 1, 0, 1]"
374,1,1,2,0.024729900201999278,"[1, 0, 0, 0, 0, 1, 0, 1, 0, 1]"
375,1,1,2,0.3328967950967031,"[1, 0, 1, 0, 1, 1, 0, 0, 1, 1]"
376,1,1,2,0.9054338146438307,"[1, 1, 0, 0, 0, 0, 0, 1, 1, 1]"
377,10,10,20,0.6845522384201708,"[1, 1, 1, 0, 1, 1, 0, 1, 0, 0]"
378,4,4,8,0.5699459829769798,"[0, 0, 1, 0, 1, 1, 0, 1, 1, 0]"
379,46,46,92,0.23333263282743077,"[1, 1, 1, 1, 1, 1, 0, 1, 1, 1]"
380,1,1,2,0.8117754621489777,"[0, 1, 0, 1, 0, 0, 0, 1, 0, 1]"
381,8,8,16,0.32289331764690987,"[0, 1, 0, 0, 1, 1, 1, 0, 1, 1]"
382,2,2,4,0.1064152636048088,"[0, 1, 1, 1, 0, 0, 0, 1, 0, 0]"
383,15,15,30,0.6023705153288523,"[0, 1, 1, 0, 0, 0, 0, 0, 1, 1]"
384,1,1,2,0.2320366919505772,"[0, 0, 0, 0, 0, 0, 0, 0, 0, 0]"
385,1,1,2,0.20166588624959525,"[1, 0, 0, 1, 1, 1, 1, 0, 1, 0]"
386,1,1,2,0.6110891995311215,"[1, 0, 1, 0, 0, 0, 0, 1, 0, 0]"
387,28,28,56,0.7536547836838375,"[0, 1, 1, 1, 1, 0, 0, 1, 1, 0]"
388,4,4,8,0.9176990114130379,"[1, 1, 1, 1, 0, 1, 1, 0, 0, 1]"
389,4,4,8,0.4129334344191774,"[1, 0, 0, 1, 1, 1, 0, 1, 1, 0]"
390,12,12,24,0.45451356422244404,"[0, 0, 1, 0, 1, 0, 1, 1, 1, 1]"
391,13,13,26,0.3276144162987249,"[1, 1, 0, 1, 0, 0, 1, 1, 0, 1]"
392,4,4,8,0.4795025966912151,"[0, 1, 0, 0, 0, 0, 0, 1, 0, 1]"
393,5,5,10,0.6112089523871876,"[0, 1, 1, 1, 0, 1, 1, 0, 0, 0]"
394,1,1,2,0.33859688768125107,"[0, 1, 1, 1, 1, 0, 1, 0, 0, 1]"
395,6,6,12,0.5795748179988572,"[1, 0, 1, 0, 0, 1, 0, 1, 0, 0]"
396,14,14,28,0.8620807814676206,"[0, 1, 0, 1, 0, 1, 0, 1, 0, 1]"
397,27,27,54,0.9936568140733625,"[0, 1, 1, 1, 0, 1, 1, 0, 0, 1]"
398,1,1,2,0.7615064608002716,"[0, 1, 1, 0, 0, 0, 1, 0, 0, 1]"
399,5,5,10,0.19452367696693584,"[0, 1, 0, 0, 1, 0, 0, 0, 0, 1]"
400,1,1,2,0.6251206807121501,"[0, 1, 0, 0, 0, 1, 0, 0, 0, 0]"
401,2,2,4,0.45654461069610486,"[0, 1, 0, 0, 1, 0, 1, 0, 1, 0]"
402,1,1,2,0.20483618131885295,"[1, 1, 0, 0, 0, 0, 0, 1, 1, 0]"
403,2,2,4,0.6946055466851724,"[0, 0, 1, 1, 0, 0, 0, 1, 0, 0]"
404,19,19,38,0.337366323021855,"[1, 0, 0, 1, 1, 0, 1, 1, 1, 1]"
405,2,2,4,0.11669848440764363,"[1, 0, 1, 0, 1, 0, 1, 0, 0, 0]"
406,3,3,6,0.6823209112281399,"[0, 0, 0, 0, 0, 1, 0, 1, 0, 1]"
407,6,6,12,0.07180785037964399,"[1, 0, 0, 1, 1, 1, 0, 0, 1, 1]"
408,4,4,8,0.4761914543749456,"[1, 1, 0, 0, 1, 0, 0, 1, 0, 1]"
409,2,2,4,0.3415078960923722,"[0, 1, 0, 0, 1, 0, 0, 0, 0, 0]"
410,2,2,4,0.9432864452830375,"[0, 0, 1, 1, 1, 1, 0, 0, 1, 0]"
411,4,4,8,0.8957939991537864,"[1, 0, 0, 0, 1, 0, 0, 0, 1, 1]"
412,15,15,30,0.46302491583494354,"[1, 0, 1, 1, 0, 1, 1, 1, 0, 1]"
413,1,1,2,0.08488316019467113,"[1, 1, 1, 1, 0, 1, 0, 0, 1, 1]"
414,3,3,6,0.17706690386463142,"[0, 1, 0, 0, 0, 1, 0, 1, 0, 1]"
415,1,1,2,0.20159958161807556,"[0, 1, 0, 0, 1, 0, 1, 0, 0, 0]"
416,15,15,30,0.6142662741373449,"[1, 0, 1, 1, 0, 0, 1, 0, 0, 0]"
417,2,2,4,0.11025726599042829,"[0, 0, 0, 0, 1, 1, 1, 0, 0, 0]"
418,5,5,10,0.41234524708099807,"[0, 1, 1, 0, 1, 0, 0, 0, 0, 1]"
419,9,9,18,0.8268010638368712,"[0, 0, 0, 1, 1, 0, 1, 1, 1, 1]"
420,1,1,2,0.27246686689321453,"[1, 1, 0, 0, 0, 1, 0, 0, 0, 1]"
421,1,1,2,0.2197671710131358,"[1, 1, 0, 0, 0, 0, 0, 0, 0, 0]"
422,5,5,10,0.276180747139501,"[0, 0, 1, 1, 0, 0, 1, 1, 0, 1]"
423,6,6,12,0.22336730929955506,"[1, 0, 1, 0, 1, 0, 0, 0, 1, 0]"
424,7,7,14,0.06166024015911287,"[1, 1, 0, 0, 0, 0, 0, 1, 0, 1]"
425,1,1,2,0.3015921750838786,"[1, 0, 1, 1, 0, 1, 1, 1, 1, 0]"
426,16,16,32,0.1606193529413681,"[1, 1, 0, 0, 1, 0, 1, 0, 1, 0]"
427,9,9,18,0.07307335021918882,"[0, 0, 1, 1, 1, 0, 1, 0, 1, 1]"
428,2,2,4,0.5591905045012205,"[1, 0, 1, 1, 0, 0, 0, 1, 1, 1]"
429,1,1,2,0.3123219134568441,"[1, 0, 1, 0, 0, 0, 0, 0, 0, 0]"
430,8,8,16,0.5097844733495976,"[0, 0, 1, 1, 0, 0, 1, 0, 1, 0]"
431,12,12,24,0.8374454890961514,"[1, 1, 1, 0, 0, 0, 0, 1, 1, 1]"
432,4,4,8,0.4446501832492392,"[0, 0, 0, 0, 1, 1, 0, 1, 1, 0]"
433,1,1,2,0.8542577731672213,"[0, 1, 0, 1, 0, 0, 0, 0, 1, 0]"
434,1,1,2,0.7163523456992129,"[0, 1, 1, 0, 1, 1, 0, 1, 0, 1]"
435,10,10,20,0.1270073344840177,"[1, 1, 0, 0, 1, 0, 1, 1, 0, 1]"
436,2,2,4,0.728912874027393,"[0, 0, 1, 1, 1, 1, 1, 0, 0, 0]"
437,4,4,8,0.34834961669227393,"[1, 0, 1, 0, 0, 1, 0, 1, 1, 0]"
438,2,2,4,0.679683289680097,"[1, 0, 1, 0, 0, 1, 1, 0, 1, 1]"
439,5,5,10,0.579363352491433,"[0, 1, 0, 0, 1, 0, 0, 0, 0, 1]"
440,1,1,2,0.28427412637178395,"[0, 1, 0, 0, 1, 0, 0, 0, 0, 0]"
441,9,9,18,0.4564682282952557,"[1, 0, 1, 0, 1, 1, 1, 0, 0, 0]"
442,8,8,16,0.09632965727469833,"[0, 1, 0, 0, 0, 1, 1, 0, 1, 1]"
443,13,13,26,0.5586882693017283,"[1, 1, 0, 0, 0, 1, 1, 1, 0, 0]"
444,2,2,4,0.3625412917470827,"[0, 1, 0, 0, 1, 0, 0, 0, 1, 0]"
445,12,12,24,0.18325103397975084,"[1, 1, 0, 0, 1, 0, 0, 1, 1, 1]"
446,4,4,8,0.9917804558080617,"[0, 1, 0, 0, 0, 0, 0, 0, 1, 1]"
447,1,1,2,0.6238668490874555,"[0, 0, 0, 1, 1, 1, 1, 0, 0, 0]"
448,4,4,8,0.07328346962759524,"[0, 1, 1, 0, 0, 0, 1, 0, 1, 0]"
449,2,2,4,0.6132152578863634,"[0, 0, 0, 0, 1, 1, 1, 0, 1, 0]"
450,65,65,130,0.1853953774088717,"[1, 1, 1, 1, 1, 1, 1, 0, 0, 1]"
451,1,1,2,0.4341036900213574,"[0, 0, 1, 0, 0, 1, 0, 0, 0, 1]"
452,29,29,58,0.2115473552518099,"[1, 1, 0, 1, 0, 1, 1, 1, 0, 0]"
453,2,2,4,0.7576864859963522,"[1, 0, 1, 0, 0, 0, 1, 0, 1, 0]"
454,8,8,16,0.5787483797324112,"[0, 1, 1, 0, 1, 1, 1, 1, 1, 1]"
455,2,2,4,0.4231645858983857,"[1, 0, 1, 1, 1, 0, 0, 0, 0, 1]"
456,4,4,8,0.7684265634926137,"[0, 1, 1, 0, 0, 0, 1, 1, 1, 1]"
457,1,1,2,0.0805164309541394,"[0, 1, 1, 0, 1, 0, 0, 0, 1, 0]"
458,3,3,6,0.15702995975083622,"[1, 1, 1, 0, 0, 0, 1, 0, 0, 1]"
459,34,34,68,0.2517968085899087,"[1, 1, 1, 1, 1, 0, 0, 1, 0, 1]"
460,3,3,6,0.6633388347452451,"[1, 0, 0, 0, 0, 1, 0, 1, 0, 1]"
461,9,9,18,0.3045071574664818,"[1, 0, 0, 0, 0, 1, 1, 0, 0, 1]"
462,1,1,2,0.19388170992280496,"[0, 0, 1, 0, 1, 0, 1, 0, 1, 1]"
463,36,36,72,0.2344483439782612,"[1, 1, 0, 1, 1, 1, 0, 1, 1, 1]"
464,1,1,2,0.1863472621640071,"[1, 1, 0, 1, 1, 1, 1, 1, 0, 0]"
465,5,5,10,0.4195153048312673,"[1, 1, 0, 1, 0, 0, 0, 1, 0, 1]"
466,3,3,6,0.5936342425945207,"[0, 0, 0, 1, 0, 1, 1, 0, 1, 0]"
467,4,4,8,0.24336824726445339,"[1, 0, 1, 1, 1, 0, 1, 1, 0, 0]"
468,5,5,10,0.736998177684255,"[0, 1, 0, 1, 0, 0, 0, 1, 1, 1]"
469,1,1,2,0.6743662858987591,"[1, 1, 1, 1, 0, 1, 1, 0, 0, 1]"
470,5,5,10,0.6481298433185239,"[1, 1, 0, 0, 1, 1, 1, 1, 1, 1]"
471,9,9,18,0.8542794553572665,"[0, 1, 0, 1, 1, 1, 1, 0, 0, 0]"
472,2,2,4,0.9467666734135897,"[0, 0, 0, 0, 0, 0, 1, 1, 1, 0]"
473,12,12,24,0.38022702873967107,"[1, 0, 0, 1, 1, 0, 0, 1, 1, 0]"
474,1,1,2,0.9987466587137112,"[0, 1, 0, 0, 0, 0, 1, 1, 0, 0]"
475,1,1,2,0.10668126837166325,"[1, 0, 0, 1, 0, 1, 0, 1, 0, 0]"
476,4,4,8,0.4958342206427542,"[0, 0, 1, 1, 0, 0, 1, 0, 1, 1]"
477,4,4,8,0.6482481026711229,"[1, 0, 1, 1, 1, 1, 0, 1, 1, 1]"
478,2,2,4,0.9589178757923558,"[1, 1, 0, 1, 0, 0, 0, 1, 1, 0]"
479,11,11,22,0.12234177024096837,"[1, 0, 1, 1, 1, 0, 0, 0, 0, 1]"
480,16,16,32,0.2348927758259054,"[1, 1, 0, 1, 0, 1, 0, 1, 1, 1]"
481,4,4,8,0.6012232716283523,"[1, 0, 1, 0, 0, 1, 1, 1, 1, 1]"
482,5,5,10,0.8965389406605537,"[1, 0, 0, 1, 1, 0, 0, 1, 1, 0]"
483,2,2,4,0.8026474265582404,"[1, 0, 1, 0, 0, 0, 0, 1, 1, 1]"
484,3,3,6,0.3372827491459629,"[0, 0, 1, 1, 1, 0, 0, 0, 1, 1]"
485,3,3,6,0.49496009456798173,"[1, 0, 1, 1, 0, 1, 1, 0, 0, 0]"
486,3,3,6,0.6892666067366905,"[1, 0, 0, 1, 1, 1, 1, 1, 1, 0]"
487,8,8,16,0.3370591539511224,"[1, 0, 1, 0, 0, 0, 0, 1, 1, 1]"
488,36,36,72,0.26417296103514976,"[1, 1, 1, 1, 0, 1, 1, 1, 1, 1]"
489,81,81,162,0.6076130530056069,"[1, 1, 0, 1, 0, 1, 0, 1, 1, 1]"
490,2,2,4,0.4325402645885019,"[1, 0, 1, 0, 1, 1, 0, 0, 0, 0]"
491,3,3,6,0.7796768370335933,"[1, 0, 0, 0, 0, 0, 1, 0, 0, 0]"
492,7,7,14,0.47047503715085115,"[1, 1, 1, 0, 0, 1, 1, 0, 0, 0]"
493,31,31,62,0.028779244595308562,"[1, 1, 1, 1, 1, 0, 0, 1, 1, 0]"
494,6,6,12,0.44229799489665433,"[1, 1, 0, 1, 0, 1, 0, 1, 1, 1]"
495,1,1,2,0.49557460322952773,"[0, 0, 0, 1, 1, 0, 0, 0, 0, 1]"
496,14,14,28,0.6457494892338483,"[0, 1, 1, 1, 0, 1, 0, 0, 1, 1]"
497,8,8,16,0.7269079107979809,"[1, 0, 1, 1, 1, 0, 1, 1, 0, 0]"
498,2,2,4,0.6826638814841428,"[0, 0, 0, 0, 0, 0, 0, 1, 0, 1]"
499,1,1,2,0.47245872696221947,"[1, 0, 1, 0, 0, 1, 1, 0, 1, 1]"
500,3,3,6,0.919943044479518,"[0, 0, 1, 0, 1, 0, 0, 0, 1, 1]"
501,7,7,14,0.9552242840005821,"[0, 1, 0, 0, 0, 1, 1, 0, 1, 0]"
502,15,15,30,0.5868594793380502,"[0, 0, 1, 0, 1, 0, 1, 1, 0, 1]"
503,4,4,8,0.7959080605114504,"[0, 1, 0, 1, 1, 0, 1, 0, 1, 0]"
504,6,6,12,0.0740086731419265,"[0, 0, 0, 0, 0, 1, 1, 1, 0, 1]"
505,1,1,2,0.6176810422297639,"[0, 0, 0, 0, 0, 1, 0, 0, 0, 1]"
506,1,1,2,0.03831622689300507,"[0, 0, 1, 0, 0, 1, 1, 1, 0, 0]"
507,19,19,38,0.36979596933916503,"[0, 1, 1, 0, 1, 0, 1, 1, 1, 0]"
508,49,49,98,0.8166340847920381,"[1, 0, 1, 1, 1, 1, 1, 0, 1, 1]"
509,11,11,22,0.6598596987386388,"[0, 1, 1, 0, 1, 1, 0, 1, 1, 0]"
510,1,1,2,0.1014697910657395,"[0, 1, 0, 1, 0, 1, 0, 0, 0, 0]"
511,5,5,10,0.1834789667085015,"[0, 1, 1, 0, 1, 0, 1, 1, 0, 0]"
512,4,4,8,0.10924508853880088,"[1, 1, 0, 0, 0, 0, 1, 0, 0, 1]"
513,1,1,2,0.4018860307136539,"[1, 1, 0, 1, 0, 0, 0, 0, 0, 1]"
514,1,1,2,0.4518193868079591,"[0, 1, 1, 1, 0, 1, 0, 0, 1, 1]"
515,6,6,12,0.36864775348629253,"[0, 0, 1, 1, 1, 0, 1, 1, 1, 0]"
516,6,6,12,0.7748821618292996,"[1, 1, 1, 1, 1, 0, 1, 1, 0, 1]"
517,13,13,26,0.09757877843686447,"[1, 1, 0, 1, 0, 1, 1, 1, 1, 1]"
518,8,8,16,0.8778854375405726,"[0, 0, 1, 1, 1, 1, 1, 0, 0, 1]"
519,1,1,2,0.3804768428570672,"[1, 0, 0, 1, 1, 1, 1, 0, 1, 0]"
520,3,3,6,0.589263572842449,"[0, 0, 0, 1, 1, 1, 1, 0, 1, 1]"
521,51,51,102,0.3417008715893567,"[1, 1, 0, 1, 1, 1, 1, 1, 1, 1]"
522,5,5,10,0.5893377413584129,"[0, 1, 1, 1, 0, 0, 0, 1, 1, 1]"
523,6,6,12,0.11471561219260562,"[1, 0, 0, 1, 1, 0, 0, 0, 0, 1]"
524,2,2,4,0.8316802694120385,"[0, 0, 1, 1, 1, 1, 0, 1, 1, 0]"
525,19,19,38,0.9999626804443045,"[0, 1, 1, 1, 1, 0, 1, 1, 0, 1]"
526,3,3,6,0.7953500855539419,"[1, 0, 0, 0, 1, 1, 0, 1, 0, 0]"
527,3,3,6,0.3545995697627028,"[0, 1, 1, 0, 1, 0, 1, 1, 1, 0]"
528,15,15,30,0.8399215655060063,"[0, 1, 0, 1, 1, 0, 1, 0, 0, 1]"
529,5,5,10,0.6302014379100926,"[0, 1, 1, 0, 1, 0, 1, 1, 1, 0]"
530,2,2,4,0.6237880807160257,"[0, 0, 0, 0, 1, 1, 0, 1, 1, 0]"
531,24,24,48,0.32156181738319023,"[0, 0, 1, 1, 1, 1, 0, 1, 1, 1]"
532,5,5,10,0.44534288797548016,"[1, 1, 1, 0, 0, 0, 0, 0, 0, 1]"
533,5,5,10,0.09450355214996486,"[1, 0, 0, 0, 1, 0, 1, 0, 1, 1]"
534,1,1,2,0.844115383650712,"[1, 0, 1, 1, 1, 1, 0, 0, 0, 1]"
535,3,3,6,0.02479388812624206,"[1, 1, 0, 1, 0, 0, 1, 1, 0, 1]"
536,5,5,10,0.5569430966552974,"[0, 1, 1, 0, 1, 1, 1, 1, 1, 0]"
537,2,2,4,0.2328194819756263,"[0, 1, 1, 0, 0, 0, 1, 1, 0, 0]"
538,25,25,50,0.24083779596927324,"[1, 1, 1, 1, 0, 1, 0, 1, 1, 1]"
539,3,3,6,0.1638414148291616,"[0, 1, 1, 1, 0, 0, 0, 0, 0, 0]"
540,2,2,4,0.685539089240558,"[1, 0, 1, 1, 1, 1, 0, 1, 0, 1]"
541,3,3,6,0.40184486169694644,"[0, 0, 0, 0, 1, 1, 1, 0, 0, 0]"
542,5,5,10,0.05476486855803775,"[1, 1, 1, 1, 0, 0, 0, 0, 1, 0]"
543,29,29,58,0.568594416048324,"[1, 1, 1, 0, 1, 1, 1, 1, 0, 1]"
544,2,2,4,0.6788650926070245,"[1, 1, 0, 1, 0, 1, 1, 0, 1, 0]"
545,10,10,20,0.5843561861484761,"[0, 1, 1, 0, 0, 0, 0, 1, 1, 0]"
546,2,2,4,0.5716463098331154,"[1, 0, 0, 1, 0, 0, 1, 1, 0, 1]"
547,13,13,26,0.1469304233818408,"[1, 1, 0, 0, 1, 1, 1, 1, 1, 1]"
548,2,2,4,0.8770022332968773,"[0, 1, 1, 0, 1, 1, 0, 0, 1, 1]"
549,1,1,2,0.20249706073214002,"[1, 1, 0, 0, 0, 0, 0, 1, 1, 0]"
550,1,1,2,0.6761570830596284,"[0, 0, 0, 0, 1, 0, 1, 0, 1, 1]"
551,5,5,10,0.34211835483528086,"[1, 1, 1, 1, 0, 0, 1, 0, 0, 1]"
552,1,1,2,0.6535972873975674,"[0, 1, 0, 0, 0, 1, 0, 0, 0, 1]"
553,7,7,14,0.7039109338424534,"[0, 1, 1, 0, 0, 1, 1, 1, 1, 0]"
554,1,1,2,0.9438263732708173,"[1, 1, 1, 0, 0, 1, 0, 1, 0, 1]"
555,1,1,2,0.4274816590842724,"[0, 0, 1, 0, 0, 0, 1, 1, 1, 0]"
556,12,12,24,0.04508085619560642,"[1, 0, 1, 1, 1, 0, 1, 1, 0, 0]"
557,1,1,2,0.7125087831217508,"[1, 0, 0, 0, 0, 0, 0, 0, 0, 0]"
558,13,13,26,0.5524813464082086,"[0, 0, 0, 1, 1, 0, 0, 1, 1, 1]"
559,2,2,4,0.01702014024527365,"[1, 0, 1, 1, 0, 0, 0, 1, 1, 0]"
560,9,9,18,0.17058503854172902,"[1, 0, 0, 1, 0, 0, 0, 0, 0, 1]"
561,21,21,42,0.9739604303992025,"[1, 0, 1, 0, 0, 1, 1, 1, 1, 0]"
562,3,3,6,0.26758359945235555,"[0, 1, 0, 0, 0, 1, 0, 0, 0, 1]"
563,6,6,12,0.31352961335926244,"[0, 0, 1, 1, 1, 1, 1, 0, 0, 1]"
564,2,2,4,0.8587969403023549,"[0, 1, 0, 1, 1, 0, 0, 1, 0, 0]"
565,3,3,6,0.5328976029479883,"[1, 1, 1, 0, 0, 1, 1, 1, 0, 1]"
566,3,3,6,0.19888771090210589,"[1, 0, 1, 0, 0, 0, 1, 1, 1, 1]"
567,3,3,6,0.43675979354273153,"[1, 1, 1, 0, 0, 1, 1, 1, 1, 0]"
568,3,3,6,0.44821171845247487,"[0, 0, 1, 1, 0, 1, 1, 0, 1, 0]"
569,3,3,6,0.46920761202340266,"[1, 0, 1, 0, 1, 1, 1, 0, 0, 0]"
570,1,1,2,0.4590687237944707,"[1, 1, 0, 0, 1, 0, 0, 0, 1, 1]"
571,1,1,2,0.43995675875517315,"[0, 0, 1, 0, 0, 0, 1, 0, 1, 0]"
572,11,11,22,0.3239557536150166,"[1, 0, 0, 0, 1, 0, 0, 1, 0, 1]"
573,4,4,8,0.7914350570434796,"[1, 0, 1, 1, 0, 1, 0, 0, 0, 1]"
574,4,4,8,0.718162726601481,"[0, 1, 0, 0, 0, 1, 1, 0, 0, 0]"
575,4,4,8,0.14205468993268344,"[1, 1, 0, 1, 1, 0, 0, 0, 0, 0]"
576,4,4,8,0.37226192870233255,"[0, 1, 1, 0, 1, 1, 1, 1, 0, 0]"
577,1,1,2,0.30217105359826646,"[0, 1, 1, 0, 0, 0, 0, 0, 1, 1]"
578,2,2,4,0.46244734878761307,"[0, 1, 0, 0, 0, 1, 1, 0, 1, 1]"
579,1,1,2,0.7587781608033396,"[0, 1, 1, 1, 1, 0, 0, 0, 0, 0]"
580,18,18,36,0.034913719145750366,"[0, 1, 1, 1, 1, 1, 0, 0, 1, 0]"
581,7,7,14,0.7010551752655857,"[1, 1, 1, 0, 1, 1, 1, 0, 0, 1]"
582,14,14,28,0.4990552617029903,"[1, 1, 1, 0, 0, 1, 0, 0, 1, 1]"
583,6,6,12,0.6569168269248494,"[0, 1, 1, 0, 1, 1, 0, 0, 0, 1]"
584,11,11,22,0.15610843521607354,"[1, 0, 0, 1, 0, 1, 0, 1, 1, 0]"
585,10,10,20,0.22640457261859814,"[0, 1, 0, 1, 1, 0, 0, 1, 1, 0]"
586,5,5,10,0.5018007884018708,"[1, 1, 1, 0, 0, 1, 0, 0, 0, 0]"
587,3,3,6,0.683073187136133,"[0, 0, 1, 1, 1, 0, 0, 1, 1, 1]"
588,8,8,16,0.001952609271399286,"[0, 0, 1, 1, 0, 0, 0, 0, 0, 1]"
589,4,4,8,0.7161296046820426,"[1, 1, 0, 1, 1, 1, 1, 0, 1, 1]"
590,3,3,6,0.32347075456860575,"[1, 1, 1, 1, 0, 0, 0, 0, 1, 0]"
591,1,1,2,0.8177915071550277,"[0, 1, 0, 1, 1, 0, 0, 0, 0, 0]"
592,2,2,4,0.059569318071265975,"[1, 1, 0, 1, 1, 1, 1, 0, 0, 0]"
593,31,31,62,0.7429250035376069,"[1, 1, 1, 1, 0, 1, 1, 1, 0, 1]"
594,51,51,102,0.3148441024497898,"[1, 0, 1, 1, 1, 1, 1, 1, 0, 0]"
595,5,5,10,0.6109959964693319,"[0, 0, 0, 1, 0, 1, 0, 0, 1, 1]"
596,1,1,2,0.8580854137096429,"[0, 0, 1, 0, 1, 0, 0, 1, 0, 0]"
597,3,3,6,0.5491373137669131,"[0, 0, 1, 1, 1, 0, 1, 1, 0, 0]"
598,3,3,6,0.3928891844782372,"[1, 1, 1, 1, 0, 0, 1, 0, 0, 0]"
599,1,1,2,0.5075692312663902,"[1, 1, 0, 0, 0, 1, 1, 0, 1, 1]"
600,1,1,2,0.35014257369321644,"[0, 0, 0, 0, 0, 0, 1, 1, 0, 0]"
601,2,2,4,0.748879917039469,"[0, 0, 0, 1, 0, 1, 1, 0, 0, 1]"
602,1,1,2,0.9305742453370831,"[0, 0, 0, 1, 0, 1, 0, 0, 1, 1]"
603,12,12,24,0.5858021235643373,"[1, 1, 0, 1, 1, 1, 0, 0, 0, 0]"
604,4,4,8,0.015213973588997565,"[0, 1, 0, 1, 0, 0, 1, 0, 0, 1]"
605,1,1,2,0.9940998856284587,"[1, 0, 1, 0, 0, 1, 0, 1, 0, 0]"
606,2,2,4,0.3658643849269363,"[1, 1, 0, 1, 0, 0, 0, 1, 0, 0]"
607,1,1,2,0.3790177745632506,"[1, 0, 0, 0, 1, 1, 0, 0, 0, 0]"
608,21,21,42,0.28092509374137864,"[1, 1, 1, 0, 1, 1, 1, 1, 0, 1]"
609,1,1,2,0.07591460053980581,"[0, 1, 0, 0, 0, 0, 0, 0, 0, 1]"
610,9,9,18,0.2917223869109119,"[1, 0, 1, 0, 1, 0, 0, 0, 0, 1]"
611,3,3,6,0.1511726368036509,"[0, 1, 0, 1, 0, 1, 0, 1, 0, 1]"
612,5,5,10,0.14526048592038254,"[1, 1, 1, 0, 1, 1, 0, 1, 1, 1]"
613,2,2,4,0.1446841131129959,"[1, 0, 0, 0, 1, 1, 1, 0, 1, 1]"
614,1,1,2,0.21004644398420036,"[1, 1, 0, 0, 1, 1, 0, 0, 1, 1]"
615,1,1,2,0.4287562036788174,"[1, 0, 0, 0, 0, 1, 0, 1, 1, 1]"
616,6,6,12,0.1308507791587622,"[0, 0, 1, 1, 1, 1, 1, 0, 1, 0]"
617,1,1,2,0.4274226189253316,"[0, 1, 0, 0, 1, 1, 0, 0, 1, 0]"
618,8,8,16,0.7501745369746751,"[0, 0, 0, 1, 1, 1, 0, 0, 0, 1]"
619,5,5,10,0.20517391823566955,"[1, 0, 1, 0, 0, 1, 1, 1, 1, 1]"
620,9,9,18,0.3118447422547146,"[0, 1, 0, 1, 1, 1, 0, 1, 1, 1]"
621,1,1,2,0.4735051303150112,"[0, 0, 0, 0, 1, 1, 1, 0, 0, 0]"
622,3,3,6,0.3006506749720358,"[1, 1, 0, 1, 0, 0, 0, 1, 0, 1]"
623,3,3,6,0.9487573096997516,"[1, 0, 1, 1, 0, 0, 1, 1, 0, 0]"
624,3,3,6,0.16843536097506706,"[1, 1, 0, 0, 0, 1, 1, 1, 1, 0]"
625,7,7,14,0.8939764961319348,"[1, 1, 0, 1, 0, 1, 1, 1, 0, 1]"
626,18,18,36,0.8981529165811681,"[1, 1, 1, 1, 1, 1, 1, 0, 0, 1]"
627,13,13,26,0.054354673446354806,"[0, 1, 1, 1, 0, 0, 1, 0, 1, 1]"
628,12,12,24,0.6568675452660359,"[1, 0, 1, 0, 0, 1, 0, 1, 1, 0]"
629,1,1,2,0.27910940774837434,"[0, 0, 0, 0, 1, 0, 0, 0, 0, 0]"
630,15,15,30,0.760597658377448,"[1, 0, 1, 1, 0, 1, 1, 1, 0, 1]"
631,1,1,2,0.6623535275160134,"[0, 0, 1, 1, 0, 1, 1, 1, 1, 1]"
632,5,5,10,0.014691222931214942,"[0, 1, 1, 0, 0, 0, 0, 0, 0, 0]"
633,3,3,6,0.012677289263543168,"[0, 1, 0, 0, 0, 1, 0, 0, 0, 1]"
634,1,1,2,0.3779783515292987,"[0, 0, 1, 1, 0, 1, 0, 1, 0, 1]"
635,1,1,2,0.4343060356900934,"[0, 0, 0, 1, 0, 1, 1, 1, 1, 0]"
636,10,10,20,0.25155027298762755,"[0, 1, 0, 1, 0, 1, 0, 0, 1, 1]"
637,2,2,4,0.2738250349626903,"[1, 0, 0, 0, 0, 1, 0, 0, 1, 1]"
638,2,2,4,0.28892789969944876,"[1, 1, 1, 0, 0, 1, 1, 1, 0, 1]"
639,1,1,2,0.19812226172745961,"[1, 1, 0, 1, 0, 0, 0, 0, 0, 0]"
640,11,11,22,0.40561738511911316,"[0, 1, 1, 0, 1, 1, 1, 0, 0, 1]"
641,1,1,2,0.11632374067306184,"[1, 0, 0, 0, 1, 0, 0, 1, 0, 1]"
642,3,3,6,0.9205188796179781,"[1, 0, 0, 1, 0, 1, 0, 0, 0, 0]"
643,1,1,2,0.17672473777035813,"[0, 0, 0, 0, 0, 1, 0, 0, 0, 1]"
644,16,16,32,0.44224132276485617,"[1, 0, 1, 0, 1, 1, 0, 1, 1, 1]"
645,4,4,8,0.6394355419429241,"[1, 0, 0, 1, 1, 1, 1, 1, 1, 1]"
646,2,2,4,0.8452506511567407,"[1, 1, 0, 1, 0, 0, 1, 0, 0, 1]"
647,1,1,2,0.48777886778043045,"[0, 1, 0, 0, 0, 1, 0, 1, 1, 0]"
648,1,1,2,0.5549935135539661,"[1, 0, 1, 0, 0, 0, 1, 0, 0, 0]"
649,3,3,6,0.72099312105809,"[0, 0, 1, 1, 1, 1, 0, 0, 1, 0]"
650,9,9,18,0.17554057005738433,"[0, 1, 0, 1, 1, 0, 1, 0, 1, 1]"
651,1,1,2,0.07958605994889578,"[0, 1, 0, 0, 1, 0, 1, 0, 1, 1]"
652,1,1,2,0.8681228778185988,"[0, 1, 1, 1, 0, 0, 0, 0, 0, 1]"
653,4,4,8,0.76356653605153,"[0, 0, 1, 0, 1, 0, 1, 0, 1, 1]"
654,4,4,8,0.4289428599736418,"[0, 1, 0, 1, 0, 1, 1, 0, 1, 0]"
655,3,3,6,0.4474318299439949,"[0, 0, 0, 0, 0, 0, 1, 1, 1, 0]"
656,5,5,10,0.2196079967550706,"[0, 0, 1, 1, 0, 0, 1, 0, 0, 1]"
657,3,3,6,0.26461314053350804,"[0, 0, 0, 1, 1, 0, 1, 0, 1, 1]"
658,2,2,4,0.1053726096136719,"[0, 1, 0, 0, 0, 1, 0, 0, 0, 0]"
659,2,2,4,0.5595601951680007,"[0, 1, 0, 0, 1, 0, 0, 0, 0, 1]"
660,4,4,8,0.6878941238001778,"[1, 0, 1, 0, 0, 0, 1, 0, 0, 0]"
661,11,11,22,0.6430262813319612,"[1, 1, 0, 1, 0, 0, 0, 1, 0, 0]"
662,8,8,16,0.8979982643959059,"[1, 1, 0, 0, 1, 1, 0, 0, 1, 1]"
663,11,11,22,0.9788301693946699,"[1, 1, 0, 0, 0, 1, 1, 1, 0, 1]"
664,1,1,2,0.13848967330975448,"[0, 1, 1, 1, 1, 1, 1, 1, 1, 1]"
665,8,8,16,0.5670259621098367,"[1, 1, 0, 1, 1, 1, 0, 0, 0, 0]"
666,9,9,18,0.2943338620435738,"[0, 1, 1, 1, 1, 1, 1, 0, 0, 0]"
667,9,9,18,0.6625849860597143,"[1, 0, 0, 0, 0, 1, 1, 0, 1, 1]"
668,6,6,12,0.130603518532884,"[0, 1, 0, 1, 0, 0, 0, 0, 0, 1]"
669,2,2,4,0.5330718424754289,"[1, 0, 1, 0, 0, 1, 0, 0, 0, 0]"
670,1,1,2,0.6541736808542568,"[1, 0, 0, 1, 0, 1, 1, 1, 0, 0]"
671,9,9,18,0.7627986629680198,"[1, 0, 0, 1, 1, 0, 1, 0, 1, 1]"
672,5,5,10,0.8095237807384464,"[1, 0, 1, 0, 0, 1, 1, 0, 0, 1]"
673,4,4,8,0.7692464259000293,"[0, 0, 1, 1, 0, 1, 0, 0, 1, 0]"
674,1,1,2,0.04836753104061797,"[0, 1, 1, 0, 0, 0, 0, 0, 0, 1]"
675,1,1,2,0.7145383233414438,"[1, 0, 0, 1, 1, 0, 1, 0, 0, 0]"
676,4,4,8,0.6578989112510439,"[1, 1, 1, 0, 0, 0, 1, 0, 0, 0]"
677,13,13,26,0.36213802646443205,"[0, 1, 0, 0, 1, 0, 1, 1, 1, 1]"
678,1,1,2,0.5582425540446062,"[0, 0, 0, 1, 0, 0, 0, 0, 0, 0]"
679,2,2,4,0.5468170317626937,"[0, 0, 0, 0, 1, 0, 0, 0, 1, 1]"
680,2,2,4,0.06565552567350808,"[1, 0, 0, 0, 1, 0, 1, 0, 0, 0]"
681,11,11,22,0.37339195262483693,"[1, 1, 1, 1, 1, 0, 1, 0, 1, 1]"
682,1,1,2,0.23041100035354134,"[0, 0, 1, 0, 0, 0, 0, 0, 0, 0]"
683,3,3,6,0.7767296554538421,"[1, 0, 1, 0, 1, 0, 0, 1, 1, 1]"
684,1,1,2,0.7100444596636858,"[0, 1, 1, 0, 1, 0, 0, 1, 0, 0]"
685,3,3,6,0.767814961413943,"[0, 1, 0, 0, 1, 0, 1, 1, 0, 1]"
686,12,12,24,0.16329577785640148,"[1, 0, 1, 0, 1, 1, 0, 0, 1, 1]"
687,3,3,6,0.3693910754521633,"[0, 1, 0, 0, 0, 0, 0, 1, 0, 1]"
688,3,3,6,0.8650657904215222,"[1, 1, 1, 1, 0, 1, 1, 1, 1, 0]"
689,1,1,2,0.9922730941555722,"[0, 0, 1, 0, 1, 0, 0, 0, 1, 0]"
690,2,2,4,0.16949243702627748,"[0, 0, 1, 0, 1, 0, 0, 1, 0, 0]"
691,2,2,4,0.7473645598412234,"[1, 1, 0, 1, 0, 1, 0, 0, 0, 1]"
692,18,18,36,0.7312242781011976,"[0, 1, 1, 1, 0, 0, 1, 0, 1, 0]"
693,11,11,22,0.6001256151665698,"[1, 0, 1, 1, 0, 0, 0, 1, 0, 1]"
694,9,9,18,0.9087602558424461,"[1, 1, 0, 1, 1, 1, 1, 1, 0, 0]"
695,4,4,8,0.5072358958940097,"[1, 0, 1, 1, 0, 1, 1, 1, 1, 0]"
696,7,7,14,0.11921929190216818,"[0, 1, 0, 0, 0, 1, 0, 0, 0, 1]"
697,3,3,6,0.7548791862470173,"[1, 1, 0, 0, 1, 0, 0, 1, 1, 0]"
698,9,9,18,0.27010370604928113,"[0, 1, 1, 0, 1, 0, 1, 0, 1, 1]"
699,2,2,4,0.036423712546877374,"[0, 1, 1, 1, 1, 0, 1, 1, 0, 0]"
700,2,2,4,0.08772003633470105,"[1, 0, 0, 0, 1, 0, 0, 1, 0, 0]"
701,11,11,22,0.6432708607949384,"[0, 0, 1, 1, 1, 0, 1, 0, 0, 1]"
702,3,3,6,0.478978406633101,"[0, 0, 1, 1, 1, 0, 1, 1, 1, 1]"
703,1,1,2,0.4661857524016516,"[1, 0, 0, 1, 1, 0, 0, 0, 1, 0]"
704,3,3,6,0.6987049739063911,"[1, 0, 1, 0, 0, 1, 1, 1, 1, 1]"
705,2,2,4,0.15993511955506168,"[0, 1, 0, 1, 0, 0, 0, 1, 0, 1]"
706,3,3,6,0.05288838520403405,"[0, 0, 0, 1, 1, 1, 1, 0, 1, 1]"
707,12,12,24,0.3001790241318242,"[1, 0, 0, 1, 1, 1, 1, 1, 0, 0]"
708,2,2,4,0.07103203678420822,"[0, 0, 0, 0, 0, 1, 0, 0, 0, 1]"
709,4,4,8,0.8421891018805416,"[0, 1, 1, 1, 0, 0, 0, 0, 1, 1]"
710,1,1,2,0.13823012518043132,"[1, 1, 1, 1, 1, 0, 0, 0, 0, 0]"
711,6,6,12,0.3636500558843452,"[0, 1, 1, 1, 1, 0, 0, 1, 0, 0]"
712,9,9,18,0.3830546022381497,"[0, 0, 1, 0, 1, 0, 1, 0, 1, 1]"
713,1,1,2,0.8615165388173388,"[0, 1, 0, 0, 1, 0, 0, 0, 1, 1]"
714,1,1,2,0.12963765696811114,"[1, 0, 1, 0, 1, 0, 0, 0, 0, 0]"
715,4,4,8,0.35633642804077714,"[0, 0, 0, 0, 0, 1, 0, 0, 0, 1]"
716,11,11,22,0.44328717399316164,"[1, 1, 1, 0, 0, 1, 0, 1, 1, 1]"
717,4,4,8,0.3349571833830103,"[1, 0, 1, 0, 1, 0, 0, 1, 1, 1]"
718,5,5,10,0.9542363564332359,"[1, 1, 0, 1, 0, 1, 0, 1, 0, 0]"
719,4,4,8,0.19198422823847583,"[1, 0, 1, 1, 0, 1, 1, 1, 0, 0]"
720,4,4,8,0.02450975302175784,"[1, 1, 1, 0, 0, 1, 0, 0, 1, 0]"
721,2,2,4,0.0438224298123111,"[1, 1, 0, 0, 1, 1, 0, 1, 1, 1]"
722,6,6,12,0.42757206042705886,"[1, 1, 0, 1, 1, 0, 0, 1, 1, 0]"
723,2,2,4,0.6841860768680647,"[0, 0, 1, 0, 1, 1, 1, 1, 1, 0]"
724,9,9,18,0.7087893925130573,"[1, 1, 1, 1, 1, 0, 1, 0, 1, 1]"
725,9,9,18,0.6851033363933613,"[1, 1, 1, 0, 1, 0, 0, 1, 0, 1]"
726,1,1,2,0.6407981919488457,"[1, 1, 0, 0, 1, 0, 0, 0, 0, 0]"
727,8,8,16,0.953290105406107,"[0, 0, 1, 0, 0, 1, 0, 1, 1, 0]"
728,21,21,42,0.44998095877985145,"[1, 0, 0, 0, 1, 0, 1, 1, 1, 1]"
729,1,1,2,0.656053522964154,"[1, 0, 0, 1, 0, 1, 0, 1, 0, 0]"
730,4,4,8,0.8503913897217905,"[1, 0, 1, 0, 0, 1, 0, 0, 1, 0]"
731,14,14,28,0.35807773001909404,"[1, 0, 1, 0, 1, 0, 1, 0, 1, 1]"
732,9,9,18,0.38025265923231466,"[1, 0, 1, 1, 1, 0, 1, 1, 0, 1]"
733,5,5,10,0.8451761353987285,"[0, 1, 1, 0, 1, 1, 1, 0, 0, 0]"
734,2,2,4,0.8848048487576207,"[0, 1, 0, 1, 1, 0, 0, 0, 1, 1]"
735,5,5,10,0.9744351685395409,"[1, 1, 1, 1, 1, 1, 1, 0, 0, 1]"
736,1,1,2,0.026053187999240945,"[0, 1, 1, 1, 1, 0, 0, 0, 0, 1]"
737,18,18,36,0.6186447334753846,"[1, 1, 0, 1, 1, 0, 1, 0, 0, 0]"
738,2,2,4,0.3275152781405999,"[1, 1, 1, 1, 1, 1, 0, 0, 0, 1]"
739,2,2,4,0.871806208342135,"[0, 0, 0, 1, 0, 0, 0, 0, 1, 1]"
740,3,3,6,0.531806294983098,"[1, 0, 1, 1, 1, 0, 0, 0, 1, 1]"
741,7,7,14,0.38362255670391254,"[1, 0, 1, 0, 0, 1, 1, 0, 0, 1]"
742,1,1,2,0.3260136141490205,"[1, 1, 0, 1, 0, 0, 0, 0, 0, 0]"
743,7,7,14,0.44974383377248317,"[0, 1, 1, 0, 0, 1, 1, 1, 0, 1]"
744,1,1,2,0.7982146201666631,"[1, 0, 1, 0, 0, 1, 0, 1, 1, 0]"
745,8,8,16,0.9168134281898389,"[1, 1, 1, 0, 1, 0, 0, 0, 0, 1]"
746,9,9,18,0.2327707907055171,"[0, 1, 0, 1, 0, 1, 1, 1, 0, 0]"
747,17,17,34,0.4876005900476035,"[1, 0, 0, 1, 0, 1, 1, 1, 1, 1]"
748,3,3,6,0.8937487024848807,"[0, 0, 1, 1, 1, 0, 1, 0, 1, 1]"
749,2,2,4,0.9648200572788642,"[1, 1, 0, 1, 1, 0, 0, 0, 0, 1]"
750,1,1,2,0.9952262779401987,"[0, 0, 1, 0, 1, 0, 1, 0, 1, 0]"
751,4,4,8,0.11202093426114779,"[1, 1, 0, 0, 1, 0, 0, 1, 1, 0]"
752,3,3,6,0.11231895241905543,"[0, 0, 1, 0, 1, 0, 1, 1, 1, 1]"
753,9,9,18,0.4563964865576302,"[0, 0, 1, 0, 0, 0, 0, 1, 0, 1]"
754,3,3,6,0.3867851793061382,"[1, 1, 1, 0, 1, 1, 1, 1, 1, 1]"
755,1,1,2,0.11344091820749858,"[0, 0, 1, 0, 1, 0, 0, 1, 1, 0]"
756,15,15,30,0.8979084075567664,"[1, 0, 1, 0, 1, 0, 0, 1, 0, 1]"
757,4,4,8,0.36125174255597625,"[1, 1, 0, 0, 1, 0, 0, 0, 0, 1]"
758,11,11,22,0.8849953368568456,"[0, 0, 0, 1, 1, 0, 1, 1, 1, 1]"
759,17,17,34,0.15691096316347808,"[0, 1, 1, 1, 0, 1, 1, 1, 1, 1]"
760,1,1,2,0.5342740993896226,"[0, 0, 0, 1, 1, 0, 1, 0, 1, 1]"
761,14,14,28,0.010320074821453251,"[1, 0, 1, 0, 0, 0, 1, 1, 0, 1]"
762,4,4,8,0.6803762798392036,"[0, 1, 0, 1, 1, 1, 1, 0, 1, 0]"
763,8,8,16,0.847622642764522,"[0, 0, 1, 1, 0, 0, 1, 1, 0, 1]"
764,13,13,26,0.6662061720987692,"[1, 1, 1, 1, 0, 1, 0, 1, 1, 0]"
765,26,26,52,0.16143142548280154,"[1, 1, 1, 0, 1, 0, 1, 1, 0, 1]"
766,12,12,24,0.27825125131938355,"[0, 1, 1, 1, 0, 1, 0, 1, 1, 1]"
767,4,4,8,0.7325255603775174,"[1, 1, 1, 0, 1, 1, 0, 0, 1, 1]"
768,1,1,2,0.8488020708375879,"[0, 1, 1, 0, 1, 1, 0, 0, 0, 0]"
769,21,21,42,0.02648440607292779,"[1, 0, 1, 1, 1, 1, 0, 0, 1, 1]"
770,1,1,2,0.9751846373268948,"[1, 0, 1, 0, 1, 0, 0, 0, 0, 1]"
771,9,9,18,0.3024050821333878,"[1, 0, 1, 1, 1, 0, 0, 1, 1, 0]"
772,6,6,12,0.16316528961391064,"[1, 1, 1, 0, 1, 0, 0, 1, 1, 0]"
773,7,7,14,0.2537366857492225,"[1, 1, 1, 0, 0, 0, 1, 0, 0, 1]"
774,2,2,4,0.420305723698312,"[0, 0, 1, 0, 0, 0, 1, 0, 1, 1]"
775,2,2,4,0.725760631601391,"[0, 1, 1, 0, 1, 1, 1, 0, 0, 1]"
776,4,4,8,0.8482343235549391,"[0, 1, 0, 1, 0, 0, 1, 1, 1, 1]"
777,11,11,22,0.13082007389647932,"[1, 1, 1, 1, 0, 1, 1, 0, 0, 1]"
778,4,4,8,0.2755296397887913,"[0, 0, 0, 1, 0, 0, 0, 1, 0, 1]"
779,4,4,8,0.10697657462932786,"[1, 1, 0, 1, 1, 0, 1, 1, 0, 0]"
780,2,2,4,0.8109662274090376,"[0, 0, 1, 1, 0, 1, 1, 0, 0, 0]"
781,2,2,4,0.9217226490583916,"[0, 0, 1, 1, 1, 0, 0, 1, 1, 0]"
782,3,3,6,0.7961757465936383,"[1, 0, 0, 0, 1, 0, 0, 1, 0, 1]"
783,2,2,4,0.31116812863800014,"[0, 1, 0, 0, 1, 1, 0, 0, 0, 1]"
784,3,3,6,0.8355224200699807,"[1, 0, 0, 1, 1, 0, 1, 0, 0, 0]"
785,3,3,6,0.2168299314247366,"[1, 1, 0, 1, 1, 0, 0, 0, 0, 0]"
786,1,1,2,0.16257663135453726,"[0, 1, 1, 1, 0, 1, 1, 0, 1, 0]"
787,12,12,24,0.11184469431702992,"[1, 0, 1, 0, 1, 0, 0, 1, 1, 0]"
788,5,5,10,0.03769475888335361,"[1, 1, 1, 0, 0, 0, 0, 1, 1, 1]"
789,13,13,26,0.23628656931287684,"[1, 1, 1, 0, 1, 1, 0, 0, 1, 1]"
790,5,5,10,0.33652783757730875,"[1, 0, 1, 1, 0, 0, 1, 0, 0, 1]"
791,6,6,12,0.9496041957455889,"[0, 1, 1, 0, 1, 0, 0, 1, 1, 0]"
792,1,1,2,0.16989465635738554,"[0, 1, 1, 1, 0, 0, 1, 0, 1, 1]"
793,3,3,6,0.42950642664880423,"[1, 1, 1, 1, 0, 1, 1, 0, 1, 1]"
794,2,2,4,0.4450702798405718,"[0, 0, 0, 1, 1, 1, 1, 0, 0, 0]"
795,4,4,8,0.5113211924539416,"[0, 0, 1, 0, 1, 0, 0, 0, 0, 1]"
796,1,1,2,0.450055736886954,"[0, 1, 0, 1, 0, 1, 1, 0, 1, 1]"
797,16,16,32,0.19333989555846587,"[1, 0, 1, 0, 1, 1, 1, 1, 0, 1]"
798,5,5,10,0.9647185752667811,"[1, 1, 0, 0, 0, 0, 1, 1, 0, 1]"
799,2,2,4,0.5984074749631737,"[0, 0, 1, 0, 0, 1, 1, 1, 1, 0]"
800,8,8,16,0.6101021646482505,"[0, 1, 1, 0, 1, 0, 1, 1, 0, 1]"
801,5,5,10,0.30579981246789667,"[1, 0, 1, 0, 0, 1, 1, 1, 1, 0]"
802,3,3,6,0.5855502878709307,"[1, 0, 1, 0, 1, 0, 0, 0, 1, 1]"
803,2,2,4,0.15012778161583473,"[0, 0, 1, 0, 0, 0, 0, 0, 0, 1]"
804,2,2,4,0.6456273074403676,"[1, 1, 0, 1, 1, 1, 1, 0, 1, 1]"
805,8,8,16,0.4777178156071695,"[1, 1, 1, 1, 0, 0, 0, 1, 1, 0]"
806,1,1,2,0.9728936473430299,"[0, 1, 1, 0, 1, 0, 1, 0, 1, 0]"
807,8,8,16,0.22410205896821067,"[0, 0, 0, 1, 0, 1, 0, 0, 0, 1]"
808,5,5,10,0.12865398716959808,"[1, 1, 1, 1, 1, 1, 1, 0, 0, 0]"
809,1,1,2,0.05479346204215052,"[0, 0, 1, 1, 0, 0, 0, 0, 1, 0]"
810,2,2,4,0.4509879964689234,"[0, 0, 1, 1, 0, 1, 1, 0, 1, 1]"
811,3,3,6,0.9232993336010126,"[0, 1, 1, 1, 0, 1, 0, 0, 1, 0]"
812,1,1,2,0.8754259128905351,"[0, 0, 1, 0, 0, 1, 1, 1, 1, 0]"
813,2,2,4,0.5443579718068643,"[0, 1, 1, 1, 0, 1, 0, 1, 0, 1]"
814,5,5,10,0.7604348617410357,"[0, 0, 1, 1, 0, 0, 0, 1, 1, 0]"
815,2,2,4,0.5585444285840796,"[1, 0, 1, 1, 1, 0, 0, 0, 0, 0]"
816,3,3,6,0.11653365931193804,"[0, 1, 1, 1, 1, 1, 0, 0, 1, 0]"
817,2,2,4,0.2974900284604959,"[1, 0, 1, 0, 1, 0, 0, 0, 1, 0]"
818,1,1,2,0.9463007233730782,"[0, 1, 0, 1, 1, 0, 0, 1, 0, 0]"
819,4,4,8,0.267123466060609,"[1, 0, 0, 1, 0, 1, 0, 1, 0, 1]"
820,1,1,2,0.9275508028914353,"[1, 0, 0, 0, 1, 0, 0, 0, 1, 0]"
821,6,6,12,0.8737982350164726,"[0, 1, 0, 1, 1, 0, 1, 0, 1, 1]"
822,2,2,4,0.7900434377426552,"[1, 1, 0, 1, 0, 0, 0, 1, 1, 1]"
823,13,13,26,0.6120769678938223,"[1, 0, 1, 1, 0, 0, 1, 0, 0, 1]"
824,4,4,8,0.8950595322969847,"[1, 1, 1, 0, 1, 1, 1, 0, 0, 1]"
825,4,4,8,0.016026334928236352,"[1, 1, 0, 1, 1, 1, 1, 0, 1, 1]"
826,8,8,16,0.9358505986352409,"[0, 1, 0, 1, 0, 0, 0, 0, 0, 1]"
827,22,22,44,0.10835607101324785,"[0, 1, 1, 1, 1, 1, 0, 1, 0, 1]"
828,5,5,10,0.40610188813830195,"[0, 0, 1, 0, 1, 1, 1, 1, 1, 0]"
829,2,2,4,0.481186543542128,"[0, 0, 0, 1, 1, 0, 0, 0, 0, 0]"
830,1,1,2,0.8613394208855059,"[0, 0, 1, 1, 0, 0, 0, 1, 0, 0]"
831,1,1,2,0.12517801805586026,"[1, 0, 0, 0, 0, 0, 0, 0, 1, 0]"
832,6,6,12,0.7064075305502501,"[1, 1, 1, 1, 0, 0, 1, 1, 1, 1]"
833,6,6,12,0.18405878400909503,"[1, 0, 1, 1, 0, 0, 1, 0, 0, 1]"
834,2,2,4,0.2820937947472797,"[1, 0, 1, 0, 0, 1, 1, 0, 1, 1]"
835,4,4,8,0.008524655076935006,"[1, 0, 1, 0, 0, 1, 0, 1, 1, 0]"
836,2,2,4,0.25752544070920147,"[1, 1, 1, 0, 1, 1, 0, 0, 0, 0]"
837,3,3,6,0.7467231990736356,"[1, 0, 0, 0, 1, 1, 0, 0, 0, 0]"
838,8,8,16,0.17535551877383704,"[1, 0, 0, 0, 1, 1, 0, 1, 0, 0]"
839,3,3,6,0.2928922957017883,"[1, 1, 1, 0, 0, 1, 0, 1, 0, 1]"
840,10,10,20,0.23724528313070858,"[0, 1, 0, 0, 0, 1, 1, 0, 1, 1]"
841,7,7,14,0.3228333354544599,"[1, 1, 0, 0, 1, 0, 1, 1, 0, 1]"
842,5,5,10,0.2326721776579611,"[1, 0, 1, 1, 0, 0, 1, 1, 1, 1]"
843,1,1,2,0.35160674136693737,"[0, 1, 1, 0, 0, 1, 1, 0, 1, 1]"
844,12,12,24,0.2782379989204431,"[0, 1, 1, 0, 1, 1, 1, 1, 1, 0]"
845,1,1,2,0.8145938720818416,"[0, 0, 0, 1, 0, 1, 1, 1, 1, 1]"
846,4,4,8,0.8305142451393402,"[0, 1, 1, 1, 1, 0, 0, 1, 1, 0]"
847,4,4,8,0.7159597718065082,"[0, 1, 0, 1, 0, 1, 1, 0, 1, 1]"
848,1,1,2,0.9136369618560172,"[0, 1, 0, 0, 1, 1, 1, 0, 0, 0]"
849,1,1,2,0.3812208150408122,"[0, 0, 1, 0, 0, 1, 0, 1, 1, 0]"
850,4,4,8,0.4696300818547704,"[1, 0, 1, 0, 0, 0, 0, 0, 0, 1]"
851,1,1,2,0.858540124697513,"[0, 0, 0, 0, 1, 0, 0, 0, 1, 0]"
852,2,2,4,0.1996685351083779,"[0, 1, 1, 0, 1, 1, 0, 0, 0, 1]"
853,1,1,2,0.18888344889574116,"[0, 1, 1, 1, 0, 1, 0, 0, 1, 1]"
854,1,1,2,0.0728780245517513,"[0, 1, 1, 1, 1, 0, 1, 0, 0, 1]"
855,1,1,2,0.49495322669031294,"[1, 1, 0, 0, 0, 1, 0, 0, 0, 1]"
856,1,1,2,0.46135109504043104,"[0, 0, 1, 1, 0, 0, 0, 1, 1, 0]"
857,21,21,42,0.20214795117712414,"[1, 0, 1, 1, 1, 1, 1, 1, 0, 1]"
858,4,4,8,0.1156656770753719,"[0, 0, 1, 0, 1, 1, 0, 1, 1, 0]"
859,7,7,14,0.7917431926459839,"[1, 1, 0, 1, 1, 0, 0, 1, 0, 1]"
860,2,2,4,0.9357785750264254,"[1, 1, 0, 0, 0, 0, 0, 0, 0, 1]"
861,4,4,8,0.1359502486219748,"[0, 0, 1, 1, 0, 1, 1, 0, 0, 1]"
862,5,5,10,0.6805899115684357,"[1, 0, 0, 0, 0, 1, 1, 0, 0, 0]"
863,4,4,8,0.23394711920949096,"[0, 0, 0, 0, 1, 1, 1, 0, 0, 0]"
864,1,1,2,0.11523265934712335,"[0, 0, 0, 1, 1, 0, 0, 1, 0, 0]"
865,3,3,6,0.4521810083474901,"[1, 0, 0, 1, 1, 0, 1, 1, 1, 1]"
866,7,7,14,0.3742391836198312,"[0, 1, 1, 0, 1, 1, 0, 1, 0, 1]"
867,3,3,6,0.5524858496096202,"[1, 0, 0, 0, 1, 0, 0, 0, 0, 0]"
868,1,1,2,0.13259720688028998,"[0, 0, 1, 1, 1, 1, 0, 0, 0, 0]"
869,1,1,2,0.42005604583391454,"[1, 1, 1, 0, 1, 1, 0, 1, 0, 0]"
870,14,14,28,0.7631923179849891,"[1, 0, 1, 1, 0, 1, 0, 0, 0, 1]"
871,1,1,2,0.6333185564918411,"[0, 1, 1, 0, 1, 0, 0, 0, 1, 0]"
872,6,6,12,0.2774461584289115,"[1, 1, 0, 1, 0, 1, 1, 0, 0, 0]"
873,5,5,10,0.761675213146299,"[1, 0, 1, 0, 1, 1, 1, 0, 0, 0]"
874,1,1,2,0.7856891127206583,"[0, 0, 0, 1, 0, 0, 0, 1, 1, 0]"
875,3,3,6,0.5353491882301535,"[1, 0, 1, 1, 1, 1, 1, 0, 1, 1]"
876,21,21,42,0.5452578966046696,"[0, 1, 0, 1, 1, 1, 1, 1, 0, 0]"
877,1,1,2,0.46570173627580147,"[0, 1, 0, 0, 1, 0, 1, 0, 1, 1]"
878,3,3,6,0.23049897724187962,"[0, 1, 1, 0, 1, 1, 0, 0, 0, 1]"
879,4,4,8,0.9020434366357526,"[1, 1, 1, 0, 0, 1, 1, 0, 1, 1]"
880,8,8,16,0.017157819890987747,"[1, 1, 0, 0, 1, 1, 1, 1, 1, 0]"
881,2,2,4,0.7245789871003928,"[0, 1, 1, 0, 1, 1, 0, 0, 1, 0]"
882,4,4,8,0.151874722022033,"[1, 1, 0, 0, 0, 1, 0, 1, 0, 0]"
883,5,5,10,0.07091326966867983,"[0, 0, 0, 1, 1, 1, 0, 0, 1, 1]"
884,3,3,6,0.2878344260938174,"[1, 1, 1, 1, 0, 0, 1, 0, 0, 0]"
885,14,14,28,0.5757519561694671,"[1, 1, 1, 0, 0, 1, 1, 1, 0, 0]"
886,7,7,14,0.10831009104071354,"[1, 0, 1, 1, 0, 0, 0, 1, 1, 1]"
887,1,1,2,0.8440227133247841,"[0, 0, 0, 0, 0, 1, 0, 0, 0, 1]"
888,3,3,6,0.7702486576897164,"[0, 1, 0, 0, 0, 1, 1, 1, 1, 0]"
889,1,1,2,0.18260142182062122,"[1, 1, 0, 0, 0, 0, 0, 1, 1, 0]"
890,5,5,10,0.6537422825615302,"[1, 0, 1, 0, 0, 0, 1, 1, 1, 0]"
891,8,8,16,0.022129467491071253,"[1, 1, 0, 1, 0, 0, 1, 1, 0, 1]"
892,1,1,2,0.5016703186487299,"[0, 0, 1, 1, 0, 1, 0, 1, 0, 1]"
893,6,6,12,0.034910254576078104,"[0, 0, 1, 0, 1, 1, 1, 1, 1, 1]"
894,2,2,4,0.8843599001339836,"[0, 1, 1, 0, 0, 0, 1, 1, 1, 1]"
895,10,10,20,0.42227313146365486,"[1, 0, 1, 1, 0, 0, 1, 1, 1, 1]"
896,10,10,20,0.9237039000901967,"[0, 1, 0, 1, 1, 1, 1, 1, 1, 0]"
897,3,3,6,0.3340302899749601,"[1, 1, 0, 0, 0, 1, 1, 0, 1, 0]"
898,1,1,2,0.31480845996212126,"[0, 0, 1, 0, 1, 1, 1, 0, 0, 1]"
899,2,2,4,0.23631416303153474,"[0, 1, 0, 0, 1, 0, 1, 1, 1, 0]"
900,3,3,6,0.14531744248749656,"[0, 1, 0, 0, 1, 0, 1, 0, 1, 0]"
901,1,1,2,0.3697065116194139,"[1, 0, 1, 1, 1, 0, 0, 1, 0, 1]"
902,2,2,4,0.49697306932878504,"[1, 1, 0, 1, 0, 1, 1, 0, 0, 1]"
903,3,3,6,0.11741748758567305,"[1, 1, 0, 1, 0, 0, 1, 0, 1, 1]"
904,2,2,4,0.8208219876971616,"[1, 0, 0, 0, 0, 1, 0, 0, 1, 0]"
905,5,5,10,0.5117084074500013,"[1, 0, 0, 1, 0, 0, 1, 1, 1, 1]"
906,1,1,2,0.9900858583086289,"[1, 1, 1, 1, 0, 0, 0, 0, 0, 1]"
907,11,11,22,0.11096511510888607,"[1, 0, 1, 1, 0, 0, 1, 1, 1, 1]"
908,7,7,14,0.3661541775936977,"[1, 0, 1, 1, 1, 0, 0, 1, 1, 0]"
909,14,14,28,0.2456626732237578,"[1, 1, 0, 1, 1, 0, 1, 1, 0, 1]"
910,7,7,14,0.44612552851684106,"[1, 1, 1, 0, 1, 1, 0, 1, 0, 0]"
911,3,3,6,0.3024654283722553,"[1, 0, 0, 0, 0, 0, 1, 0, 1, 1]"
912,1,1,2,0.7779303270794945,"[1, 0, 0, 1, 0, 1, 1, 1, 1, 1]"
913,2,2,4,0.5206946433194914,"[1, 1, 0, 1, 1, 0, 1, 1, 1, 1]"
914,7,7,14,0.658346166522509,"[1, 0, 1, 1, 1, 0, 1, 0, 1, 1]"
915,2,2,4,0.0765737485565634,"[0, 0, 0, 0, 0, 0, 1, 0, 1, 0]"
916,6,6,12,0.296980389262789,"[0, 1, 1, 0, 1, 1, 0, 1, 0, 1]"
917,4,4,8,0.4130368237654697,"[0, 0, 0, 0, 1, 0, 1, 1, 0, 0]"
918,1,1,2,0.4197991084846412,"[0, 1, 0, 0, 0, 1, 0, 1, 0, 0]"
919,1,1,2,0.5922248396353711,"[1, 1, 0, 0, 1, 0, 0, 0, 0, 0]"
920,1,1,2,0.8372015545231195,"[1, 0, 0, 0, 0, 1, 1, 1, 0, 0]"
921,4,4,8,0.7842769744885577,"[0, 1, 1, 0, 0, 1, 1, 0, 0, 0]"
922,2,2,4,0.34378577284220646,"[0, 0, 0, 1, 1, 0, 1, 0, 0, 1]"
923,7,7,14,0.8580394114849894,"[1, 0, 1, 1, 0, 0, 0, 0, 0, 0]"
924,4,4,8,0.5645100954081398,"[1, 0, 0, 0, 1, 1, 0, 1, 1, 0]"
925,5,5,10,0.6971601652099373,"[0, 0, 1, 0, 1, 0, 1, 1, 1, 1]"
926,1,1,2,0.43472116317689413,"[0, 0, 1, 0, 1, 0, 0, 1, 1, 0]"
927,5,5,10,0.9319781147747805,"[1, 1, 0, 1, 0, 1, 0, 1, 0, 1]"
928,1,1,2,0.7317206568975707,"[0, 0, 0, 0, 1, 0, 0, 0, 1, 0]"
929,2,2,4,0.8990740643372411,"[0, 1, 0, 0, 0, 0, 1, 1, 1, 0]"
930,2,2,4,0.5338649603468798,"[1, 1, 1, 0, 0, 1, 1, 0, 0, 1]"
931,2,2,4,0.27059628630031185,"[0, 0, 1, 0, 1, 0, 0, 1, 0, 1]"
932,2,2,4,0.046839170949089515,"[1, 0, 0, 0, 0, 1, 1, 0, 0, 0]"
933,12,12,24,0.5746526918585063,"[0, 1, 1, 1, 0, 1, 1, 1, 1, 0]"
934,1,1,2,0.8978265275816821,"[0, 1, 1, 0, 1, 0, 1, 1, 1, 0]"
935,10,10,20,0.4062099627847866,"[0, 1, 0, 1, 1, 1, 1, 1, 0, 1]"
936,4,4,8,0.662809310990981,"[1, 0, 1, 1, 0, 0, 1, 1, 1, 1]"
937,5,5,10,0.40767676146507403,"[1, 0, 0, 0, 0, 1, 1, 1, 0, 1]"
938,1,1,2,0.6981890685321227,"[1, 1, 0, 1, 1, 1, 0, 1, 1, 1]"
939,2,2,4,0.12504644069542104,"[1, 1, 0, 1, 0, 0, 0, 1, 1, 0]"
940,5,5,10,0.25438588671749784,"[1, 1, 1, 0, 0, 0, 0, 0, 1, 1]"
941,15,15,30,0.2886667184999876,"[1, 1, 0, 1, 1, 1, 0, 1, 0, 0]"
942,1,1,2,0.07530806803887735,"[0, 0, 1, 0, 1, 0, 0, 0, 0, 0]"
943,3,3,6,0.047696866601887544,"[0, 1, 1, 1, 0, 1, 0, 0, 1, 0]"
944,3,3,6,0.029483479982106764,"[1, 0, 0, 0, 0, 1, 0, 0, 1, 1]"
945,2,2,4,0.47926884853470586,"[1, 1, 0, 1, 0, 0, 0, 0, 1, 0]"
946,5,5,10,0.5483543534284727,"[0, 1, 0, 1, 0, 1, 1, 0, 1, 1]"
947,5,5,10,0.8309505650559847,"[0, 1, 1, 1, 0, 1, 1, 0, 1, 1]"
948,2,2,4,0.9229747726553009,"[1, 0, 0, 0, 0, 1, 0, 1, 1, 1]"
949,17,17,34,0.9498086403087307,"[1, 1, 1, 0, 0, 0, 1, 1, 1, 1]"
950,1,1,2,0.6490076175303781,"[0, 1, 0, 0, 1, 0, 1, 1, 0, 1]"
951,3,3,6,0.25342509773763555,"[1, 1, 0, 0, 0, 1, 1, 0, 0, 1]"
952,2,2,4,0.45060723170227557,"[1, 1, 0, 1, 1, 1, 0, 1, 0, 0]"
953,6,6,12,0.10944925824284502,"[1, 0, 0, 1, 1, 0, 1, 1, 1, 0]"
954,3,3,6,0.5109660434652088,"[0, 0, 1, 0, 0, 0, 0, 0, 1, 1]"
955,1,1,2,0.4150654089104,"[0, 0, 1, 0, 1, 1, 1, 0, 0, 1]"
956,1,1,2,0.6401500922925066,"[1, 1, 0, 1, 0, 1, 1, 1, 0, 1]"
957,4,4,8,0.7502073723947673,"[0, 0, 1, 1, 0, 1, 1, 1, 1, 1]"
958,3,3,6,0.3709637311912968,"[1, 0, 1, 0, 1, 0, 0, 1, 0, 1]"
959,13,13,26,0.36081225569394615,"[0, 1, 1, 0, 1, 1, 1, 0, 1, 0]"
960,2,2,4,0.06282579839373692,"[0, 0, 1, 0, 1, 1, 1, 1, 0, 0]"
961,4,4,8,0.9460578793667771,"[1, 0, 0, 1, 0, 0, 1, 1, 0, 0]"
962,22,22,44,0.3352806442847961,"[0, 1, 0, 1, 1, 1, 0, 0, 1, 1]"
963,1,1,2,0.407228837940084,"[0, 0, 0, 0, 0, 1, 1, 0, 0, 1]"
964,13,13,26,0.7211203957989951,"[1, 1, 0, 0, 1, 1, 1, 0, 0, 0]"
965,3,3,6,0.4298315989946869,"[0, 1, 0, 0, 0, 1, 0, 1, 1, 0]"
966,2,2,4,0.8600867336563385,"[1, 0, 0, 1, 0, 1, 0, 0, 0, 0]"
967,3,3,6,0.8916510320823576,"[1, 0, 0, 0, 0, 1, 1, 0, 0, 0]"
968,12,12,24,0.5955763096631669,"[1, 0, 1, 0, 1, 0, 1, 1, 0, 0]"
969,1,1,2,0.655714496443177,"[0, 0, 0, 0, 1, 0, 0, 1, 1, 0]"
970,2,2,4,0.3443485137119071,"[1, 0, 0, 1, 0, 1, 0, 0, 0, 1]"
971,1,1,2,0.05294200096325796,"[1, 0, 1, 0, 0, 1, 0, 0, 0, 0]"
972,17,17,34,0.29590744163639193,"[1, 0, 1, 1, 1, 1, 0, 1, 1, 0]"
973,1,1,2,0.1224835783569953,"[1, 0, 0, 0, 1, 0, 1, 1, 0, 0]"
974,2,2,4,0.2946307387507524,"[1, 0, 0, 1, 1, 1, 1, 1, 0, 0]"
975,2,2,4,0.525599434650953,"[0, 0, 0, 0, 1, 1, 1, 0, 0, 0]"
976,3,3,6,0.3802087718800746,"[0, 0, 1, 0, 1, 0, 1, 0, 1, 0]"
977,1,1,2,0.9205087798597024,"[0, 0, 0, 0, 1, 0, 0, 0, 0, 1]"
978,2,2,4,0.40741386065231755,"[0, 0, 0, 1, 0, 0, 1, 0, 0, 1]"
979,4,4,8,0.8468970223781329,"[0, 1, 0, 0, 1, 0, 0, 1, 0, 1]"
980,18,18,36,0.9064726754025129,"[1, 1, 1, 1, 0, 1, 1, 1, 1, 0]"
981,1,1,2,0.7680269032370408,"[1, 0, 0, 1, 0, 0, 1, 1, 0, 0]"
982,3,3,6,0.8587585696060527,"[1, 1, 1, 1, 1, 1, 1, 0, 1, 0]"
983,5,5,10,0.7944596590704256,"[1, 1, 0, 1, 0, 0, 1, 1, 0, 0]"
984,3,3,6,0.10225941448304687,"[1, 0, 0, 0, 0, 0, 1, 1, 1, 0]"
985,1,1,2,0.16985049987407552,"[0, 0, 0, 0, 0, 1, 0, 1, 1, 0]"
986,12,12,24,0.4772166309191592,"[0, 0, 0, 1, 1, 0, 0, 1, 1, 0]"
987,3,3,6,0.7450553724698896,"[1, 1, 1, 1, 0, 0, 1, 0, 0, 1]"
988,5,5,10,0.9575986235760554,"[0, 0, 1, 0, 1, 0, 1, 0, 1, 1]"
989,2,2,4,0.518078990301264,"[0, 1, 0, 1, 0, 1, 0, 0, 0, 1]"
990,2,2,4,0.47215825084983654,"[0, 1, 0, 1, 1, 0, 1, 1, 1, 1]"
991,1,1,2,0.9412208341515185,"[1, 1, 0, 0, 1, 0, 1, 1, 1, 0]"
992,5,5,10,0.5286975597206373,"[0, 0, 1, 0, 0, 1, 0, 1, 0, 0]"
993,7,7,14,0.17682394311722582,"[0, 1, 1, 1, 1, 0, 1, 0, 1, 1]"
994,12,12,24,0.8741524792634818,"[1, 1, 1, 1, 1, 1, 1, 1, 0, 1]"
995,4,4,8,0.6402051005929484,"[0, 1, 0, 0, 0, 1, 1, 0, 1, 1]"
996,4,4,8,0.5935418871746567,"[1, 1, 0, 1, 1, 1, 1, 0, 0, 1]"
997,3,3,6,0.4523802220102674,"[0, 0, 0, 0, 1, 0, 1, 1, 0, 0]"
998,1,1,2,0.3611546818997531,"[1, 0, 1, 1, 1, 0, 0, 0, 1, 1]"
999,7,7,14,0.9210413684160672,"[1, 0, 1, 1, 0, 0, 1, 0, 0, 1]"
1000,13,13,26,0.8958830414809612,"[1, 1, 1, 0, 1, 0, 1, 1, 1, 1]"
1001,2,2,4,0.5265565688265732,"[1, 0, 1, 1, 0, 0, 0, 1, 0, 1]"
1002,5,5,10,0.42940024946205924,"[0, 0, 0, 0, 0, 1, 0, 1, 1, 1]"
1003,3,3,6,0.3753373710408532,"[1, 0, 0, 0, 1, 0, 0, 1, 1, 1]"
1004,18,18,36,0.9232891163877183,"[1, 1, 1, 1, 1, 1, 1, 1, 0, 1]"
1005,2,2,4,0.44079617451659336,"[0, 0, 0, 0, 0, 1, 0, 1, 1, 0]"
1006,3,3,6,0.28533343097377806,"[0, 1, 1, 1, 1, 0, 1, 1, 1, 0]"
1007,3,3,6,0.3705501385581176,"[0, 0, 1, 1, 0, 0, 0, 1, 0, 1]"
1008,2,2,4,0.7615708231067824,"[0, 0, 1, 0, 1, 1, 0, 0, 0, 1]"
1009,6,6,12,0.12900651525647566,"[1, 0, 1, 1, 1, 0, 1, 1, 0, 0]"
1010,4,4,8,0.7228250291511298,"[1, 1, 0, 0, 1, 0, 0, 0, 0, 0]"
1011,2,2,4,0.18581913214326407,"[0, 0, 0, 1, 0, 1, 0, 1, 1, 1]"
1012,1,1,2,0.8827058082518131,"[0, 1, 0, 1, 1, 0, 0, 1, 0, 0]"
1013,1,1,2,0.31793838041886835,"[0, 0, 1, 0, 0, 1, 0, 0, 1, 0]"
1014,1,1,2,0.2841948922830402,"[0, 1, 1, 1, 1, 0, 1, 0, 0, 1]"
1015,1,1,2,0.32780953126549617,"[0, 1, 0, 1, 1, 0, 1, 0, 0, 0]"
1016,11,11,22,0.4549064255016275,"[0, 1, 0, 0, 1, 1, 1, 1, 1, 0]"
1017,1,1,2,0.3256039572302555,"[1, 0, 0, 0, 0, 0, 1, 0, 0, 0]"
1018,1,1,2,0.14045843774989497,"[0, 1, 0, 0, 1, 0, 1, 1, 1, 0]"
1019,2,2,4,0.9202534061569464,"[0, 1, 0, 1, 0, 0, 1, 1, 0, 1]"
1020,9,9,18,0.3695425145456842,"[1, 0, 0, 1, 0, 1, 1, 1, 0, 1]"
1021,1,1,2,0.5578556357684172,"[1, 1, 1, 1, 1, 0, 0, 0, 0, 0]"
1022,6,6,12,0.34074944652290373,"[1, 1, 1, 0, 1, 0, 1, 0, 1, 1]"
1023,2,2,4,0.8656379776666558,"[1, 1, 0, 1, 0, 0, 1, 0, 0, 0]"
1024,1,1,2,0.4962352092256562,"[0, 1, 0, 0, 0, 0, 0, 0, 1, 0]"
1025,3,3,6,0.18860043879234445,"[1, 0, 1, 1, 1, 1, 1, 1, 1, 1]"
1026,2,2,4,0.46115312544902554,"[0, 1, 0, 0, 0, 1, 0, 1, 0, 1]"
1027,24,24,48,0.0484783112225341,"[0, 1, 1, 0, 1, 1, 1, 0, 1, 1]"
1028,1,1,2,0.5739391335957075,"[0, 0, 1, 0, 0, 0, 0, 0, 1, 1]"
1029,7,7,14,0.6242910299140304,"[1, 1, 1, 0, 1, 1, 0, 0, 1, 0]"
1030,5,5,10,0.4156067190161611,"[1, 0, 1, 1, 1, 0, 1, 1, 0, 0]"
1031,5,5,10,0.8069814763439686,"[1, 1, 0, 1, 0, 1, 0, 1, 1, 1]"
1032,1,1,2,0.05563769863598145,"[0, 0, 0, 1, 1, 1, 0, 0, 1, 0]"
1033,1,1,2,0.8157757058981128,"[1, 0, 0, 0, 1, 1, 1, 1, 0, 0]"
1034,3,3,6,0.08797517739633953,"[0, 0, 1, 1, 0, 1, 0, 0, 1, 1]"
1035,3,3,6,0.04086455889100926,"[1, 1, 0, 1, 0, 1, 0, 1, 1, 0]"
1036,5,5,10,0.9564522995743711,"[1, 0, 1, 1, 1, 0, 1, 0, 0, 0]"
1037,5,5,10,0.8841794669883111,"[1, 1, 0, 1, 0, 0, 0, 1, 1, 1]"
1038,1,1,2,0.9950728046437259,"[1, 1, 0, 0, 1, 1, 0, 0, 0, 0]"
1039,1,1,2,0.37179519275064854,"[0, 0, 0, 0, 0, 0, 0, 0, 0, 0]"
1040,6,6,12,0.12669561027859988,"[0, 1, 0, 1, 1, 1, 0, 0, 1, 0]"
1041,5,5,10,0.8227578142499145,"[1, 0, 0, 1, 1, 1, 1, 1, 0, 1]"
1042,1,1,2,0.38911478720690273,"[0, 1, 0, 1, 1, 1, 1, 0, 1, 0]"
1043,10,10,20,0.8628417800571769,"[1, 1, 0, 0, 1, 0, 1, 0, 0, 0]"
1044,6,6,12,0.21416535321204888,"[0, 1, 0, 1, 0, 1, 1, 0, 1, 0]"
1045,13,13,26,0.3190786758581856,"[1, 0, 0, 1, 0, 1, 1, 1, 0, 0]"
1046,1,1,2,0.7714058731621198,"[0, 0, 1, 1, 1, 1, 0, 1, 1, 1]"
1047,2,2,4,0.9288402831788267,"[0, 0, 1, 1, 0, 1, 0, 0, 1, 1]"
1048,3,3,6,0.3310923636598827,"[1, 1, 0, 0, 1, 0, 0, 1, 1, 1]"
1049,1,1,2,0.5686792452765241,"[1, 0, 1, 0, 0, 0, 1, 1, 0, 0]"
1050,2,2,4,0.7684367988354066,"[0, 0, 1, 0, 0, 0, 0, 0, 0, 0]"
1051,4,4,8,0.15018195222831032,"[1, 1, 1, 1, 0, 0, 0, 0, 1, 1]"
1052,3,3,6,0.8174163069481659,"[0, 0, 1, 0, 1, 0, 1, 0, 0, 1]"
1053,1,1,2,0.06469313753639605,"[0, 1, 1, 1, 1, 0, 1, 0, 0, 1]"
1054,2,2,4,0.3996208797085772,"[0, 0, 1, 0, 0, 1, 1, 0, 0, 0]"
1055,3,3,6,0.18016281520375343,"[0, 1, 0, 0, 0, 0, 1, 0, 1, 1]"
1056,1,1,2,0.7651668690005551,"[0, 0, 0, 0, 1, 1, 1, 0, 1, 1]"
1057,10,10,20,0.13582828285029913,"[0, 1, 0, 1, 1, 1, 1, 0, 0, 0]"
1058,4,4,8,0.008781474121524524,"[0, 1, 0, 0, 1, 0, 1, 1, 0, 0]"
1059,1,1,2,0.770949866305841,"[1, 0, 1, 1, 1, 1, 1, 1, 1, 0]"
1060,1,1,2,0.6313577755656113,"[0, 0, 1, 1, 0, 0, 0, 0, 0, 1]"
1061,1,1,2,0.680603070478252,"[0, 1, 0, 0, 1, 0, 1, 1, 0, 1]"
1062,1,1,2,0.18618717554579622,"[0, 1, 0, 0, 1, 0, 0, 0, 0, 0]"
1063,1,1,2,0.027208996328118906,"[0, 1, 0, 0, 1, 0, 0, 1, 1, 0]"
1064,19,19,38,0.20970000120697296,"[1, 1, 1, 0, 1, 0, 1, 1, 1, 1]"
1065,1,1,2,0.12304361040388945,"[1, 0, 0, 1, 1, 0, 1, 0, 0, 0]"
1066,3,3,6,0.317265507724377,"[1, 0, 0, 1, 1, 0, 0, 0, 1, 1]"
1067,3,3,6,0.8908496105314121,"[0, 0, 1, 1, 1, 0, 1, 0, 0, 1]"
1068,13,13,26,0.48328344210931773,"[1, 1, 0, 1, 1, 0, 1, 1, 0, 1]"
1069,18,18,36,0.8804357678973826,"[0, 1, 1, 1, 0, 1, 1, 0, 1, 1]"
1070,1,1,2,0.7805424953248524,"[1, 0, 0, 0, 0, 0, 0, 1, 0, 0]"
1071,2,2,4,0.7241256654324261,"[1, 1, 0, 0, 1, 0, 1, 1, 0, 1]"
1072,5,5,10,0.8803613232273001,"[1, 0, 1, 1, 1, 1, 1, 0, 0, 1]"
1073,2,2,4,0.13828475545544383,"[0, 1, 0, 1, 0, 1, 1, 1, 1, 0]"
1074,3,3,6,0.5762585142603447,"[1, 0, 0, 0, 1, 0, 0, 1, 0, 1]"
1075,17,17,34,0.1865923432198382,"[1, 0, 1, 0, 0, 0, 1, 1, 0, 1]"
1076,1,1,2,0.2864276399556215,"[1, 1, 0, 0, 0, 0, 0, 1, 0, 1]"
1077,1,1,2,0.6541020880968781,"[0, 1, 0, 0, 1, 0, 0, 0, 1, 0]"
1078,3,3,6,0.04185351473611609,"[0, 1, 1, 0, 1, 1, 0, 0, 0, 0]"
1079,4,4,8,0.9251698822368682,"[0, 0, 0, 0, 0, 0, 1, 0, 1, 1]"
1080,2,2,4,0.7881975265136323,"[0, 1, 1, 0, 0, 1, 1, 0, 1, 1]"
1081,2,2,4,0.9438962818336761,"[0, 1, 0, 0, 1, 0, 1, 0, 0, 0]"
1082,1,1,2,0.7593879910633555,"[0, 0, 1, 1, 0, 1, 0, 0, 0, 0]"
1083,4,4,8,0.3605747281047207,"[0, 0, 0, 1, 1, 1, 0, 1, 1, 1]"
1084,1,1,2,0.37693305260274157,"[0, 0, 0, 1, 1, 1, 0, 1, 0, 0]"
1085,4,4,8,0.9271923110080643,"[1, 1, 1, 0, 1, 1, 1, 1, 0, 0]"
1086,1,1,2,0.5647809432098894,"[0, 0, 0, 1, 0, 1, 1, 0, 0, 1]"
1087,8,8,16,0.982255272847606,"[1, 1, 1, 1, 1, 1, 1, 1, 0, 0]"
1088,1,1,2,0.31277956459143963,"[1, 1, 0, 0, 1, 1, 1, 1, 0, 1]"
1089,6,6,12,0.8219257267028758,"[1, 0, 0, 1, 0, 1, 1, 1, 1, 1]"
1090,2,2,4,0.8952880660241448,"[1, 0, 0, 0, 1, 0, 0, 0, 0, 0]"
1091,5,5,10,0.9188395839886043,"[0, 1, 1, 1, 1, 0, 1, 0, 1, 1]"
1092,3,3,6,0.6416044378554452,"[1, 0, 0, 1, 0, 0, 0, 1, 1, 0]"
1093,2,2,4,0.2053753121783486,"[0, 1, 1, 1, 0, 0, 1, 0, 1, 0]"
1094,1,1,2,0.4026767320080462,"[1, 0, 0, 1, 0, 1, 0, 0, 0, 0]"
1095,8,8,16,0.6929879661814776,"[0, 0, 1, 0, 1, 0, 0, 0, 1, 1]"
1096,2,2,4,0.825940059902285,"[1, 1, 0, 0, 1, 0, 0, 0, 0, 1]"
1097,7,7,14,0.8623546346178428,"[0, 1, 1, 1, 0, 0, 0, 1, 1, 1]"
1098,8,8,16,0.09684917670247961,"[1, 1, 0, 1, 0, 0, 1, 0, 1, 0]"
1099,1,1,2,0.14081644321166709,"[1, 0, 0, 0, 0, 1, 1, 0, 1, 1]"
1100,5,5,10,0.9715374531604493,"[0, 0, 0, 0, 1, 0, 1, 1, 0, 1]"
1101,1,1,2,0.7402285404987792,"[0, 1, 0, 1, 0, 0, 0, 1, 1, 0]"
1102,3,3,6,0.6407586329498585,"[1, 1, 1, 0, 1, 0, 0, 1, 1, 0]"
1103,3,3,6,0.7253975146472144,"[1, 0, 0, 1, 0, 0, 0, 1, 1, 0]"
1104,2,2,4,0.8032201357191033,"[1, 0, 1, 0, 1, 0, 1, 1, 1, 0]"
1105,3,3,6,0.9463877692433973,"[1, 0, 1, 0, 0, 1, 1, 1, 0, 0]"
1106,1,1,2,0.5981873646144026,"[0, 0, 0, 1, 0, 1, 1, 0, 0, 0]"
1107,3,3,6,0.05454283243667679,"[1, 0, 0, 0, 1, 1, 1, 1, 0, 1]"
1108,7,7,14,0.5254393684040708,"[1, 1, 0, 0, 1, 0, 0, 1, 1, 1]"
1109,4,4,8,0.11115518475324426,"[1, 0, 0, 1, 1, 0, 1, 0, 1, 0]"
1110,5,5,10,0.34382798846779816,"[1, 1, 1, 1, 1, 1, 1, 0, 1, 1]"
1111,1,1,2,0.6769364658030911,"[1, 0, 0, 1, 1, 1, 1, 0, 0, 1]"
1112,1,1,2,0.10317614907280781,"[0, 1, 0, 0, 0, 0, 0, 1, 0, 0]"
1113,1,1,2,0.020506767015371685,"[0, 0, 1, 0, 1, 1, 0, 0, 1, 0]"
1114,2,2,4,0.25014488309362115,"[0, 0, 0, 1, 0, 1, 1, 0, 0, 1]"
1115,1,1,2,0.30693909750684667,"[1, 0, 1, 1, 1, 1, 0, 1, 0, 0]"
1116,1,1,2,0.3681557738972471,"[0, 0, 0, 0, 0, 1, 0, 0, 0, 0]"
1117,3,3,6,0.7989281840265066,"[1, 0, 1, 1, 1, 1, 0, 0, 0, 0]"
1118,9,9,18,0.43526178092370615,"[1, 1, 1, 0, 0, 1, 1, 1, 1, 1]"
1119,1,1,2,0.235566649016979,"[1, 0, 0, 1, 1, 0, 1, 0, 0, 0]"
1120,5,5,10,0.28879892916128547,"[0, 0, 1, 1, 0, 1, 0, 1, 1, 1]"
1121,4,4,8,0.48435062360786785,"[1, 1, 1, 1, 1, 0, 0, 0, 1, 1]"
1122,21,21,42,0.6269284035458699,"[0, 1, 1, 1, 1, 1, 1, 1, 1, 1]"
1123,1,1,2,0.02276993563599572,"[0, 0, 1, 0, 1, 0, 0, 0, 1, 0]"
1124,1,1,2,0.7200602862410433,"[1, 0, 1, 1, 0, 1, 1, 0, 1, 0]"
1125,1,1,2,0.4830031554804193,"[0, 1, 1, 0, 1, 0, 1, 1, 1, 0]"
1126,8,8,16,0.7882448853068531,"[1, 1, 1, 0, 0, 1, 1, 1, 0, 1]"
1127,2,2,4,0.0217621410426847,"[0, 0, 1, 0, 0, 0, 0, 0, 1, 1]"
1128,8,8,16,0.9100693464633174,"[0, 1, 1, 1, 0, 1, 0, 0, 1, 0]"
1129,1,1,2,0.41041555413815534,"[0, 0, 0, 1, 1, 1, 0, 1, 0, 0]"
1130,3,3,6,0.06261088171818208,"[1, 0, 0, 1, 0, 0, 1, 1, 0, 1]"
1131,4,4,8,0.3517003561346197,"[1, 0, 0, 1, 1, 1, 0, 1, 1, 0]"
1132,9,9,18,0.9945971638699662,"[0, 1, 1, 1, 0, 1, 1, 0, 1, 0]"
1133,6,6,12,0.5314362266936022,"[0, 1, 0, 1, 1, 0, 1, 0, 1, 1]"
1134,2,2,4,0.3598943009479937,"[1, 0, 0, 1, 0, 1, 0, 0, 0, 0]"
1135,1,1,2,0.4845338859061026,"[1, 0, 1, 0, 1, 0, 0, 1, 0, 1]"
1136,4,4,8,0.3231219402460248,"[0, 1, 0, 1, 1, 0, 1, 1, 1, 1]"
1137,8,8,16,0.8924592072577041,"[1, 1, 0, 1, 0, 1, 0, 0, 0, 1]"
1138,1,1,2,0.8532622556835939,"[1, 0, 0, 0, 0, 1, 1, 0, 0, 0]"
1139,3,3,6,0.3242271320721094,"[0, 0, 0, 1, 0, 0, 0, 1, 1, 0]"
1140,1,1,2,0.6972914073276493,"[0, 0, 0, 0, 0, 1, 1, 1, 0, 0]"
1141,3,3,6,0.06461664657212496,"[0, 1, 0, 1, 1, 1, 0, 0, 1, 1]"
1142,3,3,6,0.9508361430876784,"[0, 1, 1, 1, 0, 1, 1, 1, 1, 0]"
1143,3,3,6,0.5110129424112312,"[0, 1, 1, 0, 0, 1, 1, 1, 0, 0]"
1144,12,12,24,0.833604672880646,"[1, 1, 1, 0, 0, 1, 1, 0, 1, 1]"
1145,1,1,2,0.03183958088045091,"[0, 0, 1, 0, 0, 1, 1, 1, 0, 0]"
1146,12,12,24,0.14139320385462295,"[1, 1, 1, 0, 1, 1, 0, 1, 1, 0]"
1147,2,2,4,0.2900525371288045,"[0, 0, 0, 1, 0, 1, 0, 0, 1, 1]"
1148,19,19,38,0.33936763775957945,"[1, 0, 1, 0, 1, 1, 0, 0, 0, 1]"
1149,9,9,18,0.31242118899020555,"[1, 1, 1, 0, 0, 0, 0, 0, 1, 1]"
1150,8,8,16,0.5952561922199696,"[1, 1, 0, 0, 0, 1, 1, 0, 1, 1]"
1151,6,6,12,0.7468710728135047,"[0, 0, 1, 1, 0, 1, 0, 1, 1, 1]"
1152,1,1,2,0.5150227724369627,"[0, 1, 1, 0, 0, 0, 0, 1, 1, 0]"
1153,1,1,2,0.44782264536995897,"[0, 1, 0, 0, 0, 0, 0, 1, 0, 0]"
1154,17,17,34,0.8961605899628475,"[0, 1, 0, 0, 0, 1, 1, 1, 1, 1]"
1155,8,8,16,0.31288312026718235,"[1, 0, 0, 0, 1, 1, 0, 0, 1, 0]"
1156,2,2,4,0.6796843412977267,"[1, 0, 0, 0, 1, 0, 1, 1, 1, 0]"
1157,4,4,8,0.9220261070508964,"[1, 1, 0, 0, 1, 1, 0, 1, 1, 0]"
1158,5,5,10,0.7790746521759314,"[1, 0, 0, 1, 1, 0, 0, 0, 0, 1]"
1159,1,1,2,0.5972738269641565,"[0, 0, 0, 1, 0, 0, 0, 1, 0, 1]"
1160,5,5,10,0.26204729166872254,"[0, 0, 1, 1, 1, 0, 1, 1, 0, 1]"
1161,4,4,8,0.3774351051879008,"[1, 1, 1, 1, 0, 1, 1, 0, 1, 0]"
1162,7,7,14,0.09085340955272914,"[0, 0, 1, 1, 1, 1, 1, 1, 1, 1]"
1163,2,2,4,0.3926009681288254,"[1, 0, 1, 0, 0, 1, 0, 0, 0, 0]"
1164,1,1,2,0.9367664041650238,"[0, 1, 0, 1, 0, 1, 0, 0, 1, 0]"
1165,1,1,2,0.4192311204052743,"[1, 1, 0, 1, 1, 0, 0, 1, 1, 1]"
1166,9,9,18,0.4471754537918625,"[1, 0, 0, 1, 1, 1, 0, 1, 1, 1]"
1167,8,8,16,0.6203870379014069,"[1, 1, 1, 0, 1, 1, 1, 0, 1, 0]"
1168,1,1,2,0.22764321651606878,"[1, 0, 0, 1, 1, 1, 1, 1, 0, 0]"
1169,1,1,2,0.8851613604952517,"[0, 0, 1, 0, 1, 0, 1, 0, 1, 0]"
1170,6,6,12,0.2273446560949156,"[0, 1, 1, 0, 0, 1, 1, 1, 0, 0]"
1171,2,2,4,0.6644729749067674,"[0, 0, 1, 0, 1, 0, 1, 0, 1, 1]"
1172,2,2,4,0.593957496800996,"[1, 0, 0, 0, 0, 0, 1, 0, 0, 1]"
1173,1,1,2,0.08385775323276812,"[0, 0, 0, 1, 1, 0, 1, 1, 0, 1]"
1174,6,6,12,0.14179698315589695,"[0, 1, 1, 1, 1, 1, 0, 0, 0, 1]"
1175,4,4,8,0.7749392124909147,"[0, 0, 1, 1, 1, 0, 0, 0, 1, 1]"
1176,3,3,6,0.9151763211977096,"[1, 1, 1, 0, 0, 0, 0, 1, 1, 1]"
1177,6,6,12,0.9440674782144365,"[0, 1, 0, 1, 1, 1, 0, 1, 0, 0]"
1178,3,3,6,0.6994595765769939,"[0, 1, 0, 0, 0, 0, 1, 1, 1, 1]"
1179,1,1,2,0.3866917274416304,"[0, 0, 0, 1, 1, 0, 0, 0, 1, 0]"
1180,7,7,14,0.581918185701862,"[0, 1, 1, 0, 1, 0, 1, 0, 1, 0]"
1181,2,2,4,0.48613191337929607,"[0, 0, 0, 1, 1, 0, 1, 0, 0, 0]"
1182,1,1,2,0.9857463705185222,"[1, 0, 0, 0, 1, 0, 1, 1, 0, 0]"
1183,1,1,2,0.9976231154388894,"[1, 1, 0, 0, 1, 0, 1, 1, 0, 0]"
1184,4,4,8,0.9140496564822006,"[0, 0, 1, 0, 0, 1, 1, 1, 1, 0]"
1185,7,7,14,0.5696317321212664,"[1, 0, 0, 1, 1, 1, 1, 0, 1, 0]"
1186,1,1,2,0.893463419290064,"[0, 0, 0, 0, 1, 0, 1, 1, 1, 1]"
1187,3,3,6,0.07152253641112605,"[0, 1, 0, 0, 0, 0, 0, 0, 0, 1]"
1188,2,2,4,0.6121909675597978,"[1, 1, 0, 0, 1, 1, 1, 0, 0, 0]"
1189,1,1,2,0.7910096149774632,"[1, 0, 1, 1, 0, 0, 0, 0, 0, 1]"
1190,1,1,2,0.8506621426153345,"[0, 1, 1, 0, 1, 1, 0, 0, 1, 0]"
1191,2,2,4,0.06483505196441042,"[0, 0, 1, 0, 0, 1, 0, 1, 1, 1]"
1192,3,3,6,0.2330057693759372,"[0, 1, 0, 1, 0, 0, 0, 0, 1, 1]"
1193,14,14,28,0.7201164145935446,"[1, 0, 1, 1, 0, 0, 1, 1, 0, 1]"
1194,2,2,4,0.475154293979982,"[1, 0, 1, 1, 1, 0, 0, 0, 0, 1]"
1195,12,12,24,0.7834860277008671,"[1, 1, 1, 0, 0, 0, 1, 1, 1, 1]"
1196,3,3,6,0.4604206165426584,"[0, 0, 1, 0, 0, 0, 0, 1, 1, 0]"
1197,1,1,2,0.16070467051716408,"[1, 1, 1, 1, 0, 1, 1, 1, 0, 1]"
1198,1,1,2,0.8791161804910544,"[1, 1, 1, 1, 0, 0, 0, 1, 0, 1]"
1199,14,14,28,0.06405887383148279,"[1, 1, 1, 1, 1, 0, 1, 0, 0, 1]"
1200,2,2,4,0.2545712869175112,"[0, 0, 1, 1, 0, 1, 1, 1, 0, 0]"
1201,5,5,10,0.8082050871965251,"[0, 1, 1, 1, 0, 0, 1, 0, 0, 1]"
1202,1,1,2,0.46154900798980436,"[0, 1, 1, 0, 0, 0, 1, 0, 1, 0]"
1203,1,1,2,0.40888808891438866,"[1, 1, 1, 1, 0, 0, 1, 0, 0, 0]"
1204,1,1,2,0.7322132430863109,"[1, 1, 1, 1, 0, 0, 0, 0, 0, 1]"
1205,1,1,2,0.057308406963480496,"[1, 0, 0, 0, 0, 0, 0, 0, 0, 0]"
1206,15,15,30,0.2807018861748414,"[1, 1, 0, 1, 0, 1, 1, 1, 1, 1]"
1207,4,4,8,0.3580708771746577,"[0, 0, 0, 0, 1, 1, 1, 1, 1, 1]"
1208,4,4,8,0.5036780292193681,"[1, 1, 0, 0, 1, 1, 1, 0, 0, 0]"
1209,1,1,2,0.8524353102483556,"[1, 0, 0, 1, 0, 1, 0, 0, 1, 1]"
1210,2,2,4,0.48106535691266306,"[1, 0, 1, 1, 0, 0, 0, 1, 1, 1]"
1211,1,1,2,0.9278948203071105,"[0, 0, 1, 1, 1, 1, 0, 0, 0, 0]"
1212,2,2,4,0.1685554547562509,"[0, 1, 1, 0, 1, 1, 0, 0, 0, 1]"
1213,3,3,6,0.8042555427722572,"[1, 1, 1, 0, 1, 1, 0, 0, 1, 0]"
1214,3,3,6,0.8842208181751302,"[1, 1, 0, 1, 0, 1, 0, 0, 0, 1]"
1215,7,7,14,0.7129593914516797,"[1, 0, 0, 1, 1, 1, 1, 1, 0, 0]"
1216,5,5,10,0.18259855772808575,"[0, 0, 1, 0, 1, 1, 1, 1, 0, 1]"
1217,1,1,2,0.712128948027108,"[0, 0, 1, 0, 0, 0, 1, 0, 0, 0]"
1218,6,6,12,0.3523498888854598,"[0, 0, 1, 0, 1, 1, 0, 0, 1, 0]"
1219,14,14,28,0.5216845097856584,"[1, 1, 1, 0, 0, 1, 1, 1, 1, 0]"
1220,2,2,4,0.5295517568454379,"[0, 0, 1, 1, 0, 0, 0, 0, 1, 0]"
1221,5,5,10,0.04788551038702715,"[1, 1, 1, 1, 0, 0, 1, 1, 0, 0]"
1222,4,4,8,0.13967691349834865,"[0, 0, 1, 0, 0, 1, 0, 1, 0, 1]"
1223,3,3,6,0.3224594870108364,"[0, 0, 1, 0, 0, 0, 0, 0, 1, 0]"
1224,3,3,6,0.02142563517225049,"[0, 1, 0, 1, 0, 1, 1, 0, 0, 0]"
1225,4,4,8,0.7571871163977323,"[0, 0, 0, 0, 1, 1, 0, 1, 1, 1]"
1226,1,1,2,0.9493898547748869,"[0, 0, 1, 0, 1, 0, 0, 0, 0, 1]"
1227,5,5,10,0.2343962962216155,"[1, 0, 1, 1, 1, 0, 0, 0, 1, 0]"
1228,1,1,2,0.6248253700171537,"[1, 0, 1, 0, 0, 0, 1, 1, 1, 1]"
1229,3,3,6,0.403677689477169,"[1, 0, 1, 0, 0, 0, 1, 1, 0, 1]"
1230,7,7,14,0.6855655199361936,"[1, 1, 1, 1, 0, 0, 1, 0, 1, 1]"
1231,3,3,6,0.3058046307551606,"[1, 0, 1, 0, 0, 0, 1, 1, 0, 1]"
1232,5,5,10,0.7662432724598153,"[1, 0, 0, 0, 0, 0, 0, 1, 1, 0]"
1233,1,1,2,0.39086756944351075,"[0, 1, 1, 0, 1, 1, 0, 0, 1, 0]"
1234,2,2,4,0.8268777829760113,"[0, 1, 1, 1, 1, 0, 1, 0, 1, 1]"
1235,2,2,4,0.02067711353178381,"[1, 1, 0, 0, 1, 0, 0, 0, 0, 0]"
1236,2,2,4,0.9509763619110283,"[0, 0, 1, 0, 1, 0, 1, 1, 1, 0]"
1237,1,1,2,0.5806361455945301,"[1, 1, 1, 1, 1, 0, 0, 1, 0, 0]"
1238,24,24,48,0.8279640241220129,"[1, 0, 1, 1, 1, 0, 1, 0, 0, 1]"
1239,3,3,6,0.8723531712873602,"[1, 0, 1, 0, 0, 0, 1, 0, 0, 1]"
1240,4,4,8,0.7967203289232812,"[0, 0, 1, 0, 1, 1, 1, 1, 0, 1]"
1241,13,13,26,0.9287415635373422,"[1, 0, 1, 1, 1, 0, 0, 1, 1, 0]"
1242,1,1,2,0.7183695382956672,"[0, 1, 0, 1, 0, 0, 1, 0, 1, 0]"
1243,2,2,4,0.7426321809486008,"[0, 0, 0, 0, 1, 0, 0, 1, 0, 1]"
1244,5,5,10,0.12702044027807857,"[1, 0, 1, 1, 1, 0, 0, 1, 0, 1]"
1245,2,2,4,0.32002785176955195,"[0, 0, 1, 1, 0, 0, 0, 1, 1, 0]"
1246,2,2,4,0.050635411222545446,"[0, 0, 1, 0, 1, 0, 1, 1, 1, 1]"
1247,1,1,2,0.9121020352539523,"[1, 0, 0, 0, 0, 1, 1, 1, 0, 0]"
1248,3,3,6,0.03426165912050105,"[0, 0, 0, 1, 0, 0, 1, 1, 1, 0]"
1249,2,2,4,0.8488125092580283,"[1, 1, 1, 0, 0, 1, 0, 1, 1, 0]"
1250,8,8,16,0.4181504444098254,"[0, 1, 1, 1, 0, 1, 0, 0, 1, 1]"
1251,10,10,20,0.943920197778677,"[1, 0, 1, 0, 1, 1, 1, 0, 1, 1]"
1252,1,1,2,0.23910514366224678,"[0, 1, 0, 1, 1, 1, 0, 0, 0, 0]"
1253,2,2,4,0.07509838710881211,"[1, 0, 1, 1, 1, 1, 1, 0, 0, 0]"
1254,3,3,6,0.9681170492910766,"[1, 0, 1, 0, 0, 0, 0, 1, 1, 1]"
1255,4,4,8,0.5381771127946974,"[1, 0, 1, 1, 0, 1, 0, 0, 1, 1]"
1256,6,6,12,0.7074873764895863,"[1, 0, 0, 1, 1, 1, 0, 1, 1, 1]"
1257,10,10,20,0.30917458008279963,"[0, 1, 0, 1, 0, 1, 1, 1, 1, 1]"
1258,2,2,4,0.9235085244992931,"[0, 1, 0, 0, 0, 0, 0, 1, 1, 1]"
1259,5,5,10,0.43923062162766,"[1, 0, 0, 1, 0, 1, 1, 0, 1, 0]"
1260,2,2,4,0.829143805829026,"[1, 0, 1, 0, 1, 1, 0, 0, 1, 0]"
1261,1,1,2,0.514873724854594,"[1, 1, 0, 0, 0, 0, 0, 0, 0, 1]"
1262,3,3,6,0.10712644822736628,"[0, 1, 0, 1, 0, 1, 1, 1, 1, 0]"
1263,1,1,2,0.9948294881888837,"[1, 1, 1, 1, 1, 0, 1, 0, 0, 0]"
1264,4,4,8,0.058431680295763955,"[1, 0, 1, 0, 0, 1, 0, 1, 1, 1]"
1265,4,4,8,0.1407234422273721,"[0, 1, 1, 0, 0, 0, 1, 0, 0, 1]"
1266,2,2,4,0.9434693623552882,"[1, 0, 0, 1, 0, 0, 0, 0, 1, 1]"
1267,6,6,12,0.43417163526664615,"[0, 1, 0, 1, 1, 0, 0, 1, 0, 0]"
1268,3,3,6,0.26846705220137435,"[1, 0, 0, 1, 1, 1, 0, 1, 0, 0]"
1269,8,8,16,0.09070228194675956,"[1, 1, 1, 0, 0, 0, 0, 1, 1, 1]"
1270,5,5,10,0.5659563858903333,"[1, 1, 1, 0, 0, 0, 0, 1, 1, 1]"
1271,2,2,4,0.06666161106761459,"[0, 1, 1, 0, 1, 1, 1, 1, 0, 0]"
1272,3,3,6,0.12391377670214099,"[0, 1, 1, 1, 0, 0, 1, 1, 0, 1]"
1273,2,2,4,0.7651386622329737,"[1, 0, 0, 1, 0, 1, 1, 0, 0, 0]"
1274,6,6,12,0.46613027412085006,"[1, 1, 0, 1, 0, 0, 1, 0, 1, 0]"
1275,2,2,4,0.7787870421734641,"[0, 0, 1, 1, 0, 0, 1, 1, 1, 0]"
1276,3,3,6,0.5061231831861904,"[1, 1, 0, 0, 0, 0, 1, 1, 0, 1]"
1277,5,5,10,0.7431519311333448,"[0, 1, 0, 1, 0, 1, 1, 1, 1, 0]"
1278,17,17,34,0.04431516333223284,"[1, 1, 1, 1, 0, 1, 1, 1, 0, 1]"
1279,7,7,14,0.17041436490246997,"[1, 1, 0, 1, 1, 1, 0, 0, 1, 0]"
1280,2,2,4,0.5519465480231426,"[1, 0, 0, 0, 0, 0, 0, 0, 1, 1]"
1281,6,6,12,0.4782698890976945,"[0, 1, 1, 0, 1, 1, 0, 1, 0, 0]"
1282,15,15,30,0.5825376038309347,"[1, 0, 1, 1, 0, 1, 0, 0, 1, 1]"
1283,2,2,4,0.16379656523416408,"[1, 1, 1, 1, 0, 1, 0, 0, 0, 0]"
1284,3,3,6,0.8358601350600366,"[0, 1, 0, 1, 1, 0, 1, 1, 1, 0]"
1285,5,5,10,0.7512702994001673,"[1, 1, 0, 1, 1, 1, 1, 1, 1, 0]"
1286,1,1,2,0.9040970047609772,"[1, 1, 0, 1, 0, 1, 0, 1, 1, 1]"
1287,5,5,10,0.021232369444122212,"[1, 1, 1, 1, 0, 0, 0, 0, 0, 1]"
1288,4,4,8,0.60027186496413,"[0, 1, 1, 0, 0, 0, 1, 1, 1, 0]"
1289,1,1,2,0.9065689177253157,"[1, 1, 1, 0, 1, 0, 1, 0, 1, 1]"
1290,1,1,2,0.011483567448124066,"[1, 0, 0, 0, 1, 0, 0, 1, 1, 1]"
1291,1,1,2,0.2795744526413101,"[1, 0, 1, 1, 0, 1, 1, 1, 1, 0]"
1292,7,7,14,0.7655092067641387,"[0, 0, 1, 0, 0, 0, 1, 1, 1, 0]"
1293,9,9,18,0.5720199868612486,"[1, 1, 0, 0, 0, 1, 0, 0, 0, 1]"
1294,2,2,4,0.40417410825860467,"[1, 1, 0, 0, 0, 1, 0, 1, 0, 1]"
1295,3,3,6,0.8734213514292425,"[1, 1, 0, 0, 1, 0, 1, 0, 0, 1]"
1296,4,4,8,0.7389568846398441,"[0, 1, 0, 1, 1, 0, 0, 1, 1, 0]"
1297,14,14,28,0.762706213048215,"[0, 1, 0, 1, 1, 0, 1, 0, 1, 1]"
1298,10,10,20,0.8629912622739079,"[0, 1, 1, 1, 1, 1, 1, 0, 0, 1]"
1299,2,2,4,0.957549048180371,"[0, 0, 1, 1, 0, 1, 1, 0, 1, 1]"
1300,2,2,4,0.5066404240068352,"[0, 1, 0, 0, 0, 1, 1, 1, 0, 1]"
1301,1,1,2,0.170672558738028,"[1, 0, 1, 0, 0, 0, 0, 0, 0, 0]"
1302,4,4,8,0.7690567882837083,"[0, 1, 1, 1, 0, 1, 0, 1, 1, 1]"
1303,2,2,4,0.2420894454062641,"[1, 0, 0, 1, 0, 1, 0, 1, 0, 1]"
1304,1,1,2,0.6161578863470206,"[1, 0, 1, 0, 1, 0, 0, 1, 0, 0]"
1305,1,1,2,0.07543969562256414,"[0, 0, 1, 1, 1, 0, 1, 1, 0, 0]"
1306,1,1,2,0.5770195815328258,"[0, 0, 1, 0, 0, 0, 1, 0, 0, 0]"
1307,17,17,34,0.5789519995020388,"[0, 1, 1, 0, 1, 1, 1, 1, 1, 1]"
1308,10,10,20,0.45567131506617,"[1, 0, 1, 1, 1, 0, 0, 0, 1, 0]"
1309,5,5,10,0.9902139227743338,"[0, 1, 1, 1, 0, 0, 1, 0, 1, 0]"
1310,21,21,42,0.6559648942950453,"[1, 1, 1, 0, 1, 1, 1, 0, 1, 1]"
1311,2,2,4,0.6710626169263612,"[1, 0, 0, 0, 0, 0, 0, 0, 1, 0]"
1312,2,2,4,0.404892518727086,"[0, 1, 0, 0, 0, 1, 0, 1, 0, 0]"
1313,3,3,6,0.9814996138779114,"[1, 0, 1, 1, 1, 0, 1, 0, 1, 0]"
1314,2,2,4,0.8208304596481942,"[0, 0, 1, 0, 1, 1, 0, 0, 0, 1]"
1315,3,3,6,0.8787404624900482,"[0, 1, 0, 0, 1, 1, 0, 1, 1, 1]"
1316,2,2,4,0.01717743276031858,"[1, 0, 1, 0, 1, 1, 1, 0, 0, 0]"
1317,2,2,4,0.09321964732245092,"[1, 0, 0, 1, 1, 1, 0, 1, 1, 1]"
1318,2,2,4,0.725804118731936,"[0, 0, 0, 1, 0, 0, 0, 0, 1, 0]"
1319,3,3,6,0.5344496497304481,"[1, 0, 0, 1, 1, 0, 0, 0, 0, 0]"
1320,1,1,2,0.727223908625187,"[1, 0, 0, 0, 0, 0, 0, 0, 1, 0]"
1321,3,3,6,0.42825580232873717,"[0, 0, 1, 0, 0, 0, 0, 1, 0, 0]"
1322,1,1,2,0.586961393363377,"[1, 0, 1, 1, 0, 0, 1, 0, 1, 0]"
1323,1,1,2,0.7294896303480722,"[0, 0, 0, 1, 0, 1, 1, 0, 0, 0]"
1324,1,1,2,0.5966345949732699,"[1, 0, 0, 0, 0, 1, 0, 0, 0, 1]"
1325,1,1,2,0.6805356792317588,"[1, 0, 1, 1, 1, 1, 0, 0, 0, 0]"
1326,5,5,10,0.11166646588725049,"[0, 1, 0, 0, 1, 0, 0, 0, 1, 1]"
1327,3,3,6,0.11351625328443082,"[0, 1, 1, 0, 0, 0, 1, 0, 1, 0]"
1328,4,4,8,0.36026937491863986,"[1, 1, 1, 1, 0, 1, 1, 1, 1, 0]"
1329,2,2,4,0.44539244247380017,"[1, 1, 0, 0, 0, 0, 0, 0, 0, 0]"
1330,1,1,2,0.33900570645051,"[0, 1, 0, 0, 1, 1, 1, 0, 1, 1]"
1331,1,1,2,0.15201360948100373,"[0, 0, 0, 1, 0, 1, 0, 0, 1, 0]"
1332,2,2,4,0.43890131791794373,"[0, 1, 1, 0, 0, 1, 1, 1, 0, 1]"
1333,4,4,8,0.5502500376252084,"[0, 0, 0, 0, 0, 0, 1, 0, 1, 1]"
1334,1,1,2,0.5222742242399222,"[0, 0, 0, 1, 1, 0, 0, 1, 0, 0]"
1335,4,4,8,0.6927890380237974,"[0, 0, 1, 1, 1, 1, 1, 1, 1, 1]"
1336,1,1,2,0.6906017062300244,"[0, 1, 0, 1, 0, 0, 1, 1, 1, 1]"
1337,1,1,2,0.768352491889232,"[1, 1, 0, 1, 0, 1, 0, 1, 0, 1]"
1338,2,2,4,0.555609230481416,"[0, 0, 0, 0, 1, 1, 1, 1, 1, 0]"
1339,1,1,2,0.4839790552508133,"[1, 1, 0, 0, 1, 0, 0, 1, 1, 1]"
1340,1,1,2,0.894927049912685,"[1, 1, 1, 0, 1, 0, 1, 0, 0, 0]"
1341,2,2,4,0.35017108269975983,"[1, 0, 0, 1, 1, 0, 0, 0, 1, 0]"
1342,1,1,2,0.5583445559043492,"[0, 0, 0, 1, 0, 1, 1, 0, 1, 0]"
1343,9,9,18,0.2724840548997207,"[0, 1, 0, 0, 0, 1, 1, 0, 0, 1]"
1344,6,6,12,0.23442833453909784,"[1, 1, 0, 0, 0, 1, 1, 0, 1, 0]"
1345,6,6,12,0.9639595616418909,"[1, 0, 1, 1, 0, 1, 1, 0, 1, 0]"
1346,2,2,4,0.7431812639465042,"[0, 1, 1, 0, 1, 0, 1, 0, 0, 0]"
1347,1,1,2,0.28148489830319123,"[1, 0, 0, 1, 1, 0, 1, 1, 1, 1]"
1348,5,5,10,0.022050298304447158,"[1, 1, 0, 0, 1, 0, 1, 0, 1, 0]"
1349,1,1,2,0.18281519689586612,"[1, 0, 0, 0, 1, 0, 1, 0, 0, 1]"
1350,9,9,18,0.6559204902225342,"[0, 1, 1, 1, 1, 0, 0, 1, 1, 1]"
1351,6,6,12,0.4860435254254263,"[1, 1, 0, 0, 1, 0, 0, 1, 1, 0]"
1352,7,7,14,0.9481047509647814,"[0, 0, 0, 1, 1, 1, 1, 0, 0, 0]"
1353,3,3,6,0.17381104411082182,"[1, 1, 1, 1, 0, 0, 1, 1, 1, 0]"
1354,3,3,6,0.18541616558329166,"[1, 1, 0, 1, 0, 1, 0, 1, 1, 0]"
1355,1,1,2,0.14194249131772974,"[0, 0, 0, 0, 1, 1, 0, 0, 0, 0]"
1356,1,1,2,0.7161771655244624,"[0, 1, 1, 1, 1, 0, 0, 0, 1, 0]"
1357,2,2,4,0.43866103833197545,"[1, 1, 0, 0, 0, 1, 0, 0, 0, 0]"
1358,1,1,2,0.7872165472752285,"[1, 1, 1, 1, 0, 1, 0, 0, 0, 0]"
1359,1,1,2,0.5307285565772077,"[1, 0, 0, 0, 1, 1, 1, 0, 1, 1]"
1360,2,2,4,0.6958332068018932,"[1, 1, 1, 0, 1, 0, 0, 0, 0, 1]"
1361,7,7,14,0.6872460686408465,"[1, 0, 1, 1, 1, 0, 1, 0, 0, 1]"
1362,7,7,14,0.5219318355181848,"[1, 0, 0, 0, 1, 0, 1, 0, 1, 1]"
1363,1,1,2,0.8609428448469634,"[1, 1, 1, 1, 1, 1, 1, 1, 1, 0]"
1364,1,1,2,0.10966641209160755,"[1, 1, 0, 0, 0, 0, 1, 1, 0, 0]"
1365,5,5,10,0.5013050157890562,"[0, 1, 0, 1, 0, 0, 0, 1, 1, 1]"
1366,3,3,6,0.47527966592301163,"[0, 1, 1, 0, 0, 1, 0, 0, 1, 1]"
1367,2,2,4,0.3585458520139072,"[0, 0, 0, 1, 1, 1, 0, 1, 1, 1]"
1368,2,2,4,0.7026467983985321,"[0, 1, 1, 0, 0, 0, 0, 0, 0, 1]"
1369,1,1,2,0.33748525560745035,"[0, 1, 1, 1, 1, 0, 0, 1, 0, 1]"
1370,12,12,24,0.4543354756911949,"[1, 1, 1, 1, 0, 1, 0, 1, 1, 1]"
1371,1,1,2,0.32945711175005343,"[0, 1, 0, 0, 0, 0, 0, 0, 1, 1]"
1372,1,1,2,0.8552299426579651,"[0, 0, 0, 1, 0, 1, 0, 1, 1, 1]"
1373,1,1,2,0.9830029818166226,"[0, 0, 0, 1, 1, 1, 0, 0, 0, 1]"
1374,1,1,2,0.17357727475804152,"[1, 0, 1, 1, 1, 0, 1, 1, 0, 0]"
1375,3,3,6,0.5125991880884408,"[0, 0, 0, 0, 0, 1, 1, 1, 1, 0]"
1376,1,1,2,0.0347713108521539,"[1, 0, 0, 1, 0, 1, 0, 0, 0, 1]"
1377,1,1,2,0.11535792585400961,"[0, 1, 1, 0, 0, 0, 0, 0, 0, 1]"
1378,2,2,4,0.44138879831381417,"[1, 0, 0, 1, 0, 0, 0, 0, 1, 0]"
1379,3,3,6,0.03409237519929442,"[0, 1, 1, 0, 0, 1, 0, 1, 0, 0]"
1380,5,5,10,0.04111022194101355,"[0, 0, 0, 1, 1, 1, 1, 1, 1, 1]"
1381,2,2,4,0.5084586000821004,"[0, 0, 0, 1, 0, 0, 0, 0, 1, 1]"
1382,1,1,2,0.13426182002142673,"[0, 1, 1, 0, 0, 1, 1, 0, 0, 1]"
1383,6,6,12,0.605779618657384,"[1, 1, 0, 1, 1, 1, 0, 1, 0, 1]"
1384,1,1,2,0.47528752346745073,"[0, 0, 1, 0, 1, 0, 0, 0, 0, 1]"
1385,2,2,4,0.017010703913692526,"[1, 1, 0, 1, 0, 1, 0, 0, 0, 1]"
1386,4,4,8,0.1988852336175838,"[1, 0, 1, 0, 0, 0, 0, 0, 1, 1]"
1387,1,1,2,0.7795460378700182,"[0, 1, 0, 0, 0, 0, 1, 0, 0, 1]"
1388,1,1,2,0.796389845086295,"[0, 1, 0, 1, 1, 1, 1, 0, 1, 0]"
1389,17,17,34,0.9095874855636398,"[1, 1, 1, 0, 1, 0, 1, 1, 1, 0]"
1390,13,13,26,0.030385497786688087,"[1, 1, 1, 0, 0, 1, 1, 1, 0, 1]"
1391,5,5,10,0.5040191651531468,"[0, 1, 1, 1, 1, 1, 1, 1, 0, 1]"
1392,4,4,8,0.17870446689374386,"[0, 1, 1, 0, 0, 1, 1, 1, 1, 1]"
1393,2,2,4,0.9710743820682036,"[0, 0, 0, 0, 1, 1, 1, 1, 0, 0]"
1394,5,5,10,0.6105153769753566,"[1, 0, 1, 0, 0, 1, 1, 0, 0, 0]"
1395,1,1,2,0.6608728861405749,"[1, 0, 1, 0, 1, 1, 1, 0, 1, 1]"
1396,6,6,12,0.3256295515378881,"[0, 1, 0, 1, 0, 1, 0, 1, 0, 1]"
1397,1,1,2,0.5082162189016377,"[0, 0, 0, 0, 0, 0, 0, 0, 0, 0]"
1398,5,5,10,0.970313681466648,"[1, 1, 1, 0, 0, 1, 1, 1, 1, 0]"
1399,4,4,8,0.4048522362153053,"[0, 1, 0, 1, 0, 0, 1, 1, 1, 0]"
1400,2,2,4,0.6289477471589163,"[0, 0, 1, 0, 1, 1, 1, 0, 1, 0]"
1401,3,3,6,0.9206118828491585,"[1, 1, 0, 1, 1, 0, 1, 1, 1, 1]"
1402,8,8,16,0.31971851379539384,"[1, 0, 1, 1, 1, 1, 1, 1, 1, 1]"
1403,1,1,2,0.5095359678628719,"[0, 0, 0, 1, 0, 1, 1, 1, 1, 1]"
1404,1,1,2,0.9782192788284412,"[1, 1, 0, 1, 1, 0, 1, 1, 1, 1]"
1405,7,7,14,0.25820051953166934,"[0, 1, 0, 1, 1, 0, 1, 0, 0, 1]"
1406,1,1,2,0.6393470182539428,"[1, 1, 1, 1, 0, 0, 0, 1, 1, 1]"
1407,1,1,2,0.91967962584458,"[0, 1, 1, 0, 0, 1, 1, 0, 1, 1]"
1408,1,1,2,0.005491437667351495,"[0, 1, 1, 0, 0, 1, 1, 1, 0, 0]"
1409,1,1,2,0.5138686770027521,"[0, 1, 0, 0, 0, 1, 0, 1, 0, 1]"
1410,1,1,2,0.8574533184826888,"[0, 0, 0, 1, 0, 1, 0, 1, 1, 0]"
1411,5,5,10,0.6166874735057353,"[1, 1, 1, 0, 0, 0, 1, 0, 1, 0]"
1412,2,2,4,0.884888477530027,"[0, 1, 1, 0, 0, 0, 1, 0, 0, 0]"
1413,2,2,4,0.37041852192053026,"[0, 1, 1, 0, 0, 0, 0, 1, 1, 0]"
1414,1,1,2,0.7755440232237722,"[1, 0, 0, 1, 0, 1, 0, 1, 1, 0]"
1415,8,8,16,0.5518747562514364,"[1, 1, 1, 0, 1, 0, 1, 0, 0, 1]"
1416,1,1,2,0.8456530063958794,"[0, 0, 0, 1, 0, 1, 1, 0, 1, 1]"
1417,2,2,4,0.5396492930405884,"[1, 0, 1, 1, 0, 0, 0, 0, 1, 0]"
1418,2,2,4,0.11532897950986265,"[0, 1, 1, 0, 1, 0, 0, 1, 0, 0]"
1419,3,3,6,0.5374446262288337,"[1, 1, 1, 0, 1, 0, 0, 0, 1, 0]"
1420,6,6,12,0.5352006773004221,"[1, 0, 0, 0, 1, 0, 0, 1, 0, 0]"
1421,5,5,10,0.8232796740395972,"[0, 1, 1, 1, 1, 1, 1, 0, 1, 0]"
1422,1,1,2,0.2702976073862653,"[0, 0, 1, 0, 0, 0, 0, 0, 0, 0]"
1423,6,6,12,0.3064070128391363,"[1, 1, 0, 1, 1, 1, 0, 1, 0, 0]"
1424,3,3,6,0.9049822824892197,"[1, 0, 1, 1, 0, 0, 0, 1, 0, 1]"
1425,3,3,6,0.8881274045157587,"[1, 0, 0, 1, 0, 1, 0, 1, 0, 1]"
1426,1,1,2,0.858507606528835,"[0, 1, 0, 0, 0, 1, 0, 0, 0, 0]"
1427,2,2,4,0.7647178301561023,"[0, 1, 1, 1, 1, 1, 1, 0, 0, 0]"
1428,1,1,2,0.6333607024627612,"[1, 0, 0, 1, 0, 0, 0, 0, 0, 1]"
1429,8,8,16,0.3178729202081998,"[0, 1, 0, 1, 1, 0, 1, 1, 1, 1]"
1430,1,1,2,0.2420724229725738,"[0, 0, 1, 0, 0, 0, 1, 0, 1, 1]"
1431,2,2,4,0.6508453202088023,"[1, 1, 1, 1, 1, 1, 0, 1, 1, 1]"
1432,1,1,2,0.25458737569100853,"[0, 1, 1, 0, 0, 0, 0, 0, 0, 0]"
1433,4,4,8,0.7212876424855587,"[0, 0, 0, 0, 1, 1, 1, 1, 1, 1]"
1434,3,3,6,0.1769308059590482,"[0, 1, 0, 0, 1, 1, 1, 0, 1, 1]"
1435,14,14,28,0.26287672188927846,"[0, 1, 1, 1, 1, 1, 0, 1, 0, 1]"
1436,2,2,4,0.46817524201353156,"[0, 1, 0, 0, 0, 0, 0, 0, 1, 1]"
1437,1,1,2,0.14442532205906644,"[1, 0, 0, 0, 1, 1, 1, 0, 0, 0]"
1438,2,2,4,0.31217341056493564,"[0, 1, 1, 1, 0, 0, 1, 0, 0, 0]"
1439,1,1,2,0.38731922290864584,"[1, 0, 1, 0, 0, 1, 0, 1, 1, 1]"
1440,2,2,4,0.8664857709588986,"[1, 0, 1, 0, 1, 1, 1, 1, 1, 1]"
1441,2,2,4,0.5653050365365825,"[1, 0, 0, 0, 1, 0, 0, 1, 0, 0]"
1442,3,3,6,0.08109773977348478,"[0, 0, 1, 1, 0, 0, 1, 0, 0, 1]"
1443,13,13,26,0.9905974326396629,"[1, 1, 0, 1, 0, 0, 1, 0, 1, 1]"
1444,3,3,6,0.8731631404942801,"[0, 0, 0, 0, 1, 0, 0, 1, 0, 1]"
1445,16,16,32,0.7958820605038383,"[1, 1, 1, 1, 1, 0, 1, 0, 1, 0]"
1446,2,2,4,0.9935654747987597,"[0, 0, 0, 1, 0, 1, 1, 1, 0, 0]"
1447,1,1,2,0.2986444189648103,"[0, 1, 0, 0, 0, 0, 0, 1, 0, 0]"
1448,4,4,8,0.9452974029244039,"[1, 1, 0, 0, 1, 0, 1, 0, 0, 1]"
1449,7,7,14,0.25521517757821255,"[0, 1, 1, 1, 1, 1, 1, 0, 0, 1]"
1450,1,1,2,0.26302847693835096,"[0, 1, 1, 0, 1, 0, 0, 0, 0, 1]"
1451,2,2,4,0.9409279898685827,"[1, 0, 1, 1, 1, 1, 0, 0, 0, 0]"
1452,2,2,4,0.6204901316030909,"[1, 1, 0, 1, 0, 0, 0, 1, 1, 0]"
1453,3,3,6,0.9251205133375855,"[0, 0, 1, 1, 1, 0, 0, 1, 1, 1]"
1454,2,2,4,0.39130223903084915,"[1, 1, 0, 1, 1, 0, 0, 0, 1, 0]"
1455,3,3,6,0.33709345866758655,"[0, 0, 1, 0, 0, 1, 1, 0, 1, 0]"
1456,1,1,2,0.541432206145029,"[0, 1, 0, 1, 1, 1, 0, 0, 0, 1]"
1457,6,6,12,0.5056387509117533,"[1, 1, 1, 1, 1, 0, 0, 1, 1, 1]"
1458,2,2,4,0.9325749188952382,"[1, 0, 0, 1, 1, 0, 0, 1, 1, 0]"
1459,6,6,12,0.8010660967389431,"[1, 0, 1, 1, 0, 0, 1, 0, 1, 0]"
1460,1,1,2,0.6032378832112653,"[1, 0, 0, 0, 0, 1, 0, 0, 1, 1]"
1461,16,16,32,0.7371840871333116,"[0, 1, 1, 1, 1, 1, 1, 0, 0, 0]"
1462,2,2,4,0.8479915991749791,"[0, 0, 0, 0, 0, 1, 0, 1, 1, 1]"
1463,15,15,30,0.8207441456556929,"[1, 1, 1, 1, 1, 0, 1, 0, 0, 0]"
1464,10,10,20,0.48106333507931487,"[1, 1, 0, 0, 0, 1, 1, 1, 0, 1]"
1465,4,4,8,0.30800860425760757,"[1, 0, 1, 0, 1, 1, 0, 0, 1, 0]"
1466,4,4,8,0.59096924920987,"[1, 1, 1, 0, 1, 0, 1, 0, 0, 0]"
1467,3,3,6,0.2674592298505145,"[0, 0, 1, 0, 1, 1, 1, 1, 0, 0]"
1468,7,7,14,0.6581043969548317,"[1, 1, 0, 1, 0, 0, 0, 1, 1, 1]"
1469,4,4,8,0.7063941403718729,"[1, 1, 1, 1, 1, 1, 0, 0, 1, 1]"
1470,2,2,4,0.4359515600799142,"[1, 0, 0, 0, 0, 1, 0, 0, 1, 1]"
1471,2,2,4,0.8689462981689662,"[0, 1, 0, 1, 0, 1, 0, 0, 0, 0]"
1472,4,4,8,0.6410004607307846,"[1, 1, 1, 0, 1, 1, 1, 1, 0, 1]"
1473,1,1,2,0.9268939568490626,"[0, 0, 0, 0, 0, 0, 1, 0, 1, 1]"
1474,3,3,6,0.5362856666112282,"[0, 1, 0, 0, 1, 1, 1, 1, 1, 1]"
1475,1,1,2,0.5670608192329307,"[0, 0, 0, 0, 0, 1, 0, 0, 1, 1]"
1476,7,7,14,0.18922492080786935,"[1, 0, 1, 0, 1, 1, 1, 1, 1, 0]"
1477,3,3,6,0.29972954288553166,"[1, 0, 0, 0, 0, 1, 1, 0, 0, 0]"
1478,5,5,10,0.40750690921070354,"[1, 1, 0, 1, 1, 1, 0, 1, 1, 0]"
1479,4,4,8,0.894586728900973,"[1, 0, 0, 1, 1, 0, 0, 0, 0, 1]"
1480,1,1,2,0.6413668283631999,"[0, 0, 0, 0, 0, 1, 1, 0, 1, 0]"
1481,1,1,2,0.38136365524751736,"[0, 1, 1, 0, 0, 0, 1, 0, 0, 1]"
1482,1,1,2,0.3862678913001498,"[0, 0, 1, 0, 0, 1, 1, 1, 0, 1]"
1483,3,3,6,0.8414695895757077,"[1, 1, 1, 0, 1, 0, 1, 1, 0, 1]"
1484,4,4,8,0.7254403386845206,"[1, 0, 1, 1, 0, 1, 0, 1, 0, 1]"
1485,7,7,14,0.32210822403686823,"[0, 0, 0, 1, 0, 0, 1, 1, 1, 0]"
1486,4,4,8,0.9425547164946569,"[1, 0, 1, 1, 1, 1, 0, 0, 0, 0]"
1487,4,4,8,0.559867315393117,"[1, 1, 1, 0, 0, 0, 1, 0, 1, 0]"
1488,1,1,2,0.8665141713101404,"[0, 1, 0, 1, 0, 0, 0, 0, 0, 0]"
1489,4,4,8,0.4213347696785754,"[1, 0, 1, 0, 1, 1, 0, 0, 0, 0]"
1490,2,2,4,0.03436906772686499,"[0, 0, 0, 1, 1, 1, 0, 1, 1, 1]"
1491,2,2,4,0.23666177848112335,"[0, 0, 0, 1, 0, 1, 0, 0, 1, 0]"
1492,3,3,6,0.25730062617419935,"[0, 1, 0, 0, 0, 0, 1, 1, 1, 1]"
1493,1,1,2,0.9443480779278757,"[1, 0, 1, 0, 1, 1, 1, 1, 1, 0]"
1494,3,3,6,0.774523161484778,"[0, 0, 0, 0, 0, 0, 0, 0, 1, 0]"
1495,1,1,2,0.8094517147528311,"[1, 0, 0, 1, 0, 1, 0, 1, 1, 0]"
1496,1,1,2,0.2116880058267291,"[1, 0, 0, 1, 0, 0, 0, 0, 1, 0]"
1497,3,3,6,0.7942927414094381,"[1, 0, 0, 0, 1, 0, 0, 0, 1, 0]"
1498,3,3,6,0.32476626689754695,"[0, 1, 1, 1, 0, 1, 0, 1, 0, 1]"
1499,2,2,4,0.9343982331326692,"[1, 0, 0, 0, 1, 0, 1, 0, 1, 1]"
1500,1,1,2,0.6308943833525082,"[0, 0, 1, 1, 1, 0, 1, 1, 1, 0]"
1501,2,2,4,0.02286664946911887,"[1, 1, 0, 0, 0, 1, 1, 0, 1, 0]"
1502,1,1,2,0.1487631433205442,"[0, 0, 1, 0, 1, 1, 0, 1, 1, 0]"
1503,2,2,4,0.9441676288249949,"[0, 0, 0, 0, 0, 0, 1, 1, 1, 1]"
1504,1,1,2,0.10865953683248242,"[0, 0, 0, 1, 0, 0, 0, 1, 1, 1]"
1505,5,5,10,0.6737222360892844,"[0, 1, 0, 0, 1, 1, 0, 1, 0, 1]"
1506,4,4,8,0.942509911034425,"[1, 1, 0, 0, 1, 0, 0, 0, 1, 1]"
1507,4,4,8,0.9436695377073036,"[1, 0, 1, 0, 0, 0, 1, 1, 1, 1]"
1508,2,2,4,0.25492269458126904,"[1, 1, 0, 1, 1, 0, 1, 1, 0, 0]"
1509,3,3,6,0.18219549857935247,"[1, 0, 1, 0, 0, 1, 0, 1, 0, 0]"
1510,1,1,2,0.7917735814543684,"[0, 0, 0, 0, 0, 0, 0, 0, 0, 1]"
1511,3,3,6,0.5118162456056711,"[1, 1, 0, 1, 1, 0, 0, 1, 0, 0]"
1512,3,3,6,0.9397175169745249,"[0, 0, 1, 0, 1, 0, 1, 0, 0, 0]"
1513,1,1,2,0.5398274099083595,"[1, 1, 0, 1, 1, 0, 1, 1, 0, 0]"
1514,2,2,4,0.36295451633946085,"[0, 0, 1, 1, 0, 0, 0, 1, 1, 0]"
1515,1,1,2,0.6016714262789562,"[0, 1, 1, 1, 1, 0, 1, 1, 0, 0]"
1516,3,3,6,0.9193016037355888,"[1, 1, 0, 0, 1, 0, 1, 0, 1, 0]"
1517,4,4,8,0.5804509903932563,"[1, 1, 1, 0, 0, 0, 1, 0, 1, 0]"
1518,4,4,8,0.5210760353636221,"[1, 1, 0, 0, 0, 1, 1, 0, 0, 1]"
1519,3,3,6,0.5125481842182205,"[1, 1, 0, 0, 0, 0, 0, 1, 1, 1]"
1520,3,3,6,0.482285367634809,"[0, 1, 1, 0, 1, 1, 0, 1, 0, 1]"
1521,1,1,2,0.812547930530705,"[1, 0, 0, 0, 1, 0, 1, 1, 0, 0]"
1522,4,4,8,0.3100585712609917,"[0, 1, 0, 1, 0, 0, 1, 1, 1, 0]"
1523,1,1,2,0.9629205166030028,"[0, 1, 0, 1, 0, 0, 0, 0, 0, 0]"
1524,5,5,10,0.4489615240197169,"[0, 1, 0, 1, 1, 0, 1, 0, 1, 0]"
1525,2,2,4,0.15815613100215065,"[0, 0, 1, 1, 1, 0, 0, 0, 1, 0]"
1526,6,6,12,0.8078296132739943,"[1, 1, 1, 0, 0, 0, 1, 1, 1, 1]"
1527,7,7,14,0.7290824993524346,"[1, 1, 1, 1, 1, 1, 0, 1, 0, 1]"
1528,1,1,2,0.9842646593863704,"[0, 0, 0, 0, 1, 0, 1, 0, 0, 1]"
1529,1,1,2,0.810226194298164,"[1, 0, 1, 1, 0, 0, 0, 1, 0, 1]"
1530,1,1,2,0.3071145591633695,"[1, 0, 0, 0, 1, 0, 1, 0, 1, 0]"
1531,2,2,4,0.449957965168429,"[1, 1, 0, 0, 1, 0, 0, 0, 0, 1]"
1532,4,4,8,0.22146999458359073,"[0, 1, 1, 0, 1, 0, 1, 1, 0, 1]"
1533,2,2,4,0.9099758971650299,"[1, 1, 1, 1, 0, 0, 0, 0, 0, 1]"
1534,5,5,10,0.45830428472684204,"[1, 1, 1, 0, 1, 1, 0, 1, 1, 1]"
1535,1,1,2,0.9822785449790461,"[0, 1, 1, 1, 1, 1, 0, 0, 0, 1]"
1536,3,3,6,0.18605223569571716,"[0, 0, 1, 0, 0, 0, 1, 0, 0, 0]"
1537,12,12,24,0.10389354555484986,"[0, 1, 0, 0, 1, 0, 1, 0, 1, 1]"
1538,3,3,6,0.9466462222327084,"[0, 1, 0, 0, 0, 0, 0, 1, 0, 0]"
1539,2,2,4,0.5955546620194491,"[1, 1, 0, 1, 1, 1, 1, 0, 1, 0]"
1540,1,1,2,0.40967669807571505,"[0, 1, 0, 0, 1, 1, 1, 0, 0, 1]"
1541,1,1,2,0.0032341427154564117,"[0, 1, 1, 1, 0, 1, 1, 0, 1, 0]"
1542,1,1,2,0.7118580547304106,"[1, 1, 0, 0, 0, 1, 0, 0, 0, 1]"
1543,3,3,6,0.41002269591211415,"[1, 1, 1, 0, 0, 1, 1, 1, 1, 0]"
1544,6,6,12,0.22757610348558155,"[1, 1, 1, 1, 1, 1, 1, 1, 0, 0]"
1545,1,1,2,0.8717577416786304,"[1, 1, 1, 0, 1, 0, 0, 0, 1, 0]"
1546,6,6,12,0.19028284705861587,"[1, 0, 0, 1, 0, 1, 1, 1, 0, 1]"
1547,6,6,12,0.37512483787657613,"[0, 1, 1, 0, 0, 0, 0, 0, 1, 0]"
1548,6,6,12,0.3050860408683421,"[0, 1, 1, 0, 1, 0, 1, 1, 1, 1]"
1549,1,1,2,0.4597207710760922,"[1, 1, 1, 0, 1, 0, 1, 1, 0, 0]"
1550,1,1,2,0.5281476478091335,"[0, 1, 1, 0, 0, 0, 0, 1, 1, 1]"
1551,5,5,10,0.6311437649387616,"[1, 1, 0, 1, 1, 0, 1, 0, 0, 1]"
1552,8,8,16,0.8615021366784233,"[1, 0, 0, 1, 1, 0, 1, 1, 1, 1]"
1553,25,25,50,0.7529237980743003,"[1, 1, 0, 1, 0, 1, 1, 1, 0, 1]"
1554,5,5,10,0.2907863328193968,"[1, 0, 1, 1, 0, 0, 1, 0, 1, 0]"
1555,2,2,4,0.11002247492072426,"[1, 0, 1, 0, 0, 0, 0, 0, 1, 0]"
1556,5,5,10,0.4237309186173762,"[0, 1, 0, 1, 0, 1, 0, 0, 1, 0]"
1557,6,6,12,0.13029555243973956,"[0, 1, 0, 1, 0, 1, 0, 0, 0, 0]"
1558,5,5,10,0.5130016003247171,"[0, 0, 1, 0, 0, 0, 1, 1, 0, 1]"
1559,2,2,4,0.736770210097023,"[0, 1, 0, 0, 0, 0, 0, 0, 0, 0]"
1560,1,1,2,0.18022386931954537,"[1, 1, 0, 1, 0, 0, 1, 0, 0, 0]"
1561,2,2,4,0.6028670645985215,"[0, 1, 1, 0, 1, 0, 1, 0, 0, 1]"
1562,1,1,2,0.5380510351916161,"[1, 1, 0, 0, 1, 1, 1, 0, 0, 0]"
1563,5,5,10,0.02414597817371833,"[0, 0, 1, 0, 1, 1, 1, 1, 1, 1]"
1564,2,2,4,0.547148615991062,"[1, 0, 0, 1, 0, 1, 0, 1, 1, 1]"
1565,3,3,6,0.7884702159898649,"[0, 1, 0, 0, 1, 1, 1, 1, 0, 1]"
1566,1,1,2,0.1493237470613925,"[0, 0, 1, 0, 0, 0, 0, 1, 0, 1]"
1567,3,3,6,0.28345256883768155,"[0, 0, 1, 1, 0, 0, 1, 0, 0, 0]"
1568,2,2,4,0.4230768642170015,"[1, 1, 1, 0, 1, 1, 0, 0, 1, 1]"
1569,2,2,4,0.8007851477534861,"[1, 0, 1, 1, 1, 0, 0, 0, 1, 1]"
1570,1,1,2,0.8262740860945849,"[1, 1, 1, 1, 0, 1, 1, 0, 0, 0]"
1571,2,2,4,0.689133179785422,"[0, 0, 0, 1, 1, 1, 1, 0, 0, 0]"
1572,3,3,6,0.33907023213548115,"[1, 1, 1, 1, 1, 1, 0, 1, 0, 0]"
1573,2,2,4,0.027093638820477994,"[0, 1, 0, 0, 0, 0, 1, 0, 1, 1]"
1574,4,4,8,0.8469051690727851,"[1, 0, 0, 0, 0, 0, 0, 1, 1, 0]"
1575,4,4,8,0.03494357383251079,"[0, 1, 0, 0, 0, 0, 1, 1, 0, 1]"
1576,1,1,2,0.20388732830728196,"[1, 1, 0, 1, 1, 0, 0, 0, 1, 0]"
1577,6,6,12,0.16763178203160034,"[1, 1, 1, 1, 0, 1, 1, 1, 0, 0]"
1578,6,6,12,0.11301230215048841,"[0, 1, 0, 1, 1, 1, 1, 0, 0, 1]"
1579,2,2,4,0.44774014894868774,"[0, 0, 0, 0, 0, 0, 0, 1, 1, 1]"
1580,5,5,10,0.7728388372897347,"[1, 0, 1, 1, 1, 1, 1, 1, 1, 1]"
1581,2,2,4,0.35990395318847246,"[1, 1, 0, 0, 0, 1, 0, 0, 0, 1]"
1582,5,5,10,0.484098227853588,"[1, 0, 1, 0, 1, 0, 1, 1, 0, 0]"
1583,3,3,6,0.06440297741956169,"[1, 0, 1, 0, 0, 1, 0, 1, 1, 0]"
1584,15,15,30,0.006138308059604247,"[1, 0, 1, 0, 1, 0, 1, 0, 1, 0]"
1585,1,1,2,0.8181279866504462,"[0, 1, 1, 1, 0, 1, 0, 0, 1, 0]"
1586,1,1,2,0.3797212855999005,"[1, 0, 0, 0, 0, 1, 0, 1, 1, 1]"
1587,1,1,2,0.5339056980186182,"[0, 1, 1, 0, 0, 1, 0, 1, 1, 1]"
1588,1,1,2,0.2295070061023936,"[0, 0, 0, 0, 0, 1, 1, 0, 1, 1]"
1589,1,1,2,0.001402919854884277,"[1, 0, 1, 0, 1, 1, 0, 0, 0, 0]"
1590,3,3,6,0.4740646699741109,"[0, 0, 0, 1, 1, 0, 0, 1, 1, 1]"
1591,3,3,6,0.2054393658215703,"[1, 1, 1, 0, 0, 0, 1, 1, 1, 1]"
1592,2,2,4,0.25284248380923224,"[0, 1, 0, 1, 0, 0, 0, 0, 0, 0]"
1593,4,4,8,0.5384468399787745,"[1, 1, 0, 0, 1, 1, 0, 0, 1, 0]"
1594,2,2,4,0.8872936596851487,"[0, 1, 1, 0, 1, 0, 0, 0, 0, 1]"
1595,9,9,18,0.41278003409588304,"[0, 1, 1, 1, 1, 1, 0, 0, 1, 1]"
1596,3,3,6,0.5098816385602881,"[0, 0, 0, 1, 1, 0, 0, 1, 1, 0]"
1597,8,8,16,0.3028696704364521,"[1, 0, 1, 1, 1, 1, 0, 1, 1, 1]"
1598,2,2,4,0.12105120564182514,"[0, 0, 0, 1, 1, 1, 0, 0, 0, 0]"
1599,1,1,2,0.5623717466914024,"[1, 1, 0, 0, 0, 1, 0, 1, 0, 0]"
1600,2,2,4,0.9329829530468199,"[0, 1, 0, 1, 1, 1, 0, 1, 0, 1]"
1601,1,1,2,0.323089922216918,"[0, 1, 0, 0, 1, 1, 0, 1, 0, 0]"
1602,1,1,2,0.3367155198253535,"[0, 0, 1, 0, 1, 0, 0, 0, 0, 1]"
1603,1,1,2,0.2808898960255066,"[1, 1, 1, 0, 1, 0, 1, 0, 1, 0]"
1604,3,3,6,0.529486895631613,"[0, 1, 0, 0, 0, 1, 1, 0, 0, 1]"
1605,1,1,2,0.14290964452613564,"[1, 0, 1, 0, 0, 0, 0, 0, 0, 1]"
1606,2,2,4,0.011828175859558865,"[0, 1, 0, 1, 0, 0, 1, 1, 0, 1]"
1607,2,2,4,0.9184938989762126,"[0, 0, 1, 1, 1, 1, 1, 1, 0, 1]"
1608,3,3,6,0.8467499329448785,"[1, 1, 0, 0, 1, 0, 1, 1, 0, 1]"
1609,1,1,2,0.8516058196869566,"[0, 0, 1, 1, 1, 0, 1, 1, 0, 0]"
1610,1,1,2,0.1642207278102773,"[0, 0, 0, 0, 0, 1, 0, 1, 0, 0]"
1611,3,3,6,0.2979668878375987,"[1, 1, 0, 0, 1, 1, 0, 0, 1, 1]"
1612,1,1,2,0.08221572046570169,"[0, 0, 1, 0, 0, 1, 0, 1, 1, 1]"
1613,5,5,10,0.9710511799421173,"[1, 0, 0, 1, 1, 0, 0, 0, 1, 0]"
1614,2,2,4,0.4322652152137012,"[0, 1, 1, 1, 1, 1, 1, 1, 0, 0]"
1615,2,2,4,0.5895414794436074,"[1, 0, 1, 0, 0, 1, 0, 0, 1, 1]"
1616,7,7,14,0.14531087851388436,"[0, 0, 1, 1, 0, 1, 1, 0, 0, 1]"
1617,5,5,10,0.25518569572311056,"[1, 1, 0, 0, 1, 0, 0, 1, 1, 1]"
1618,13,13,26,0.31920320825999593,"[1, 1, 0, 0, 1, 1, 0, 1, 1, 0]"
1619,1,1,2,0.18051103099887555,"[0, 1, 0, 1, 0, 1, 1, 1, 1, 1]"
1620,3,3,6,0.698760466073885,"[0, 0, 0, 1, 1, 1, 0, 1, 1, 1]"
1621,4,4,8,0.004819759147588143,"[1, 1, 1, 1, 0, 1, 1, 1, 1, 0]"
1622,1,1,2,0.4950271656028341,"[0, 1, 1, 0, 1, 0, 0, 0, 0, 1]"
1623,1,1,2,0.5817557419414274,"[1, 1, 0, 1, 0, 0, 1, 0, 0, 1]"
1624,1,1,2,0.891731429031324,"[0, 1, 1, 1, 0, 0, 1, 1, 1, 0]"
1625,3,3,6,0.6570297341423311,"[1, 1, 1, 0, 0, 0, 1, 0, 1, 0]"
1626,7,7,14,0.27546375399494505,"[1, 1, 1, 1, 1, 1, 0, 1, 1, 1]"
1627,1,1,2,0.8469220284502157,"[0, 1, 1, 0, 0, 1, 0, 1, 1, 0]"
1628,4,4,8,0.7518134863244362,"[1, 1, 1, 1, 0, 0, 0, 1, 0, 1]"
1629,4,4,8,0.06478404799494275,"[0, 0, 1, 0, 1, 0, 1, 1, 0, 0]"
1630,13,13,26,0.7035286506290679,"[1, 0, 1, 1, 0, 0, 0, 1, 0, 1]"
1631,5,5,10,0.4181007459567695,"[1, 0, 1, 0, 1, 0, 1, 1, 1, 0]"
1632,8,8,16,0.5352438377903611,"[1, 1, 0, 1, 1, 1, 0, 1, 1, 1]"
1633,1,1,2,0.5219055804670255,"[0, 1, 1, 1, 1, 1, 0, 1, 0, 0]"
1634,5,5,10,0.8665770029229697,"[0, 0, 0, 1, 1, 0, 1, 1, 0, 1]"
1635,3,3,6,0.9781411712637488,"[0, 0, 1, 0, 0, 0, 1, 1, 0, 0]"
1636,3,3,6,0.237363245855285,"[1, 1, 0, 0, 0, 0, 0, 0, 0, 1]"
1637,1,1,2,0.7089836894496833,"[0, 0, 0, 0, 0, 0, 0, 0, 0, 0]"
1638,3,3,6,0.18150339206554134,"[0, 0, 1, 0, 1, 0, 1, 0, 0, 0]"
1639,3,3,6,0.04542064134062085,"[1, 0, 1, 0, 0, 1, 0, 1, 1, 0]"
1640,2,2,4,0.5266153427607931,"[0, 0, 1, 0, 0, 1, 0, 0, 1, 1]"
1641,2,2,4,0.08394774367873004,"[1, 0, 1, 0, 1, 1, 0, 1, 1, 1]"
1642,2,2,4,0.28653220905707244,"[0, 1, 0, 0, 1, 1, 1, 0, 1, 1]"
1643,4,4,8,0.27455435540041606,"[1, 1, 1, 1, 0, 1, 1, 0, 0, 0]"
1644,2,2,4,0.5078925004122606,"[0, 1, 1, 0, 0, 0, 0, 1, 1, 0]"
1645,2,2,4,0.21871231712069472,"[0, 0, 1, 1, 1, 1, 1, 1, 0, 0]"
1646,6,6,12,0.39133193544987854,"[1, 1, 1, 0, 1, 0, 1, 0, 0, 1]"
1647,2,2,4,0.14229434829848675,"[1, 0, 1, 1, 0, 0, 0, 1, 0, 1]"
1648,5,5,10,0.6451328595900488,"[0, 1, 1, 1, 1, 1, 0, 0, 0, 1]"
1649,2,2,4,0.2746688117445012,"[0, 1, 1, 1, 1, 0, 0, 0, 1, 0]"
1650,12,12,24,0.05984117293728464,"[0, 0, 1, 0, 1, 1, 0, 1, 1, 0]"
1651,1,1,2,0.8513860601438574,"[0, 0, 0, 0, 0, 1, 1, 1, 0, 1]"
1652,1,1,2,0.6790208289841914,"[0, 0, 1, 1, 1, 0, 0, 0, 1, 1]"
1653,1,1,2,0.8155382689672162,"[0, 1, 1, 0, 0, 0, 1, 1, 1, 1]"
1654,6,6,12,0.06635210771585043,"[0, 0, 1, 0, 1, 0, 1, 0, 1, 1]"
1655,3,3,6,0.5509135281334259,"[1, 0, 1, 1, 1, 1, 1, 0, 1, 0]"
1656,2,2,4,0.03940286031505269,"[0, 1, 1, 1, 0, 1, 1, 0, 0, 1]"
1657,2,2,4,0.850253941047873,"[0, 1, 0, 0, 0, 0, 1, 1, 0, 1]"
1658,2,2,4,0.2720319216096825,"[1, 0, 1, 0, 0, 0, 1, 0, 1, 0]"
1659,1,1,2,0.8031367983207793,"[1, 1, 0, 0, 0, 0, 0, 0, 1, 0]"
1660,6,6,12,0.1367615371126495,"[0, 1, 0, 1, 1, 1, 1, 0, 1, 0]"
1661,1,1,2,0.029020645396885425,"[0, 0, 0, 0, 0, 0, 0, 0, 0, 0]"
1662,6,6,12,0.240172626511022,"[0, 1, 0, 0, 1, 1, 0, 0, 0, 0]"
1663,3,3,6,0.8611906072517758,"[1, 0, 0, 1, 1, 0, 0, 0, 1, 0]"
1664,13,13,26,0.7928755702520166,"[0, 1, 1, 1, 1, 0, 0, 1, 1, 1]"
1665,1,1,2,0.24199841077504425,"[1, 0, 1, 1, 0, 0, 1, 0, 1, 1]"
1666,2,2,4,0.7595855181856667,"[1, 1, 1, 0, 0, 1, 1, 0, 0, 0]"
1667,2,2,4,0.7122214967007375,"[0, 1, 0, 0, 1, 0, 1, 1, 0, 1]"
1668,4,4,8,0.23488133430766722,"[0, 1, 1, 0, 1, 1, 0, 1, 0, 0]"
1669,6,6,12,0.04736803621994534,"[1, 0, 1, 1, 1, 1, 0, 0, 1, 0]"
1670,2,2,4,0.8706327316005238,"[1, 0, 0, 1, 1, 1, 0, 0, 0, 1]"
1671,1,1,2,0.4920378093812229,"[1, 0, 0, 1, 0, 0, 0, 1, 1, 1]"
1672,2,2,4,0.9934223712497657,"[1, 0, 0, 1, 0, 0, 1, 0, 0, 0]"
1673,6,6,12,0.2643330450281698,"[0, 0, 0, 0, 0, 0, 1, 1, 1, 1]"
1674,2,2,4,0.9727958588522135,"[0, 1, 0, 0, 1, 1, 0, 0, 0, 1]"
1675,3,3,6,0.29004969887030674,"[0, 1, 1, 0, 1, 1, 1, 1, 0, 1]"
1676,3,3,6,0.622366162136552,"[1, 0, 0, 1, 0, 1, 0, 0, 0, 0]"
1677,1,1,2,0.6635090825401591,"[1, 0, 1, 1, 0, 1, 0, 0, 0, 1]"
1678,2,2,4,0.2591038275270148,"[1, 0, 1, 1, 0, 1, 1, 1, 0, 1]"
1679,2,2,4,0.3697522037823594,"[0, 1, 1, 0, 1, 0, 1, 1, 0, 0]"
1680,2,2,4,0.3296273738722483,"[1, 1, 1, 1, 0, 1, 1, 0, 1, 1]"
1681,9,9,18,0.18247429162447482,"[1, 1, 1, 0, 1, 0, 0, 0, 1, 1]"
1682,1,1,2,0.9424864576920382,"[0, 1, 0, 0, 0, 1, 0, 1, 1, 0]"
1683,1,1,2,0.33965528907350706,"[0, 0, 0, 1, 0, 1, 0, 0, 1, 0]"
1684,2,2,4,0.7075384860972296,"[1, 0, 0, 0, 1, 1, 0, 0, 0, 1]"
1685,9,9,18,0.3279028817592462,"[1, 1, 0, 0, 0, 1, 1, 1, 1, 1]"
1686,3,3,6,0.29534490993325657,"[0, 0, 0, 1, 1, 0, 0, 1, 1, 0]"
1687,1,1,2,0.7515163298661625,"[1, 0, 1, 0, 0, 0, 0, 0, 0, 1]"
1688,5,5,10,0.942698369096128,"[0, 1, 1, 0, 0, 1, 0, 1, 0, 0]"
1689,11,11,22,0.13534040045937856,"[0, 0, 1, 1, 1, 1, 0, 1, 0, 0]"
1690,1,1,2,0.42693038747732814,"[1, 0, 1, 1, 1, 0, 1, 1, 0, 1]"
1691,5,5,10,0.7724552604655929,"[0, 0, 0, 1, 0, 0, 0, 0, 1, 0]"
1692,3,3,6,0.33623890365159315,"[0, 0, 1, 1, 0, 0, 0, 1, 0, 1]"
1693,1,1,2,0.4860390913653211,"[0, 1, 0, 1, 0, 0, 1, 0, 1, 1]"
1694,1,1,2,0.27006266808329515,"[0, 1, 1, 1, 1, 0, 0, 1, 1, 1]"
1695,5,5,10,0.5764182438936432,"[1, 1, 1, 1, 0, 0, 0, 0, 1, 0]"
1696,4,4,8,0.5545728403321564,"[0, 1, 1, 0, 1, 1, 0, 1, 0, 0]"
1697,4,4,8,0.4431861065850411,"[1, 0, 1, 0, 1, 1, 0, 1, 0, 0]"
1698,3,3,6,0.9119464856882588,"[1, 1, 1, 1, 1, 0, 1, 1, 1, 1]"
1699,1,1,2,0.6060320426408182,"[0, 0, 0, 1, 0, 1, 0, 1, 0, 0]"
1700,2,2,4,0.9102312703745302,"[1, 0, 0, 1, 0, 1, 1, 0, 0, 1]"
1701,3,3,6,0.30420004196666706,"[1, 0, 1, 0, 1, 0, 1, 1, 0, 1]"
1702,10,10,20,0.9029250401322098,"[1, 1, 0, 1, 0, 1, 0, 1, 0, 1]"
1703,2,2,4,0.08084104655308744,"[0, 0, 0, 1, 1, 1, 1, 1, 0, 1]"
1704,11,11,22,0.4222872033218249,"[1, 1, 0, 0, 0, 1, 0, 1, 0, 1]"
1705,5,5,10,0.27217931429083986,"[0, 0, 1, 0, 1, 1, 0, 1, 1, 1]"
1706,2,2,4,0.8727797982885438,"[1, 0, 1, 0, 0, 0, 0, 0, 1, 0]"
1707,1,1,2,0.11848221789604008,"[1, 0, 0, 1, 0, 1, 1, 0, 1, 1]"
1708,2,2,4,0.15193076903137193,"[1, 0, 0, 1, 1, 0, 0, 0, 0, 0]"
1709,1,1,2,0.6739471883680422,"[1, 1, 0, 0, 1, 0, 0, 1, 1, 1]"
1710,1,1,2,0.5251195328169473,"[1, 0, 1, 1, 0, 1, 1, 0, 0, 0]"
1711,2,2,4,0.10518748973361147,"[0, 1, 0, 0, 0, 1, 0, 1, 1, 0]"
1712,4,4,8,0.7160369954479254,"[1, 1, 0, 1, 0, 1, 1, 0, 0, 1]"
1713,4,4,8,0.39165342252844637,"[0, 1, 1, 0, 0, 0, 0, 0, 1, 1]"
1714,2,2,4,0.6141419239507445,"[1, 1, 0, 0, 0, 1, 1, 0, 0, 0]"
1715,4,4,8,0.6983469026135508,"[0, 1, 0, 0, 0, 0, 1, 1, 0, 1]"
1716,3,3,6,0.8558901035533582,"[0, 1, 0, 0, 1, 1, 1, 0, 1, 0]"
1717,1,1,2,0.24986688230411858,"[1, 1, 1, 0, 0, 1, 0, 0, 0, 0]"
1718,1,1,2,0.46390444112029405,"[1, 0, 0, 1, 1, 0, 0, 1, 1, 0]"
1719,9,9,18,0.9768041134462097,"[1, 0, 0, 1, 1, 0, 1, 0, 1, 1]"
1720,6,6,12,0.667576376438144,"[1, 1, 1, 1, 1, 0, 0, 0, 0, 0]"
1721,3,3,6,0.18544691078442443,"[1, 0, 1, 1, 0, 0, 1, 0, 1, 1]"
1722,5,5,10,0.0830588695985971,"[0, 0, 1, 1, 0, 1, 0, 1, 1, 0]"
1723,1,1,2,0.36872008232520914,"[0, 1, 0, 0, 1, 0, 0, 0, 0, 1]"
1724,2,2,4,0.309350945702902,"[0, 0, 0, 1, 1, 0, 1, 1, 0, 0]"
1725,2,2,4,0.5620474434625142,"[1, 0, 0, 0, 1, 0, 1, 0, 0, 1]"
1726,8,8,16,0.8799678536387947,"[1, 0, 1, 1, 1, 0, 0, 1, 1, 1]"
1727,8,8,16,0.3691746682452882,"[1, 0, 1, 1, 1, 0, 0, 1, 0, 1]"
1728,1,1,2,0.6371978465499486,"[1, 1, 1, 0, 0, 0, 0, 0, 1, 1]"
1729,1,1,2,0.7934909529208328,"[0, 1, 0, 0, 1, 1, 1, 0, 0, 0]"
1730,2,2,4,0.9232439418564381,"[1, 1, 1, 1, 1, 0, 0, 1, 1, 0]"
1731,1,1,2,0.8903995471436617,"[1, 0, 0, 0, 0, 0, 1, 1, 0, 0]"
1732,4,4,8,0.6870177067480613,"[1, 1, 1, 0, 0, 1, 0, 0, 0, 0]"
1733,19,19,38,0.17028998413960694,"[1, 1, 1, 1, 1, 0, 1, 1, 1, 1]"
1734,12,12,24,0.899532046074961,"[1, 1, 1, 0, 0, 1, 1, 1, 0, 1]"
1735,4,4,8,0.4187482954906726,"[1, 0, 1, 1, 1, 0, 0, 1, 0, 1]"
1736,5,5,10,0.5786387977208356,"[0, 0, 1, 1, 0, 1, 1, 1, 1, 0]"
1737,2,2,4,0.4994576812811481,"[1, 1, 0, 1, 1, 1, 1, 0, 0, 0]"
1738,5,5,10,0.44117283062196766,"[1, 1, 0, 1, 1, 1, 0, 0, 0, 0]"
1739,3,3,6,0.8024023358709089,"[0, 0, 1, 1, 0, 0, 0, 0, 1, 0]"
1740,8,8,16,0.07702581102153894,"[0, 0, 1, 1, 0, 1, 1, 1, 1, 0]"
1741,2,2,4,0.258365846961389,"[0, 1, 0, 1, 0, 1, 1, 0, 1, 0]"
1742,1,1,2,0.769684082863873,"[1, 1, 1, 1, 0, 1, 0, 0, 1, 0]"
1743,2,2,4,0.43440707043430715,"[0, 0, 0, 0, 0, 1, 0, 1, 0, 1]"
1744,3,3,6,0.4421493202238339,"[1, 1, 1, 1, 1, 1, 1, 1, 1, 1]"
1745,1,1,2,0.5452763901845973,"[1, 0, 0, 0, 1, 1, 0, 0, 1, 1]"
1746,2,2,4,0.9280572897712986,"[1, 0, 0, 0, 1, 1, 0, 1, 1, 1]"
1747,3,3,6,0.35676771052373235,"[0, 1, 1, 1, 0, 1, 0, 1, 1, 1]"
1748,2,2,4,0.11857361083067819,"[1, 0, 1, 1, 1, 1, 1, 1, 1, 0]"
1749,2,2,4,0.4259834321921987,"[0, 1, 1, 0, 1, 0, 0, 1, 1, 1]"
1750,2,2,4,0.7196782965677484,"[0, 1, 1, 0, 0, 0, 1, 1, 0, 1]"
1751,5,5,10,0.5309551378106742,"[1, 1, 0, 1, 1, 1, 1, 1, 1, 0]"
1752,8,8,16,0.1922173435552338,"[0, 0, 0, 1, 1, 1, 1, 0, 1, 1]"
1753,9,9,18,0.2298941073805224,"[1, 1, 1, 1, 1, 1, 0, 1, 1, 1]"
1754,1,1,2,0.4542406030995665,"[1, 1, 1, 0, 1, 0, 0, 0, 0, 1]"
1755,1,1,2,0.049448568441594065,"[0, 1, 0, 0, 1, 0, 1, 0, 0, 0]"
1756,5,5,10,0.24339960915622794,"[1, 0, 1, 0, 0, 1, 1, 1, 1, 1]"
1757,1,1,2,0.03379233564117745,"[0, 0, 1, 0, 0, 1, 1, 0, 1, 1]"
1758,3,3,6,0.3880096152290531,"[1, 0, 1, 1, 1, 0, 0, 0, 0, 1]"
1759,1,1,2,0.35428359109849694,"[0, 1, 1, 0, 0, 1, 0, 0, 1, 1]"
1760,10,10,20,0.43254072103799623,"[1, 1, 0, 1, 1, 0, 0, 1, 0, 1]"
1761,1,1,2,0.23760139273493075,"[0, 0, 1, 1, 1, 0, 0, 0, 0, 0]"
1762,5,5,10,0.598648427048467,"[1, 1, 0, 0, 1, 1, 1, 1, 1, 0]"
1763,4,4,8,0.736661105914577,"[1, 1, 0, 0, 1, 0, 0, 0, 1, 1]"
1764,2,2,4,0.36094366539596034,"[1, 1, 0, 1, 0, 0, 1, 0, 0, 1]"
1765,4,4,8,0.2992531634040143,"[0, 1, 0, 1, 0, 0, 1, 0, 1, 1]"
1766,2,2,4,0.27728007067695215,"[1, 0, 1, 1, 1, 0, 0, 1, 1, 0]"
1767,4,4,8,0.7647194232923213,"[1, 1, 0, 0, 0, 0, 1, 1, 1, 0]"
1768,1,1,2,0.9559999980793591,"[1, 0, 1, 1, 0, 0, 0, 0, 0, 0]"
1769,4,4,8,0.07199193915009239,"[0, 1, 0, 0, 1, 0, 0, 1, 1, 0]"
1770,2,2,4,0.40026643478969504,"[0, 1, 0, 1, 0, 1, 0, 0, 0, 0]"
1771,4,4,8,0.1370095418990569,"[0, 0, 1, 0, 1, 1, 0, 1, 1, 0]"
1772,2,2,4,0.2253659612995389,"[1, 1, 0, 1, 1, 0, 0, 1, 0, 0]"
1773,14,14,28,0.4936627546804634,"[1, 1, 0, 1, 1, 1, 1, 0, 0, 1]"
1774,1,1,2,0.14518886356116145,"[0, 0, 0, 0, 0, 0, 0, 0, 1, 0]"
1775,1,1,2,0.8811851897812818,"[1, 1, 0, 0, 0, 1, 1, 0, 0, 1]"
1776,17,17,34,0.3489875991180388,"[1, 1, 1, 1, 1, 1, 1, 1, 1, 1]"
1777,1,1,2,0.7738556506967825,"[0, 0, 0, 1, 1, 1, 1, 0, 0, 1]"
1778,1,1,2,0.04625491049487651,"[1, 0, 0, 1, 1, 0, 0, 0, 0, 1]"
1779,1,1,2,0.4132359379576638,"[1, 0, 0, 0, 1, 1, 0, 1, 0, 1]"
1780,1,1,2,0.655310358760204,"[0, 0, 0, 0, 0, 1, 0, 0, 0, 0]"
1781,10,10,20,0.6705038399623248,"[0, 1, 0, 0, 1, 0, 1, 1, 1, 1]"
1782,2,2,4,0.7722296543221575,"[1, 1, 0, 1, 1, 1, 1, 0, 1, 0]"
1783,3,3,6,0.030665775963838016,"[1, 0, 0, 0, 1, 1, 0, 0, 1, 1]"
1784,1,1,2,0.8458986938828218,"[0, 0, 1, 0, 0, 0, 0, 0, 1, 0]"
1785,4,4,8,0.4430627683093603,"[0, 1, 0, 1, 1, 1, 0, 1, 0, 0]"
1786,4,4,8,0.7108671427168136,"[1, 1, 1, 0, 1, 1, 1, 1, 0, 1]"
1787,9,9,18,0.19407873277158305,"[1, 1, 1, 0, 0, 1, 0, 1, 1, 1]"
1788,1,1,2,0.12856881640466145,"[0, 0, 0, 0, 1, 1, 0, 0, 0, 1]"
1789,1,1,2,0.5183930609938006,"[1, 1, 1, 1, 0, 1, 0, 1, 1, 1]"
1790,6,6,12,0.776081428926408,"[1, 0, 0, 1, 1, 1, 1, 1, 1, 0]"
1791,2,2,4,0.06143802747591942,"[0, 0, 0, 1, 0, 1, 0, 1, 0, 1]"
1792,2,2,4,0.636200549710998,"[0, 0, 0, 1, 1, 1, 1, 0, 0, 0]"
1793,6,6,12,0.8059643089675793,"[1, 0, 0, 1, 0, 0, 0, 1, 1, 1]"
1794,7,7,14,0.65063370634373,"[1, 0, 0, 1, 1, 0, 1, 1, 0, 0]"
1795,1,1,2,0.8866842519476524,"[1, 1, 0, 0, 0, 0, 0, 0, 0, 1]"
1796,1,1,2,0.7684216960531277,"[0, 1, 1, 1, 0, 0, 1, 0, 0, 0]"
1797,8,8,16,0.7848864403517899,"[0, 0, 1, 1, 1, 1, 0, 0, 0, 1]"
1798,2,2,4,0.02577631427508531,"[0, 0, 0, 1, 1, 0, 1, 1, 1, 1]"
1799,2,2,4,0.35614390409091823,"[0, 0, 1, 0, 1, 0, 0, 1, 0, 0]"
1800,2,2,4,0.9072240457017269,"[1, 1, 0, 0, 0, 1, 0, 1, 0, 1]"
1801,1,1,2,0.5559420736741884,"[0, 0, 1, 1, 0, 0, 1, 1, 1, 1]"
1802,4,4,8,0.3117701345408923,"[0, 1, 0, 0, 0, 0, 0, 1, 1, 1]"
1803,3,3,6,0.0729952713232992,"[1, 0, 1, 1, 1, 0, 1, 1, 1, 1]"
1804,5,5,10,0.4891987688163817,"[1, 0, 0, 0, 1, 1, 0, 1, 1, 1]"
1805,1,1,2,0.146019937417598,"[1, 0, 1, 0, 0, 1, 0, 1, 0, 1]"
1806,5,5,10,0.2737181971717707,"[0, 1, 0, 1, 0, 1, 0, 0, 0, 0]"
1807,3,3,6,0.3517989294510936,"[1, 1, 0, 0, 1, 0, 1, 0, 1, 0]"
1808,2,2,4,0.7792207947898122,"[1, 0, 0, 0, 1, 1, 0, 1, 0, 1]"
1809,1,1,2,0.6606343188219274,"[0, 0, 0, 1, 1, 0, 1, 0, 0, 1]"
1810,1,1,2,0.45635752951649533,"[1, 1, 0, 0, 1, 0, 0, 0, 0, 0]"
1811,1,1,2,0.5200597369635739,"[1, 1, 1, 1, 0, 1, 0, 1, 0, 1]"
1812,8,8,16,0.7732415722696466,"[1, 1, 1, 1, 1, 0, 0, 0, 0, 1]"
1813,1,1,2,0.8646324849553306,"[0, 1, 0, 1, 1, 0, 0, 1, 0, 0]"
1814,2,2,4,0.26966227556325384,"[1, 1, 1, 0, 0, 0, 0, 0, 0, 1]"
1815,22,22,44,0.3781533142986886,"[1, 1, 1, 1, 1, 0, 0, 1, 0, 0]"
1816,2,2,4,0.43881243843535145,"[1, 1, 1, 0, 1, 1, 0, 1, 1, 1]"
1817,5,5,10,0.8610573575296964,"[1, 0, 1, 1, 1, 1, 1, 1, 0, 0]"
1818,2,2,4,0.9070002559627889,"[0, 1, 0, 0, 1, 1, 1, 0, 0, 0]"
1819,1,1,2,0.022927750359125865,"[1, 0, 0, 1, 0, 1, 1, 1, 1, 0]"
1820,2,2,4,0.7694426697076724,"[0, 0, 1, 1, 1, 0, 0, 1, 1, 1]"
1821,10,10,20,0.3086340028427562,"[1, 0, 1, 0, 0, 1, 1, 1, 1, 1]"
1822,1,1,2,0.6208912542326974,"[0, 1, 1, 1, 0, 0, 1, 1, 0, 0]"
1823,4,4,8,0.23615170836663013,"[1, 1, 0, 1, 1, 1, 0, 1, 0, 0]"
1824,1,1,2,0.0926084306093995,"[0, 0, 0, 0, 0, 1, 0, 0, 0, 1]"
1825,1,1,2,0.21695217392509702,"[0, 0, 1, 0, 0, 1, 0, 1, 0, 0]"
1826,2,2,4,0.4115911900414224,"[1, 0, 1, 1, 0, 1, 1, 0, 0, 1]"
1827,10,10,20,0.5814865182651918,"[0, 1, 0, 0, 1, 0, 1, 1, 1, 1]"
1828,2,2,4,0.1337179241523031,"[0, 1, 0, 1, 1, 1, 0, 0, 1, 1]"
1829,2,2,4,0.03383508754515885,"[0, 1, 1, 0, 1, 0, 0, 1, 0, 0]"
1830,1,1,2,0.3253768918030272,"[0, 0, 1, 0, 0, 0, 1, 1, 1, 1]"
1831,1,1,2,0.5908288268851117,"[0, 1, 0, 0, 1, 0, 0, 0, 0, 1]"
1832,4,4,8,0.29209881295040885,"[0, 1, 0, 1, 1, 1, 1, 1, 1, 0]"
1833,7,7,14,0.6515671640717421,"[0, 1, 0, 1, 1, 1, 1, 0, 1, 0]"
1834,1,1,2,0.7893082082942294,"[1, 0, 1, 0, 0, 0, 1, 0, 1, 1]"
1835,1,1,2,0.281818587099928,"[0, 0, 0, 1, 1, 0, 0, 1, 0, 1]"
1836,1,1,2,0.09298025456790959,"[1, 0, 0, 1, 0, 1, 0, 0, 0, 1]"
1837,2,2,4,0.03567762282513964,"[0, 1, 0, 1, 0, 1, 0, 1, 0, 0]"
1838,2,2,4,0.40020182942375515,"[0, 1, 1, 0, 0, 1, 0, 1, 0, 0]"
1839,2,2,4,0.795663988114165,"[0, 1, 0, 0, 1, 0, 1, 1, 0, 1]"
1840,1,1,2,0.8416077161517924,"[1, 0, 0, 0, 1, 0, 1, 0, 0, 0]"
1841,2,2,4,0.6100544148443947,"[0, 0, 0, 0, 0, 0, 0, 1, 0, 1]"
1842,3,3,6,0.2513534591030274,"[1, 0, 1, 0, 0, 0, 0, 1, 1, 1]"
1843,1,1,2,0.7914415659918684,"[0, 0, 0, 1, 0, 0, 0, 1, 1, 1]"
1844,1,1,2,0.25947330677407976,"[0, 1, 0, 0, 0, 0, 0, 0, 0, 1]"
1845,7,7,14,0.5040679583460983,"[0, 1, 0, 0, 1, 1, 1, 1, 0, 1]"
1846,1,1,2,0.8970910615743518,"[1, 0, 0, 0, 1, 1, 0, 1, 1, 0]"
1847,1,1,2,0.43731827620798525,"[0, 1, 0, 1, 0, 1, 0, 0, 1, 1]"
1848,2,2,4,0.8140760270525599,"[1, 1, 1, 0, 0, 0, 1, 1, 1, 1]"
1849,5,5,10,0.5093873561098141,"[0, 1, 0, 0, 1, 1, 0, 0, 1, 0]"
1850,2,2,4,0.6958072306743195,"[1, 0, 0, 1, 1, 1, 1, 0, 1, 1]"
1851,1,1,2,0.5502985676138118,"[0, 1, 1, 1, 1, 1, 0, 0, 0, 1]"
1852,9,9,18,0.8586147905175545,"[1, 0, 1, 1, 1, 1, 0, 1, 1, 1]"
1853,1,1,2,0.9486110408589415,"[1, 1, 0, 0, 0, 0, 0, 1, 1, 0]"
1854,1,1,2,0.4215211763536296,"[1, 0, 1, 1, 0, 0, 0, 1, 0, 1]"
1855,2,2,4,0.4516279966541964,"[1, 0, 0, 1, 0, 1, 0, 1, 1, 1]"
1856,1,1,2,0.3747707542272275,"[0, 0, 1, 0, 0, 1, 0, 0, 0, 1]"
1857,2,2,4,0.24668988571098172,"[0, 0, 1, 0, 1, 0, 1, 0, 1, 1]"
1858,1,1,2,0.8624743822822775,"[1, 1, 1, 0, 0, 0, 1, 0, 0, 0]"
1859,1,1,2,0.45159900660200925,"[1, 1, 1, 1, 0, 0, 1, 0, 1, 0]"
1860,2,2,4,0.4694945141573075,"[0, 1, 1, 0, 1, 1, 1, 1, 1, 0]"
1861,1,1,2,0.5048376958841491,"[1, 0, 0, 0, 1, 1, 0, 0, 1, 0]"
1862,1,1,2,0.18164695925450025,"[0, 0, 0, 1, 1, 1, 0, 0, 1, 1]"
1863,1,1,2,0.16406814720803975,"[1, 1, 1, 1, 1, 1, 0, 1, 0, 1]"
1864,3,3,6,0.9069871753517369,"[0, 1, 1, 0, 1, 0, 1, 0, 0, 0]"
1865,1,1,2,0.7635055887727882,"[1, 1, 1, 1, 1, 1, 1, 0, 0, 0]"
1866,2,2,4,0.6537039455202642,"[1, 1, 1, 1, 0, 1, 0, 1, 0, 0]"
1867,1,1,2,0.4980790060806578,"[0, 1, 0, 1, 0, 1, 0, 1, 1, 0]"
1868,1,1,2,0.8837583125365691,"[0, 1, 1, 0, 0, 0, 1, 1, 0, 1]"
1869,1,1,2,0.4253663920413604,"[1, 0, 0, 0, 1, 1, 1, 1, 1, 0]"
1870,2,2,4,0.32373537636448313,"[1, 1, 0, 1, 1, 1, 0, 0, 0, 0]"
1871,2,2,4,0.5017291765326145,"[1, 0, 0, 0, 1, 1, 1, 1, 1, 1]"
1872,3,3,6,0.8429176717330354,"[1, 0, 1, 1, 0, 0, 0, 1, 1, 0]"
1873,5,5,10,0.36422223892268923,"[0, 0, 0, 1, 1, 1, 0, 1, 1, 0]"
1874,5,5,10,0.6523628042058471,"[1, 0, 1, 0, 1, 1, 0, 0, 0, 1]"
1875,1,1,2,0.9387611424520347,"[1, 0, 1, 0, 1, 0, 0, 0, 0, 0]"
1876,2,2,4,0.5815961524530399,"[0, 1, 0, 0, 1, 0, 0, 1, 0, 1]"
1877,3,3,6,0.020974354322428,"[1, 1, 0, 0, 1, 0, 0, 1, 0, 0]"
1878,4,4,8,0.9228652353597333,"[1, 1, 0, 1, 1, 1, 1, 0, 0, 1]"
1879,1,1,2,0.5919260673553649,"[0, 0, 1, 0, 1, 0, 0, 1, 0, 0]"
1880,1,1,2,0.5784094773131494,"[1, 1, 1, 0, 0, 1, 1, 0, 0, 1]"
1881,4,4,8,0.6832260673614928,"[0, 0, 0, 0, 1, 1, 1, 0, 0, 0]"
1882,2,2,4,0.8107817435073112,"[1, 1, 0, 0, 1, 1, 1, 0, 0, 0]"
1883,12,12,24,0.7157131022797002,"[1, 1, 0, 1, 1, 0, 1, 0, 1, 0]"
1884,1,1,2,0.421016325569732,"[0, 0, 1, 1, 0, 1, 0, 0, 0, 1]"
1885,5,5,10,0.12313756440749879,"[1, 0, 1, 0, 0, 1, 1, 1, 0, 1]"
1886,1,1,2,0.3843063136950098,"[1, 0, 0, 0, 1, 0, 1, 0, 0, 0]"
1887,1,1,2,0.5692328427571598,"[1, 1, 1, 0, 0, 0, 1, 0, 0, 0]"
1888,19,19,38,0.1045296178727525,"[1, 1, 1, 1, 1, 1, 0, 1, 1, 1]"
1889,3,3,6,0.4627331590949517,"[1, 0, 1, 0, 0, 1, 0, 1, 1, 0]"
1890,2,2,4,0.0943239550495657,"[1, 1, 0, 0, 1, 0, 0, 1, 1, 0]"
1891,2,2,4,0.46228456755279856,"[1, 1, 1, 0, 1, 0, 0, 0, 0, 0]"
1892,1,1,2,0.6310154155011248,"[1, 1, 1, 0, 0, 0, 1, 1, 1, 1]"
1893,3,3,6,0.7348966109596934,"[1, 1, 0, 0, 1, 1, 0, 0, 1, 1]"
1894,1,1,2,0.2109929130156093,"[1, 1, 0, 0, 1, 1, 1, 0, 0, 1]"
1895,4,4,8,0.8944739436769369,"[0, 1, 0, 1, 0, 1, 1, 0, 1, 0]"
1896,8,8,16,0.6619424117125675,"[1, 1, 1, 1, 1, 0, 0, 1, 1, 1]"
1897,1,1,2,0.8111203577611611,"[1, 1, 0, 0, 0, 1, 0, 1, 0, 0]"
1898,1,1,2,0.9585292905083053,"[1, 1, 1, 0, 0, 1, 1, 0, 0, 0]"
1899,2,2,4,0.7978310191764013,"[0, 0, 1, 1, 1, 1, 1, 1, 1, 1]"
1900,3,3,6,0.9631921311347265,"[0, 1, 1, 0, 0, 0, 1, 1, 0, 1]"
1901,3,3,6,0.5596944410091598,"[1, 1, 1, 0, 1, 0, 0, 1, 1, 0]"
1902,4,4,8,0.8144390811131426,"[0, 0, 1, 1, 1, 0, 0, 1, 1, 0]"
1903,4,4,8,0.3127242093755257,"[0, 1, 1, 0, 0, 0, 0, 1, 1, 1]"
1904,1,1,2,0.07994635995244925,"[1, 1, 1, 0, 0, 1, 1, 0, 0, 1]"
1905,1,1,2,0.8427132134225457,"[0, 0, 1, 0, 1, 0, 1, 0, 1, 1]"
1906,4,4,8,0.962440923198851,"[0, 1, 0, 0, 1, 1, 0, 1, 0, 1]"
1907,6,6,12,0.27928994903087767,"[0, 1, 1, 0, 0, 1, 1, 0, 1, 1]"
1908,2,2,4,0.7671496834125817,"[0, 0, 0, 1, 0, 0, 0, 1, 1, 1]"
1909,3,3,6,0.7588684954941448,"[0, 1, 1, 0, 1, 1, 0, 0, 1, 0]"
1910,6,6,12,0.12044525333939848,"[0, 0, 0, 0, 1, 1, 0, 1, 1, 1]"
1911,1,1,2,0.9046539391109811,"[0, 0, 1, 1, 0, 1, 0, 0, 0, 0]"
1912,1,1,2,0.7826982738533329,"[0, 1, 0, 1, 1, 0, 1, 0, 0, 1]"
1913,2,2,4,0.38099422282276174,"[1, 1, 0, 0, 0, 1, 1, 1, 1, 0]"
1914,2,2,4,0.3128870656309364,"[1, 0, 0, 0, 0, 0, 1, 0, 1, 1]"
1915,2,2,4,0.34184321705643794,"[1, 1, 0, 1, 1, 0, 0, 1, 0, 1]"
1916,7,7,14,0.04184177385617083,"[1, 1, 1, 0, 0, 0, 1, 1, 1, 0]"
1917,3,3,6,0.21484496442360212,"[0, 0, 1, 1, 1, 0, 0, 1, 0, 1]"
1918,10,10,20,0.7719055102447847,"[0, 1, 0, 0, 1, 1, 1, 1, 1, 1]"
1919,6,6,12,0.48037470713928077,"[1, 0, 1, 0, 0, 1, 1, 0, 0, 1]"
1920,1,1,2,0.27536618268373514,"[1, 0, 1, 0, 1, 0, 1, 1, 0, 1]"
1921,1,1,2,0.4488985533087355,"[0, 0, 0, 1, 1, 1, 0, 0, 1, 0]"
1922,2,2,4,0.7208541039657357,"[1, 1, 0, 1, 1, 0, 1, 0, 1, 1]"
1923,2,2,4,0.7954483945505989,"[1, 0, 1, 0, 1, 0, 0, 1, 1, 0]"
1924,7,7,14,0.5109402971991244,"[0, 0, 1, 1, 0, 1, 0, 0, 1, 0]"
1925,4,4,8,0.3492681453544758,"[1, 0, 0, 0, 1, 1, 0, 1, 0, 1]"
1926,2,2,4,0.13740519007662533,"[0, 0, 0, 1, 1, 1, 1, 1, 0, 1]"
1927,2,2,4,0.3069237795070442,"[1, 0, 0, 1, 0, 1, 1, 0, 1, 0]"
1928,1,1,2,0.02956175302497721,"[0, 0, 0, 0, 0, 0, 0, 0, 1, 0]"
1929,1,1,2,0.20321821965441167,"[0, 0, 1, 1, 0, 0, 0, 0, 0, 0]"
1930,4,4,8,0.2583239224893584,"[0, 1, 1, 0, 0, 0, 1, 1, 0, 1]"
1931,1,1,2,0.47845623782842417,"[1, 0, 0, 0, 1, 0, 0, 1, 0, 0]"
1932,3,3,6,0.7176404309692301,"[1, 0, 0, 0, 1, 1, 1, 1, 1, 1]"
1933,3,3,6,0.6805645548141227,"[1, 0, 1, 0, 0, 0, 0, 1, 1, 0]"
1934,1,1,2,0.7182276203904967,"[1, 0, 0, 1, 1, 1, 0, 0, 1, 1]"
1935,1,1,2,0.7833656709730211,"[0, 1, 0, 1, 1, 0, 1, 1, 1, 1]"
1936,1,1,2,0.736154721098472,"[0, 0, 0, 0, 1, 0, 1, 1, 1, 1]"
1937,2,2,4,0.5312872830812408,"[1, 0, 1, 0, 0, 0, 1, 0, 0, 1]"
1938,3,3,6,0.5965687432973853,"[0, 0, 0, 1, 0, 0, 1, 0, 1, 1]"
1939,2,2,4,0.5090503109685836,"[1, 0, 0, 1, 1, 0, 0, 0, 0, 1]"
1940,3,3,6,0.17566356735083077,"[0, 1, 0, 0, 1, 1, 0, 0, 0, 1]"
1941,3,3,6,0.3370545071236388,"[0, 1, 0, 0, 0, 0, 1, 1, 0, 1]"
1942,1,1,2,0.45613581576292617,"[1, 1, 1, 0, 0, 1, 0, 0, 1, 0]"
1943,6,6,12,0.5191152016802474,"[1, 1, 1, 1, 0, 0, 1, 1, 1, 1]"
1944,1,1,2,0.7719599319941722,"[0, 0, 0, 0, 1, 1, 0, 0, 1, 1]"
1945,4,4,8,0.888628277432713,"[1, 1, 1, 0, 1, 0, 1, 1, 0, 1]"
1946,1,1,2,0.7009052103016802,"[0, 1, 0, 0, 0, 0, 0, 0, 0, 1]"
1947,1,1,2,0.48912964953015337,"[1, 0, 1, 0, 1, 0, 0, 1, 0, 0]"
1948,8,8,16,0.9871879331823965,"[0, 1, 1, 0, 1, 1, 0, 0, 1, 0]"
1949,1,1,2,0.6655554199731122,"[0, 0, 1, 0, 0, 0, 1, 0, 0, 1]"
1950,5,5,10,0.5779571873543766,"[1, 1, 1, 1, 1, 0, 1, 0, 1, 0]"
1951,1,1,2,0.26187518141232535,"[0, 0, 0, 0, 1, 1, 1, 1, 0, 0]"
1952,2,2,4,0.5598149042507635,"[1, 0, 1, 1, 0, 0, 0, 1, 1, 0]"
1953,3,3,6,0.0061242347285188625,"[1, 1, 1, 0, 0, 1, 0, 0, 0, 0]"
1954,1,1,2,0.9643818807064467,"[0, 0, 0, 1, 1, 1, 0, 0, 0, 1]"
1955,2,2,4,0.2813116503300296,"[0, 1, 1, 0, 0, 1, 1, 0, 0, 0]"
1956,3,3,6,0.9687333328340177,"[0, 1, 1, 1, 0, 0, 0, 0, 0, 1]"
1957,3,3,6,0.9245291525897853,"[0, 0, 1, 1, 1, 0, 1, 1, 1, 0]"
1958,2,2,4,0.3624003183536397,"[0, 0, 1, 1, 1, 1, 0, 1, 1, 1]"
1959,1,1,2,0.5233669590748427,"[0, 0, 1, 0, 0, 1, 0, 0, 0, 0]"
1960,5,5,10,0.07686593410317055,"[1, 1, 0, 0, 0, 1, 0, 1, 1, 0]"
1961,1,1,2,0.5651374214283154,"[1, 0, 1, 1, 1, 0, 0, 1, 1, 0]"
1962,1,1,2,0.8318440447653273,"[0, 1, 1, 0, 0, 0, 1, 0, 0, 0]"
1963,1,1,2,0.02230392202530762,"[1, 1, 1, 0, 1, 0, 0, 0, 1, 0]"
1964,1,1,2,0.8053781064032172,"[0, 0, 0, 0, 0, 0, 0, 1, 1, 0]"
1965,1,1,2,0.6408808116558695,"[1, 1, 0, 0, 0, 0, 1, 0, 0, 1]"
1966,2,2,4,0.7220344186583346,"[0, 1, 1, 1, 0, 0, 1, 1, 0, 0]"
1967,1,1,2,0.19558803745742825,"[1, 0, 0, 1, 1, 0, 1, 0, 1, 1]"
1968,1,1,2,0.7557331438470417,"[0, 1, 1, 1, 1, 0, 1, 1, 0, 0]"
1969,1,1,2,0.9916937469341672,"[0, 0, 0, 0, 1, 0, 1, 0, 1, 1]"
1970,2,2,4,0.0738350839134918,"[0, 1, 1, 1, 1, 0, 1, 1, 0, 1]"
1971,5,5,10,0.8480497515201795,"[1, 0, 0, 1, 0, 1, 1, 1, 1, 1]"
1972,2,2,4,0.946223953657023,"[0, 1, 1, 1, 1, 0, 0, 0, 1, 0]"
1973,1,1,2,0.5019278147034592,"[1, 0, 1, 1, 1, 0, 0, 1, 0, 0]"
1974,2,2,4,0.2098500458226722,"[1, 1, 0, 0, 0, 0, 1, 0, 0, 0]"
1975,6,6,12,0.01609356636196213,"[1, 1, 0, 1, 0, 1, 1, 1, 0, 0]"
1976,7,7,14,0.6329107990129182,"[1, 1, 1, 1, 0, 1, 1, 1, 1, 0]"
1977,1,1,2,0.9516850875035986,"[0, 1, 0, 1, 0, 1, 0, 0, 0, 0]"
1978,3,3,6,0.41777333100704994,"[0, 1, 1, 0, 0, 0, 1, 1, 0, 1]"
1979,1,1,2,0.6924350156566392,"[0, 1, 1, 0, 1, 0, 0, 0, 1, 0]"
1980,2,2,4,0.3127655229036411,"[0, 1, 0, 1, 0, 0, 1, 1, 0, 0]"
1981,1,1,2,0.05609688355383813,"[0, 1, 1, 0, 0, 1, 1, 1, 0, 0]"
1982,2,2,4,0.04949397706543179,"[0, 1, 1, 1, 0, 0, 0, 0, 0, 1]"
1983,1,1,2,0.3981854717589606,"[1, 0, 1, 0, 1, 1, 1, 1, 0, 0]"
1984,6,6,12,0.4590139787060211,"[1, 1, 0, 0, 1, 1, 0, 1, 1, 1]"
1985,2,2,4,0.9047953640568036,"[1, 0, 1, 0, 1, 1, 0, 0, 0, 0]"
1986,2,2,4,0.2032980970417686,"[0, 1, 0, 0, 0, 1, 0, 1, 1, 1]"
1987,3,3,6,0.8077478193405454,"[1, 1, 0, 0, 1, 1, 1, 0, 0, 0]"
1988,8,8,16,0.7056448439146155,"[1, 1, 1, 1, 0, 0, 1, 0, 1, 0]"
1989,6,6,12,0.27860054145978197,"[1, 0, 1, 0, 0, 1, 0, 1, 0, 1]"
1990,3,3,6,0.5527666649179744,"[1, 0, 0, 1, 1, 0, 1, 1, 1, 1]"
1991,2,2,4,0.3061014507895613,"[1, 0, 0, 0, 0, 1, 1, 1, 1, 1]"
1992,4,4,8,0.7673210340100639,"[1, 0, 0, 0, 1, 1, 0, 0, 0, 0]"
1993,6,6,12,0.3429598238935505,"[0, 1, 1, 1, 1, 0, 0, 1, 1, 1]"
1994,2,2,4,0.2452283507551305,"[1, 1, 0, 1, 1, 0, 0, 0, 1, 1]"
1995,2,2,4,0.7703077434382934,"[1, 0, 0, 0, 0, 1, 0, 1, 0, 0]"
1996,1,1,2,0.3351594686185533,"[0, 1, 1, 0, 1, 1, 1, 1, 0, 0]"
1997,4,4,8,0.0865046825365573,"[1, 0, 1, 1, 0, 0, 0, 0, 0, 0]"
1998,2,2,4,0.32706906354519205,"[0, 0, 1, 1, 0, 1, 1, 1, 0, 0]"
1999,1,1,2,0.15089776425612145,"[0, 0, 0, 0, 1, 1, 0, 1, 0, 1]"
2000,1,1,2,0.10824512283158083,"[1, 0, 0, 0, 1, 1, 0, 0, 1, 0]"
2001,6,6,12,0.43357313798564545,"[1, 1, 0, 0, 1, 1, 1, 0, 1, 0]"
2002,1,1,2,0.400402315180479,"[0, 0, 0, 0, 1, 1, 1, 1, 0, 1]"
2003,1,1,2,0.12464112452362552,"[1, 0, 1, 1, 0, 1, 0, 1, 0, 0]"
2004,1,1,2,0.5556613848431486,"[1, 0, 1, 1, 0, 0, 0, 0, 0, 1]"
2005,1,1,2,0.27216240857972607,"[1, 0, 0, 1, 0, 0, 1, 1, 1, 1]"
2006,2,2,4,0.8966511430397729,"[1, 1, 0, 1, 1, 0, 0, 0, 1, 0]"
2007,3,3,6,0.5481808268332024,"[1, 0, 0, 1, 0, 0, 1, 1, 0, 1]"
2008,3,3,6,0.4624508054346467,"[1, 0, 0, 0, 0, 1, 0, 1, 0, 1]"
2009,4,4,8,0.13568824148557046,"[0, 1, 1, 1, 1, 1, 1, 0, 1, 0]"
2010,1,1,2,0.3175633654633089,"[0, 1, 0, 1, 1, 0, 0, 1, 0, 1]"
2011,1,1,2,0.7798373283450707,"[0, 0, 0, 1, 1, 1, 1, 1, 1, 0]"
2012,4,4,8,0.17176402010283365,"[1, 0, 0, 0, 0, 0, 1, 0, 1, 1]"
2013,2,2,4,0.7634330110365495,"[0, 1, 0, 1, 0, 1, 1, 0, 1, 0]"
2014,2,2,4,0.9407404960094155,"[1, 0, 1, 0, 0, 1, 0, 1, 0, 0]"
2015,2,2,4,0.1961814324777187,"[0, 0, 1, 1, 0, 1, 1, 0, 1, 1]"
2016,4,4,8,0.8123649186606241,"[1, 1, 0, 0, 0, 1, 1, 0, 1, 1]"
2017,1,1,2,0.7798519018217104,"[0, 1, 1, 1, 1, 1, 0, 1, 1, 0]"
2018,1,1,2,0.8110851736885292,"[0, 1, 1, 1, 1, 1, 0, 0, 0, 0]"
2019,1,1,2,0.11287858091683145,"[0, 0, 0, 1, 1, 0, 0, 1, 0, 1]"
2020,5,5,10,0.40494707478830316,"[1, 1, 1, 1, 1, 0, 1, 1, 1, 0]"
2021,1,1,2,0.07761441173139805,"[1, 1, 0, 1, 1, 0, 0, 1, 1, 1]"
2022,1,1,2,0.8301735833706753,"[0, 1, 0, 1, 0, 1, 1, 1, 0, 1]"
2023,1,1,2,0.9315394087253551,"[0, 0, 0, 1, 0, 0, 0, 0, 1, 0]"
2024,10,10,20,0.06174495874867392,"[1, 1, 1, 1, 0, 1, 0, 1, 1, 1]"
2025,2,2,4,0.5857702432178624,"[1, 0, 0, 1, 1, 0, 0, 0, 1, 0]"
2026,10,10,20,0.4255416442992924,"[0, 0, 1, 1, 1, 1, 1, 1, 0, 1]"
2027,6,6,12,0.8571659623895671,"[1, 1, 1, 1, 0, 1, 1, 0, 0, 0]"
2028,1,1,2,0.5377206565166271,"[1, 0, 1, 1, 1, 1, 0, 1, 0, 0]"
2029,1,1,2,0.4219364965660679,"[1, 1, 1, 0, 0, 0, 0, 1, 0, 0]"
2030,4,4,8,0.1773760818445802,"[0, 0, 1, 1, 0, 1, 1, 1, 1, 1]"
2031,1,1,2,0.7043705763914507,"[0, 0, 0, 1, 1, 0, 1, 0, 1, 0]"
2032,8,8,16,0.36293436507507226,"[1, 1, 1, 0, 0, 0, 0, 0, 0, 1]"
2033,2,2,4,0.7088127696981582,"[0, 0, 0, 1, 1, 1, 0, 1, 1, 0]"
2034,2,2,4,0.9203392238229132,"[0, 0, 0, 0, 0, 1, 0, 1, 0, 0]"
2035,2,2,4,0.4300970216789546,"[1, 1, 0, 0, 1, 0, 0, 1, 0, 0]"
2036,1,1,2,0.20796777505428365,"[0, 1, 0, 1, 1, 0, 1, 0, 1, 0]"
2037,1,1,2,0.8518953883162803,"[0, 0, 1, 1, 0, 0, 0, 0, 0, 0]"
2038,4,4,8,0.5599317132646676,"[1, 1, 0, 1, 1, 1, 1, 1, 0, 0]"
2039,3,3,6,0.03332419395352859,"[1, 1, 0, 0, 1, 1, 1, 0, 1, 0]"
2040,6,6,12,0.9339221388961159,"[1, 1, 0, 1, 1, 1, 1, 1, 0, 0]"
2041,7,7,14,0.08642415031672201,"[0, 1, 1, 0, 1, 0, 1, 1, 0, 0]"
2042,2,2,4,0.5407303744284462,"[1, 1, 0, 0, 0, 1, 0, 0, 1, 1]"
2043,1,1,2,0.1395670796524182,"[1, 0, 1, 0, 1, 0, 0, 1, 1, 1]"
2044,1,1,2,0.3629419992745647,"[0, 0, 1, 0, 0, 0, 1, 1, 1, 0]"
2045,8,8,16,0.04383361629362059,"[1, 1, 1, 1, 1, 1, 0, 1, 0, 1]"
2046,1,1,2,0.8288481535981719,"[0, 1, 0, 1, 1, 0, 0, 0, 0, 1]"
2047,1,1,2,0.9335704616175673,"[1, 1, 1, 1, 1, 1, 0, 1, 0, 1]"
2048,1,1,2,0.8570656540426198,"[1, 1, 1, 0, 0, 0, 0, 0, 1, 0]"
2049,9,9,18,0.05940879287500467,"[1, 1, 1, 0, 0, 1, 1, 0, 1, 1]"
2050,1,1,2,0.09182939970899773,"[0, 0, 0, 1, 0, 1, 0, 0, 0, 0]"
2051,5,5,10,0.3465900157801235,"[1, 1, 1, 0, 0, 0, 0, 1, 0, 1]"
2052,2,2,4,0.9018963756396058,"[1, 1, 1, 0, 1, 1, 1, 0, 0, 0]"
2053,5,5,10,0.9052584422024917,"[1, 1, 1, 1, 1, 0, 1, 0, 1, 1]"
2054,5,5,10,0.21004454472528533,"[0, 1, 0, 1, 0, 0, 1, 1, 0, 1]"
2055,1,1,2,0.6913191182159719,"[1, 0, 0, 1, 0, 1, 0, 1, 0, 0]"
2056,1,1,2,0.6223689069392464,"[0, 0, 1, 0, 1, 1, 1, 1, 0, 1]"
2057,7,7,14,0.07818531551099495,"[0, 1, 0, 1, 1, 0, 1, 1, 1, 1]"
2058,6,6,12,0.08963325587507043,"[0, 1, 1, 1, 1, 1, 1, 0, 1, 0]"
2059,1,1,2,0.12734505590581557,"[0, 1, 0, 1, 0, 0, 0, 1, 1, 0]"
2060,1,1,2,0.7358007012074765,"[0, 0, 1, 0, 0, 0, 0, 1, 1, 0]"
2061,1,1,2,0.309612561637173,"[0, 1, 0, 0, 0, 0, 0, 0, 1, 1]"
2062,6,6,12,0.657784125230496,"[1, 1, 0, 0, 1, 0, 0, 1, 0, 0]"
2063,5,5,10,0.9967009741386945,"[1, 1, 1, 1, 0, 1, 0, 0, 1, 0]"
2064,8,8,16,0.2720475188458813,"[0, 1, 0, 1, 0, 1, 1, 0, 1, 0]"
2065,4,4,8,0.3717869059895953,"[0, 1, 0, 1, 1, 1, 0, 1, 1, 0]"
2066,6,6,12,0.6500191155039212,"[1, 1, 1, 1, 1, 0, 0, 1, 1, 1]"
2067,6,6,12,0.9958854078359801,"[0, 1, 0, 1, 1, 0, 0, 1, 1, 0]"
2068,5,5,10,0.6697306466029778,"[0, 1, 1, 0, 1, 1, 0, 1, 0, 1]"
2069,2,2,4,0.08341508076035109,"[0, 0, 1, 0, 1, 1, 1, 1, 1, 1]"
2070,3,3,6,0.7206713583046475,"[1, 1, 0, 1, 0, 1, 0, 0, 0, 0]"
2071,7,7,14,0.9615897414494115,"[1, 1, 0, 1, 0, 0, 1, 1, 0, 1]"
2072,1,1,2,0.6988073862881035,"[1, 0, 0, 1, 0, 0, 1, 0, 0, 1]"
2073,1,1,2,0.6276038145583035,"[1, 0, 1, 0, 0, 1, 0, 1, 0, 0]"
2074,1,1,2,0.7871956653487936,"[0, 1, 1, 0, 0, 0, 1, 0, 0, 0]"
2075,1,1,2,0.8206082751394909,"[1, 1, 1, 0, 0, 1, 0, 1, 0, 1]"
2076,7,7,14,0.4899656844886895,"[1, 0, 1, 1, 0, 1, 0, 1, 0, 0]"
2077,1,1,2,0.4887178755433528,"[0, 0, 1, 1, 0, 1, 0, 0, 1, 1]"
2078,4,4,8,0.8974116504811995,"[0, 0, 1, 0, 1, 0, 1, 0, 1, 0]"
2079,2,2,4,0.9824328108410743,"[0, 1, 0, 1, 1, 0, 1, 0, 0, 0]"
2080,2,2,4,0.7829461852728199,"[0, 0, 1, 1, 1, 1, 0, 1, 0, 1]"
2081,4,4,8,0.8978818466510036,"[1, 1, 1, 1, 0, 0, 1, 0, 0, 0]"
2082,3,3,6,0.0366341931113886,"[0, 0, 1, 0, 0, 1, 1, 0, 1, 0]"
2083,2,2,4,0.5806628095706251,"[1, 0, 0, 0, 1, 0, 1, 1, 0, 0]"
2084,2,2,4,0.48594634140538684,"[0, 1, 0, 1, 1, 0, 0, 0, 0, 1]"
2085,1,1,2,0.37985320651831156,"[1, 0, 0, 0, 1, 0, 0, 1, 0, 0]"
2086,7,7,14,0.10147452694965575,"[1, 0, 0, 1, 0, 1, 0, 1, 1, 1]"
2087,1,1,2,0.4150492237941571,"[1, 0, 1, 0, 0, 0, 0, 0, 0, 0]"
2088,1,1,2,0.06917950830465025,"[1, 0, 1, 0, 0, 0, 1, 0, 0, 0]"
2089,2,2,4,0.7937788371421759,"[0, 1, 0, 0, 1, 1, 0, 1, 1, 1]"
2090,7,7,14,0.867631953849779,"[0, 1, 1, 0, 1, 1, 1, 1, 0, 1]"
2091,1,1,2,0.09349209220280563,"[1, 1, 0, 0, 1, 0, 0, 0, 0, 1]"
2092,1,1,2,0.7877697426882234,"[1, 0, 1, 0, 1, 0, 1, 0, 1, 0]"
2093,2,2,4,0.7603778851339698,"[0, 0, 1, 1, 0, 0, 1, 1, 0, 0]"
2094,5,5,10,0.6297188825604352,"[1, 0, 0, 1, 1, 1, 1, 1, 1, 0]"
2095,7,7,14,0.13367230960037857,"[1, 0, 0, 0, 1, 1, 1, 1, 1, 1]"
2096,2,2,4,0.22963792755398504,"[1, 0, 1, 1, 1, 0, 0, 0, 1, 1]"
2097,1,1,2,0.5426410854900928,"[1, 1, 0, 0, 0, 1, 0, 0, 1, 1]"
2098,3,3,6,0.4061713265962392,"[0, 1, 1, 0, 0, 1, 1, 1, 1, 0]"
2099,8,8,16,0.7560498904111362,"[0, 0, 1, 1, 0, 1, 1, 1, 1, 1]"
2100,2,2,4,0.5513987181821993,"[1, 0, 0, 0, 1, 1, 0, 1, 1, 1]"
2101,2,2,4,0.2326381792372999,"[0, 1, 1, 1, 1, 1, 1, 0, 1, 1]"
2102,4,4,8,0.6120841242248357,"[1, 0, 1, 1, 0, 0, 0, 0, 1, 1]"
2103,2,2,4,0.748200702057039,"[0, 0, 1, 0, 1, 0, 0, 1, 1, 1]"
2104,2,2,4,0.88693615560755,"[0, 0, 0, 1, 0, 1, 1, 0, 1, 1]"
2105,2,2,4,0.78831083584174,"[0, 1, 0, 0, 1, 0, 1, 0, 0, 1]"
2106,4,4,8,0.7674802194578981,"[1, 1, 0, 1, 0, 1, 0, 0, 0, 1]"
2107,2,2,4,0.6284729030627061,"[0, 1, 1, 0, 1, 0, 1, 1, 1, 0]"
2108,2,2,4,0.8322062158403418,"[1, 1, 1, 1, 1, 0, 1, 1, 1, 0]"
2109,1,1,2,0.6002723174400384,"[0, 0, 1, 1, 1, 0, 0, 1, 0, 0]"
2110,3,3,6,0.42166405777140226,"[1, 0, 1, 1, 0, 1, 0, 1, 1, 0]"
2111,2,2,4,0.7747494657869033,"[1, 0, 1, 1, 1, 0, 0, 1, 1, 0]"
2112,1,1,2,0.23861724903751147,"[1, 0, 0, 1, 0, 0, 1, 0, 1, 0]"
2113,4,4,8,0.5622637507229654,"[1, 0, 0, 0, 1, 0, 0, 1, 1, 0]"
2114,4,4,8,0.5056588356578791,"[0, 0, 1, 1, 1, 1, 0, 1, 0, 1]"
2115,2,2,4,0.6704127444657961,"[1, 1, 1, 1, 0, 0, 0, 1, 0, 0]"
2116,1,1,2,0.3703915407338525,"[0, 1, 1, 1, 1, 0, 0, 0, 1, 1]"
2117,1,1,2,0.2439996776891905,"[0, 1, 1, 1, 0, 1, 1, 0, 1, 0]"
2118,6,6,12,0.6891890381086438,"[0, 0, 0, 1, 0, 1, 0, 0, 1, 0]"
2119,3,3,6,0.3218754334261642,"[1, 1, 1, 0, 0, 0, 1, 1, 1, 0]"
2120,4,4,8,0.2654410570505541,"[0, 1, 0, 1, 1, 1, 1, 0, 0, 0]"
2121,1,1,2,0.14835398657094467,"[0, 0, 1, 1, 0, 1, 1, 0, 1, 1]"
2122,2,2,4,0.5577853735252365,"[0, 1, 0, 1, 0, 0, 1, 0, 0, 0]"
2123,6,6,12,0.7889023777710621,"[0, 0, 1, 1, 0, 1, 1, 0, 1, 1]"
2124,2,2,4,0.16564753454080683,"[1, 0, 1, 1, 0, 1, 0, 1, 0, 0]"
2125,1,1,2,0.8760516199428178,"[0, 1, 0, 1, 0, 0, 1, 0, 0, 0]"
2126,1,1,2,0.20576149549500267,"[0, 1, 1, 0, 0, 0, 1, 0, 1, 0]"
2127,7,7,14,0.29874645505626984,"[1, 1, 0, 1, 0, 1, 0, 1, 0, 1]"
2128,2,2,4,0.7833324532841647,"[0, 0, 1, 1, 1, 0, 1, 0, 0, 1]"
2129,2,2,4,0.20725954094744226,"[0, 0, 1, 1, 0, 1, 1, 1, 0, 1]"
2130,2,2,4,0.263555112613888,"[1, 0, 1, 0, 1, 0, 0, 0, 1, 1]"
2131,4,4,8,0.46687934412265786,"[0, 0, 1, 0, 1, 1, 0, 1, 0, 0]"
2132,1,1,2,0.11566402345903937,"[1, 0, 0, 0, 0, 0, 1, 0, 0, 1]"
2133,1,1,2,0.07269564355813896,"[1, 0, 0, 1, 0, 1, 0, 1, 0, 0]"
2134,4,4,8,0.6860595231715095,"[1, 0, 0, 1, 1, 1, 0, 0, 1, 1]"
2135,2,2,4,0.24443873264018356,"[1, 1, 0, 1, 1, 0, 0, 1, 0, 0]"
2136,1,1,2,0.0996821306603839,"[1, 0, 0, 0, 1, 1, 0, 0, 0, 1]"
2137,1,1,2,0.2856991999943381,"[1, 1, 0, 0, 1, 1, 1, 0, 0, 0]"
2138,1,1,2,0.08459584484104465,"[1, 0, 0, 0, 1, 0, 0, 1, 1, 0]"
2139,8,8,16,0.6874273927906677,"[1, 1, 1, 0, 0, 0, 1, 0, 1, 1]"
2140,1,1,2,0.20236203114577178,"[1, 1, 1, 0, 1, 0, 0, 0, 0, 1]"
2141,1,1,2,0.18837000149004723,"[1, 1, 1, 1, 0, 1, 0, 1, 0, 0]"
2142,8,8,16,0.3058885679670875,"[1, 0, 1, 1, 0, 1, 0, 1, 0, 1]"
2143,1,1,2,0.8910760535205492,"[0, 0, 0, 0, 1, 1, 0, 1, 0, 0]"
2144,2,2,4,0.19535120358699287,"[1, 1, 0, 0, 1, 0, 1, 1, 0, 0]"
2145,1,1,2,0.5180260376399032,"[1, 1, 0, 0, 1, 1, 0, 0, 0, 1]"
2146,2,2,4,0.680349789901469,"[0, 1, 0, 1, 1, 1, 0, 1, 1, 0]"
2147,1,1,2,0.9039297039785412,"[0, 0, 0, 1, 1, 1, 0, 1, 0, 0]"
2148,2,2,4,0.06480059405729821,"[0, 1, 0, 1, 0, 1, 1, 0, 1, 0]"
2149,3,3,6,0.3690416783644831,"[1, 0, 1, 1, 0, 0, 0, 0, 0, 0]"
2150,3,3,6,0.9301943035379894,"[1, 0, 0, 1, 0, 1, 0, 1, 0, 0]"
2151,3,3,6,0.3855055839662913,"[0, 0, 1, 1, 1, 0, 0, 1, 1, 0]"
2152,1,1,2,0.9003045287937288,"[0, 1, 0, 0, 1, 1, 1, 0, 0, 0]"
2153,3,3,6,0.7360884179377433,"[0, 1, 0, 0, 0, 0, 0, 1, 1, 0]"
2154,4,4,8,0.1736368690232124,"[1, 0, 0, 0, 1, 1, 1, 0, 1, 1]"
2155,1,1,2,0.386706171179945,"[1, 0, 1, 0, 1, 1, 0, 0, 1, 0]"
2156,2,2,4,0.01694807101924789,"[0, 1, 1, 1, 0, 1, 1, 1, 1, 1]"
2157,1,1,2,0.6257062859014282,"[0, 0, 0, 0, 1, 0, 1, 0, 1, 1]"
2158,1,1,2,0.3372094746528004,"[1, 0, 1, 1, 0, 0, 1, 1, 0, 1]"
2159,5,5,10,0.7925342154305792,"[0, 1, 0, 1, 0, 0, 0, 0, 0, 1]"
2160,3,3,6,0.6154593576871062,"[1, 1, 1, 0, 0, 1, 0, 0, 0, 0]"
2161,1,1,2,0.7358750729572855,"[0, 0, 1, 0, 0, 0, 1, 0, 0, 1]"
2162,1,1,2,0.2726983295366532,"[0, 0, 1, 0, 0, 0, 0, 0, 1, 0]"
2163,2,2,4,0.15118535616504047,"[1, 0, 0, 1, 0, 0, 0, 0, 0, 1]"
2164,5,5,10,0.36148746443367075,"[1, 0, 1, 0, 1, 0, 1, 1, 1, 1]"
2165,6,6,12,0.2964163901518707,"[1, 1, 0, 1, 1, 1, 0, 1, 0, 1]"
2166,1,1,2,0.5791212677922686,"[1, 1, 0, 1, 0, 0, 1, 0, 1, 0]"
2167,1,1,2,0.9380044661941728,"[0, 1, 1, 1, 1, 0, 1, 0, 1, 0]"
2168,1,1,2,0.47518475818451533,"[1, 0, 1, 0, 1, 0, 1, 1, 0, 1]"
2169,2,2,4,0.3178223653762954,"[0, 0, 1, 1, 0, 0, 1, 0, 0, 0]"
2170,1,1,2,0.4680564491093796,"[0, 0, 1, 1, 0, 1, 0, 0, 0, 0]"
2171,14,14,28,0.2670133277409157,"[1, 1, 0, 1, 0, 0, 0, 1, 0, 1]"
2172,2,2,4,0.23817851112847144,"[1, 0, 1, 0, 0, 1, 1, 0, 0, 0]"
2173,4,4,8,0.8593937665908087,"[1, 1, 1, 1, 1, 0, 0, 1, 1, 0]"
2174,1,1,2,0.40479490446603605,"[0, 1, 0, 1, 0, 1, 1, 0, 0, 0]"
2175,3,3,6,0.04863275069233852,"[0, 0, 1, 1, 0, 0, 1, 1, 0, 1]"
2176,6,6,12,0.5233044962042254,"[1, 0, 0, 1, 1, 1, 1, 1, 0, 0]"
2177,2,2,4,0.4641723493795693,"[1, 1, 0, 1, 0, 1, 0, 0, 0, 1]"
2178,5,5,10,0.039954707277491286,"[0, 0, 1, 0, 0, 0, 1, 1, 1, 0]"
2179,1,1,2,0.30643540888035503,"[0, 1, 0, 0, 1, 1, 0, 0, 0, 0]"
2180,1,1,2,0.9769703958305511,"[0, 1, 0, 1, 1, 0, 1, 0, 1, 0]"
2181,5,5,10,0.7079539342237318,"[1, 0, 0, 1, 0, 0, 0, 1, 1, 0]"
2182,4,4,8,0.6222188619673883,"[0, 0, 0, 1, 0, 0, 0, 0, 1, 1]"
2183,5,5,10,0.5460934686342467,"[1, 0, 0, 1, 0, 1, 1, 0, 1, 1]"
2184,1,1,2,0.24779770844030125,"[1, 1, 1, 1, 0, 1, 0, 0, 1, 1]"
2185,5,5,10,0.6463106251906793,"[1, 1, 1, 1, 1, 1, 0, 0, 0, 0]"
2186,1,1,2,0.4824694687750549,"[0, 0, 1, 1, 0, 1, 0, 1, 1, 0]"
2187,2,2,4,0.032796394825156505,"[0, 1, 0, 0, 0, 1, 0, 1, 1, 0]"
2188,3,3,6,0.37098554345702206,"[1, 0, 0, 0, 1, 1, 0, 0, 0, 1]"
2189,2,2,4,0.8822977315050864,"[0, 1, 0, 0, 0, 0, 1, 1, 1, 0]"
2190,1,1,2,0.803257811584639,"[1, 0, 1, 0, 1, 0, 1, 0, 0, 1]"
2191,9,9,18,0.8327274109877277,"[1, 0, 1, 1, 0, 0, 1, 0, 1, 1]"
2192,2,2,4,0.6741701356520303,"[0, 0, 1, 1, 0, 0, 1, 1, 1, 1]"
2193,13,13,26,0.26041028469053396,"[0, 0, 0, 1, 1, 1, 1, 0, 1, 1]"
2194,8,8,16,0.945943237621487,"[1, 0, 0, 1, 0, 0, 0, 1, 0, 1]"
2195,1,1,2,0.9913757406033831,"[1, 1, 1, 0, 0, 0, 1, 1, 0, 0]"
2196,3,3,6,0.9841795985619447,"[0, 0, 1, 1, 1, 0, 0, 1, 0, 0]"
2197,1,1,2,0.046593909178297976,"[0, 1, 0, 1, 0, 1, 1, 0, 1, 1]"
2198,4,4,8,0.5369333919921683,"[0, 1, 0, 0, 1, 1, 0, 1, 0, 1]"
2199,2,2,4,0.8504906839251055,"[0, 1, 1, 0, 0, 0, 0, 0, 1, 0]"
2200,5,5,10,0.4361623980865431,"[1, 1, 1, 0, 1, 1, 0, 1, 0, 0]"
2201,3,3,6,0.9781708631370394,"[0, 1, 1, 0, 1, 0, 0, 1, 0, 1]"
2202,5,5,10,0.8513092751923128,"[0, 1, 1, 0, 1, 0, 0, 1, 1, 1]"
2203,4,4,8,0.7450667807021187,"[1, 1, 1, 0, 0, 1, 1, 1, 0, 0]"
2204,5,5,10,0.5548123443378267,"[0, 0, 1, 1, 1, 1, 0, 0, 0, 1]"
2205,2,2,4,0.1813169527436621,"[0, 1, 1, 1, 0, 0, 0, 1, 1, 0]"
2206,4,4,8,0.7525735243890678,"[1, 0, 0, 0, 0, 1, 1, 1, 0, 1]"
2207,1,1,2,0.6693523464522455,"[0, 0, 1, 0, 0, 0, 1, 0, 0, 1]"
2208,1,1,2,0.07555725857400086,"[0, 0, 0, 0, 1, 0, 0, 0, 0, 1]"
2209,2,2,4,0.2975230393153958,"[0, 0, 1, 0, 1, 0, 1, 0, 0, 0]"
2210,1,1,2,0.076761556456733,"[1, 0, 0, 0, 0, 1, 0, 0, 1, 0]"
2211,1,1,2,0.1034359800079393,"[0, 1, 1, 1, 0, 0, 0, 0, 1, 0]"
2212,1,1,2,0.7572111345526064,"[0, 0, 0, 0, 1, 0, 1, 1, 1, 0]"
2213,4,4,8,0.28411037445820997,"[1, 0, 1, 0, 0, 1, 1, 1, 0, 0]"
2214,3,3,6,0.7863552078345821,"[1, 0, 1, 0, 1, 0, 1, 1, 0, 1]"
2215,4,4,8,0.6836670608808687,"[1, 0, 0, 0, 0, 1, 1, 1, 0, 0]"
2216,1,1,2,0.5254856421784369,"[1, 0, 1, 1, 1, 0, 0, 1, 1, 0]"
2217,10,10,20,0.33323358133790815,"[0, 1, 1, 1, 1, 0, 0, 1, 1, 1]"
2218,2,2,4,0.35188849647053744,"[0, 1, 1, 1, 0, 1, 0, 1, 0, 1]"
2219,1,1,2,0.33348703293452064,"[1, 0, 0, 1, 0, 0, 0, 0, 0, 1]"
2220,1,1,2,0.33220864103376624,"[0, 0, 1, 1, 1, 1, 1, 1, 0, 1]"
2221,1,1,2,0.9511479138921521,"[1, 0, 0, 0, 0, 1, 0, 0, 1, 0]"
2222,3,3,6,0.7164145155864519,"[0, 1, 1, 0, 1, 1, 0, 1, 1, 1]"
2223,4,4,8,0.7464895896004459,"[1, 1, 0, 0, 0, 1, 0, 0, 0, 1]"
2224,2,2,4,0.8851271241548041,"[1, 0, 1, 1, 0, 0, 0, 0, 1, 1]"
2225,1,1,2,0.9081390033340768,"[0, 0, 0, 0, 1, 0, 0, 1, 1, 1]"
2226,2,2,4,0.7703395009205398,"[1, 1, 1, 1, 0, 0, 0, 0, 1, 0]"
2227,1,1,2,0.9378953319377249,"[0, 1, 0, 1, 0, 0, 0, 1, 1, 1]"
2228,1,1,2,0.09887617086310374,"[0, 1, 0, 0, 1, 0, 0, 1, 0, 1]"
2229,3,3,6,0.3180090709282182,"[1, 0, 1, 1, 0, 1, 1, 1, 0, 0]"
2230,3,3,6,0.7722839733997109,"[0, 1, 1, 0, 1, 1, 0, 0, 1, 0]"
2231,1,1,2,0.5155565419213287,"[0, 1, 1, 0, 0, 0, 1, 0, 0, 0]"
2232,2,2,4,0.703568992897109,"[0, 1, 1, 1, 0, 1, 1, 0, 0, 1]"
2233,2,2,4,0.7014725268686172,"[0, 0, 1, 1, 0, 1, 0, 1, 1, 1]"
2234,3,3,6,0.6932448818628237,"[0, 1, 1, 0, 0, 1, 1, 1, 1, 1]"
2235,6,6,12,0.9148343019773951,"[1, 0, 0, 1, 0, 1, 1, 1, 0, 1]"
2236,5,5,10,0.2462247738871176,"[0, 0, 1, 1, 1, 1, 0, 1, 1, 1]"
2237,4,4,8,0.6583568650260404,"[1, 0, 0, 1, 0, 0, 0, 1, 1, 1]"
2238,2,2,4,0.04087397430690942,"[1, 1, 0, 1, 1, 0, 1, 0, 0, 0]"
2239,1,1,2,0.18686754553968687,"[1, 0, 0, 0, 1, 0, 1, 1, 1, 1]"
2240,1,1,2,0.9396887005258374,"[1, 1, 0, 0, 1, 0, 0, 1, 0, 0]"
2241,2,2,4,0.38902867682638587,"[0, 0, 0, 0, 1, 1, 0, 1, 1, 0]"
2242,4,4,8,0.9730625672825706,"[0, 0, 0, 1, 1, 0, 1, 0, 1, 1]"
2243,4,4,8,0.7032072757423047,"[1, 1, 1, 1, 0, 0, 0, 1, 0, 1]"
2244,4,4,8,0.312615379153107,"[1, 0, 0, 0, 0, 1, 1, 0, 1, 0]"
2245,4,4,8,0.4193857828448151,"[1, 1, 0, 1, 0, 0, 1, 0, 0, 0]"
2246,1,1,2,0.2053996129810981,"[0, 0, 1, 1, 1, 1, 1, 0, 1, 1]"
2247,3,3,6,0.2242182959565706,"[0, 0, 0, 1, 1, 0, 0, 0, 1, 1]"
2248,5,5,10,0.5133332269662348,"[0, 0, 1, 0, 1, 0, 1, 0, 0, 1]"
2249,6,6,12,0.9780964851694568,"[1, 1, 0, 0, 0, 0, 1, 1, 0, 1]"
2250,1,1,2,0.8697484065930112,"[0, 0, 0, 0, 1, 1, 1, 0, 1, 0]"
2251,2,2,4,0.4242285599544332,"[0, 1, 0, 1, 1, 1, 0, 1, 0, 0]"
2252,7,7,14,0.4320057450338358,"[0, 1, 1, 0, 1, 0, 1, 0, 0, 1]"
2253,1,1,2,0.9913289358540931,"[1, 1, 0, 0, 1, 0, 1, 0, 1, 1]"
2254,1,1,2,0.9419967666282444,"[1, 0, 0, 1, 0, 1, 0, 0, 1, 0]"
2255,5,5,10,0.642721434464375,"[0, 1, 1, 0, 0, 1, 1, 1, 1, 1]"
2256,4,4,8,0.48491184514620855,"[1, 0, 0, 1, 1, 1, 1, 0, 0, 0]"
2257,1,1,2,0.6526001542176452,"[0, 1, 1, 1, 1, 1, 0, 1, 0, 0]"
2258,8,8,16,0.2570971083095499,"[1, 0, 1, 1, 1, 0, 1, 1, 1, 1]"
2259,2,2,4,0.871489199982495,"[1, 0, 1, 0, 0, 1, 1, 0, 1, 0]"
2260,1,1,2,0.6896684490201855,"[1, 0, 0, 1, 0, 0, 0, 0, 1, 0]"
2261,8,8,16,0.913081172356402,"[1, 1, 0, 1, 1, 1, 0, 1, 1, 0]"
2262,1,1,2,0.1805594782927763,"[0, 1, 1, 1, 0, 0, 1, 0, 0, 0]"
2263,5,5,10,0.2702904322877915,"[1, 0, 1, 0, 1, 1, 0, 0, 0, 1]"
2264,1,1,2,0.3652428268337897,"[1, 0, 1, 0, 0, 1, 0, 1, 0, 0]"
2265,1,1,2,0.7767561923014172,"[0, 1, 0, 1, 1, 0, 1, 0, 1, 0]"
2266,3,3,6,0.564154901612799,"[1, 1, 0, 0, 1, 1, 1, 1, 0, 1]"
2267,1,1,2,0.8394524558572118,"[0, 0, 1, 1, 1, 0, 1, 0, 0, 0]"
2268,1,1,2,0.8615229115746204,"[0, 1, 1, 1, 0, 0, 0, 0, 0, 0]"
2269,2,2,4,0.6932836446691075,"[1, 1, 0, 0, 0, 1, 0, 1, 1, 0]"
2270,4,4,8,0.12060795356993848,"[1, 0, 0, 1, 1, 1, 0, 0, 1, 0]"
2271,1,1,2,0.7998309714813707,"[0, 1, 0, 0, 1, 1, 0, 0, 0, 0]"
2272,1,1,2,0.46843966196177955,"[1, 0, 1, 0, 0, 1, 1, 0, 1, 1]"
2273,5,5,10,0.20947538134418464,"[1, 1, 0, 1, 0, 0, 0, 1, 1, 1]"
2274,1,1,2,0.8134359924924125,"[0, 1, 0, 0, 1, 0, 0, 0, 1, 0]"
2275,4,4,8,0.40133990578664347,"[0, 1, 1, 0, 0, 1, 1, 0, 1, 1]"
2276,2,2,4,0.9687846886448781,"[0, 0, 0, 0, 0, 1, 0, 0, 1, 0]"
2277,2,2,4,0.3544137578830354,"[0, 0, 0, 1, 1, 0, 0, 1, 0, 1]"
2278,1,1,2,0.7287938674890534,"[1, 0, 0, 1, 1, 0, 1, 1, 0, 0]"
2279,4,4,8,0.32224300323302524,"[1, 1, 1, 1, 1, 1, 1, 1, 1, 0]"
2280,1,1,2,0.28845714026851865,"[1, 0, 0, 1, 0, 1, 1, 0, 1, 1]"
2281,2,2,4,0.9641720061178347,"[0, 0, 1, 0, 1, 0, 1, 1, 0, 0]"
2282,8,8,16,0.2245755012463062,"[1, 0, 0, 1, 1, 1, 0, 0, 0, 0]"
2283,3,3,6,0.6930863050260077,"[0, 1, 1, 0, 1, 1, 0, 1, 1, 1]"
2284,1,1,2,0.4484222462981604,"[1, 0, 1, 1, 0, 0, 1, 0, 1, 1]"
2285,3,3,6,0.5569643578824636,"[1, 0, 0, 1, 1, 0, 0, 0, 1, 0]"
2286,2,2,4,0.7244027516978052,"[1, 0, 1, 0, 1, 0, 1, 1, 0, 1]"
2287,1,1,2,0.9675096449367839,"[1, 1, 0, 1, 0, 0, 1, 0, 0, 0]"
2288,1,1,2,0.35395866850789504,"[1, 0, 0, 1, 0, 0, 0, 1, 1, 1]"
2289,3,3,6,0.8059058557429445,"[0, 1, 1, 0, 0, 0, 0, 1, 1, 0]"
2290,3,3,6,0.04633027825244951,"[0, 1, 0, 0, 0, 0, 0, 0, 1, 1]"
2291,2,2,4,0.9669328228996689,"[1, 0, 1, 1, 0, 0, 0, 1, 1, 0]"
2292,3,3,6,0.8045979040297552,"[0, 0, 0, 1, 1, 1, 1, 1, 0, 0]"
2293,2,2,4,0.3247067272933458,"[0, 0, 0, 1, 1, 1, 1, 0, 1, 0]"
2294,1,1,2,0.9014367811072705,"[1, 0, 1, 0, 0, 1, 1, 0, 1, 1]"
2295,2,2,4,0.6373679959686405,"[1, 0, 1, 0, 0, 1, 0, 1, 0, 0]"
2296,1,1,2,0.6368005466001148,"[0, 0, 0, 1, 1, 1, 1, 0, 0, 1]"
2297,1,1,2,0.7610690229381997,"[1, 0, 0, 0, 0, 1, 1, 1, 0, 0]"
2298,5,5,10,0.7632834243775062,"[1, 1, 1, 0, 0, 1, 1, 1, 0, 1]"
2299,1,1,2,0.6189346954153001,"[0, 0, 0, 0, 0, 0, 0, 1, 0, 0]"
2300,1,1,2,0.4352293002090347,"[0, 1, 1, 0, 0, 0, 0, 0, 1, 0]"
2301,3,3,6,0.7874518534983544,"[0, 0, 0, 1, 1, 0, 1, 1, 0, 0]"
2302,2,2,4,0.058317265843146227,"[1, 1, 0, 0, 0, 0, 1, 1, 1, 1]"
2303,2,2,4,0.6930875725909003,"[1, 1, 1, 0, 1, 0, 0, 0, 0, 0]"
2304,2,2,4,0.9221149358389116,"[0, 0, 1, 1, 1, 0, 0, 1, 1, 0]"
2305,2,2,4,0.7419203788830084,"[0, 1, 1, 1, 1, 0, 1, 0, 1, 0]"
2306,3,3,6,0.6601590538799721,"[0, 0, 0, 1, 0, 1, 0, 1, 0, 0]"
2307,1,1,2,0.36160688925188267,"[0, 0, 1, 0, 0, 0, 1, 1, 1, 0]"
2308,2,2,4,0.5991321333654677,"[0, 0, 1, 1, 0, 0, 0, 0, 0, 1]"
2309,7,7,14,0.5744444021350866,"[0, 0, 1, 1, 1, 0, 0, 1, 1, 0]"
2310,1,1,2,0.08542384221728316,"[1, 0, 0, 0, 1, 0, 1, 0, 0, 1]"
2311,1,1,2,0.28113922324163565,"[0, 1, 0, 0, 0, 0, 1, 0, 1, 0]"
2312,3,3,6,0.30669302114738295,"[1, 1, 1, 1, 0, 0, 1, 1, 1, 0]"
2313,2,2,4,0.6192687004789134,"[0, 0, 1, 1, 1, 0, 0, 1, 0, 1]"
2314,1,1,2,0.8676725611567226,"[0, 1, 1, 1, 0, 1, 1, 0, 1, 1]"
2315,1,1,2,0.8833857476362151,"[1, 0, 0, 0, 1, 0, 0, 0, 1, 1]"
2316,7,7,14,0.8049705325164827,"[1, 0, 1, 0, 1, 1, 1, 0, 1, 1]"
2317,3,3,6,0.5823275980135935,"[1, 0, 1, 1, 1, 1, 0, 0, 1, 1]"
2318,2,2,4,0.002660682533608516,"[1, 0, 0, 1, 0, 0, 1, 1, 1, 1]"
2319,3,3,6,0.07495567230199829,"[1, 0, 0, 0, 0, 1, 0, 0, 1, 1]"
2320,21,21,42,0.8431968627060558,"[1, 0, 1, 0, 1, 1, 1, 0, 0, 1]"
2321,5,5,10,0.6805954080461337,"[1, 0, 0, 1, 0, 0, 1, 0, 0, 0]"
2322,2,2,4,0.08586147438905634,"[1, 0, 0, 1, 1, 1, 0, 0, 0, 1]"
2323,2,2,4,0.7909827834322984,"[0, 1, 0, 0, 0, 0, 1, 0, 0, 1]"
2324,3,3,6,0.9450077371115666,"[1, 0, 1, 1, 1, 0, 1, 1, 1, 1]"
2325,4,4,8,0.313975356127969,"[0, 0, 1, 1, 0, 0, 0, 0, 0, 1]"
2326,4,4,8,0.12541398605916554,"[1, 1, 0, 1, 0, 1, 1, 1, 0, 0]"
2327,1,1,2,0.8052592323798121,"[1, 1, 0, 1, 0, 0, 0, 1, 1, 0]"
2328,6,6,12,0.7939742900210075,"[0, 0, 1, 0, 1, 1, 0, 1, 1, 0]"
2329,5,5,10,0.39067129594310157,"[1, 0, 0, 1, 1, 0, 0, 0, 0, 1]"
2330,2,2,4,0.9548169378834,"[1, 1, 0, 1, 1, 1, 0, 0, 0, 1]"
2331,1,1,2,0.06936123364379276,"[1, 0, 1, 1, 1, 1, 1, 1, 0, 1]"
2332,6,6,12,0.37021299081993764,"[0, 0, 1, 1, 0, 1, 0, 1, 1, 1]"
2333,3,3,6,0.03792882900125105,"[0, 1, 0, 1, 0, 1, 1, 0, 0, 0]"
2334,1,1,2,0.4844457694869706,"[1, 0, 1, 1, 0, 1, 0, 1, 0, 0]"
2335,2,2,4,0.27303638598280144,"[0, 1, 1, 1, 0, 0, 1, 0, 1, 1]"
2336,1,1,2,0.9230215007281086,"[1, 0, 0, 1, 0, 0, 0, 0, 0, 0]"
2337,1,1,2,0.914206679777895,"[0, 0, 1, 0, 0, 1, 0, 1, 0, 0]"
2338,2,2,4,0.7292463625401719,"[0, 0, 1, 0, 1, 1, 0, 0, 1, 0]"
2339,4,4,8,0.11964510084875246,"[1, 0, 1, 1, 1, 1, 0, 0, 0, 0]"
2340,1,1,2,0.83086001814412,"[0, 0, 0, 1, 1, 0, 0, 0, 1, 1]"
2341,1,1,2,0.8531163756619243,"[0, 0, 1, 0, 1, 0, 1, 0, 0, 0]"
2342,5,5,10,0.3527272822274201,"[1, 1, 1, 1, 1, 0, 0, 1, 1, 1]"
2343,1,1,2,0.16940488012886878,"[0, 0, 0, 1, 1, 0, 1, 0, 0, 1]"
2344,2,2,4,0.5613603481950987,"[0, 0, 1, 0, 1, 1, 1, 1, 0, 1]"
2345,4,4,8,0.4508334094408426,"[1, 1, 1, 0, 1, 0, 0, 0, 1, 1]"
2346,9,9,18,0.1819718682903313,"[0, 1, 1, 0, 1, 0, 1, 1, 1, 1]"
2347,3,3,6,0.12103070398740423,"[0, 1, 1, 1, 0, 1, 0, 1, 0, 1]"
2348,2,2,4,0.20833184417619488,"[0, 1, 1, 1, 1, 0, 0, 1, 0, 1]"
2349,1,1,2,0.36065932018197333,"[1, 0, 0, 1, 0, 1, 1, 1, 1, 1]"
2350,2,2,4,0.1216167206248322,"[0, 1, 1, 0, 1, 0, 1, 1, 0, 0]"
2351,1,1,2,0.8315955589093927,"[0, 0, 0, 1, 1, 0, 0, 1, 0, 0]"
2352,3,3,6,0.9580990369626718,"[0, 1, 0, 0, 0, 0, 1, 0, 1, 0]"
2353,1,1,2,0.549416076632483,"[0, 0, 1, 1, 1, 0, 0, 1, 1, 0]"
2354,2,2,4,0.1368423539198358,"[1, 1, 0, 0, 1, 1, 0, 0, 0, 0]"
2355,3,3,6,0.0038644125728941603,"[1, 0, 0, 0, 1, 1, 1, 1, 0, 1]"
2356,1,1,2,0.01606631753192933,"[0, 0, 0, 0, 0, 0, 1, 0, 0, 0]"
2357,3,3,6,0.8544460588138059,"[1, 0, 1, 1, 0, 1, 1, 0, 0, 0]"
2358,6,6,12,0.4769308441764527,"[1, 1, 0, 0, 0, 1, 1, 1, 1, 0]"
2359,4,4,8,0.3374995469004053,"[1, 1, 0, 1, 1, 0, 0, 0, 1, 1]"
2360,4,4,8,0.5651244088501558,"[1, 0, 0, 0, 0, 1, 1, 1, 1, 1]"
2361,2,2,4,0.09408729610109734,"[0, 1, 0, 0, 0, 0, 1, 1, 0, 1]"
2362,1,1,2,0.014445943887797075,"[0, 1, 1, 0, 0, 0, 0, 0, 1, 1]"
2363,3,3,6,0.7361034261613659,"[0, 0, 1, 0, 0, 1, 1, 1, 0, 1]"
2364,1,1,2,0.10244563263774165,"[0, 1, 0, 0, 1, 0, 1, 0, 0, 1]"
2365,2,2,4,0.6965034161189101,"[0, 1, 1, 0, 0, 0, 0, 1, 1, 1]"
2366,1,1,2,0.5540151046709967,"[1, 0, 1, 0, 1, 1, 0, 0, 1, 0]"
2367,3,3,6,0.5050816036318501,"[1, 1, 1, 0, 0, 0, 0, 0, 0, 1]"
2368,1,1,2,0.8915205256330196,"[0, 0, 1, 0, 1, 0, 1, 1, 1, 1]"
2369,3,3,6,0.08913619879316037,"[0, 0, 1, 0, 0, 1, 1, 1, 0, 0]"
2370,1,1,2,0.11823647691647787,"[0, 0, 1, 1, 0, 1, 0, 1, 1, 0]"
2371,1,1,2,0.176930034834217,"[0, 0, 0, 1, 1, 1, 1, 0, 1, 0]"
2372,2,2,4,0.05808536894355043,"[1, 1, 1, 0, 1, 1, 0, 1, 0, 0]"
2373,1,1,2,0.6016068418487026,"[1, 0, 0, 1, 0, 1, 1, 0, 1, 0]"
2374,2,2,4,0.5524918786294403,"[0, 1, 0, 0, 1, 0, 1, 1, 0, 0]"
2375,1,1,2,0.8662561298754224,"[0, 1, 0, 0, 1, 0, 0, 0, 0, 0]"
2376,5,5,10,0.6915346487578703,"[0, 0, 1, 1, 0, 1, 0, 0, 0, 1]"
2377,1,1,2,0.37219836666542294,"[0, 0, 0, 1, 0, 0, 1, 0, 1, 1]"
2378,2,2,4,0.10252997838005395,"[0, 0, 0, 0, 1, 1, 1, 0, 1, 0]"
2379,3,3,6,0.4829193923103585,"[0, 1, 0, 0, 0, 1, 0, 0, 1, 0]"
2380,1,1,2,0.5842198451482326,"[1, 0, 1, 1, 1, 0, 0, 1, 1, 1]"
2381,1,1,2,0.8917126915836642,"[0, 1, 0, 1, 0, 0, 0, 0, 1, 0]"
2382,1,1,2,0.653460645447907,"[0, 1, 1, 0, 0, 1, 0, 0, 1, 0]"
2383,5,5,10,0.22233117955734938,"[0, 1, 1, 1, 0, 0, 0, 0, 1, 0]"
2384,5,5,10,0.21534670529539013,"[0, 0, 1, 0, 1, 0, 1, 0, 1, 0]"
2385,4,4,8,0.813578930515534,"[0, 0, 1, 0, 1, 0, 0, 1, 1, 1]"
2386,2,2,4,0.18689992547058132,"[1, 0, 0, 0, 1, 0, 0, 1, 0, 0]"
2387,1,1,2,0.3066927812800846,"[0, 1, 0, 0, 1, 0, 1, 1, 0, 1]"
2388,3,3,6,0.10962278592092711,"[1, 1, 0, 1, 0, 1, 0, 1, 1, 1]"
2389,2,2,4,0.2085252503828967,"[0, 0, 0, 0, 0, 0, 1, 1, 0, 0]"
2390,1,1,2,0.3418359200468958,"[1, 0, 1, 0, 1, 0, 1, 0, 1, 0]"
2391,2,2,4,0.01660848894607947,"[0, 0, 1, 0, 0, 1, 1, 0, 1, 0]"
2392,4,4,8,0.751392912887413,"[0, 1, 0, 1, 1, 0, 1, 1, 1, 0]"
2393,4,4,8,0.17410702843098624,"[1, 1, 0, 0, 1, 0, 1, 0, 1, 0]"
2394,2,2,4,0.1569609195109951,"[0, 0, 1, 0, 1, 0, 0, 0, 1, 0]"
2395,1,1,2,0.6298710161902391,"[0, 0, 0, 0, 0, 0, 0, 1, 0, 0]"
2396,2,2,4,0.14478179528625001,"[0, 0, 1, 0, 1, 0, 0, 1, 0, 1]"
2397,10,10,20,0.8226974424148549,"[1, 1, 0, 0, 0, 1, 1, 1, 1, 1]"
2398,1,1,2,0.005526315408786786,"[0, 0, 1, 0, 1, 0, 1, 1, 1, 1]"
2399,6,6,12,0.4066562099253789,"[1, 0, 1, 1, 1, 1, 1, 1, 1, 0]"
2400,3,3,6,0.236822968076004,"[1, 0, 1, 0, 0, 1, 1, 1, 1, 1]"
2401,1,1,2,0.8120915006097529,"[1, 1, 1, 1, 0, 1, 1, 0, 1, 1]"
2402,2,2,4,0.5889304520241662,"[0, 0, 1, 0, 1, 0, 0, 0, 0, 1]"
2403,2,2,4,0.4434653576952866,"[0, 0, 0, 0, 1, 1, 0, 1, 1, 1]"
2404,2,2,4,0.3762776061474209,"[1, 1, 1, 0, 1, 0, 0, 0, 0, 0]"
2405,1,1,2,0.3512371072766983,"[0, 1, 0, 0, 0, 0, 0, 0, 0, 0]"
2406,1,1,2,0.9572617728340373,"[0, 1, 0, 1, 0, 0, 0, 0, 0, 1]"
2407,4,4,8,0.8952680280829473,"[1, 0, 0, 0, 1, 0, 0, 1, 1, 1]"
2408,2,2,4,0.39322979667710656,"[1, 1, 0, 1, 1, 0, 0, 1, 1, 0]"
2409,3,3,6,0.9880969049979872,"[1, 1, 1, 0, 1, 0, 1, 1, 1, 0]"
2410,3,3,6,0.9630560771525024,"[0, 1, 1, 0, 1, 1, 1, 1, 0, 0]"
2411,2,2,4,0.9226297925763107,"[1, 0, 1, 0, 0, 1, 1, 1, 0, 1]"
2412,2,2,4,0.1595268802964228,"[1, 1, 0, 1, 1, 1, 0, 0, 0, 0]"
2413,2,2,4,0.5756065393741185,"[1, 1, 0, 0, 1, 0, 0, 1, 0, 0]"
2414,2,2,4,0.8881545068659565,"[0, 0, 0, 0, 0, 1, 0, 1, 0, 0]"
2415,1,1,2,0.755937251773269,"[0, 0, 0, 1, 0, 1, 0, 1, 1, 1]"
2416,3,3,6,0.70521588410341,"[0, 0, 0, 1, 0, 1, 0, 0, 0, 0]"
2417,2,2,4,0.7314709532088515,"[0, 0, 1, 0, 1, 0, 0, 1, 0, 1]"
2418,1,1,2,0.5050959602507021,"[0, 0, 0, 0, 0, 1, 0, 0, 1, 1]"
2419,3,3,6,0.4605900959332362,"[0, 1, 0, 1, 1, 0, 1, 0, 1, 0]"
2420,4,4,8,0.4886329645846319,"[0, 1, 1, 0, 0, 0, 1, 0, 1, 1]"
2421,3,3,6,0.655174183152116,"[1, 0, 1, 0, 1, 1, 0, 0, 1, 1]"
2422,1,1,2,0.4835198456635519,"[0, 1, 0, 1, 1, 1, 0, 0, 0, 0]"
2423,3,3,6,0.4345145009642678,"[0, 0, 0, 0, 0, 1, 0, 1, 1, 0]"
2424,1,1,2,0.3595446373288509,"[0, 0, 0, 0, 0, 0, 1, 0, 0, 0]"
2425,6,6,12,0.5123679632021225,"[1, 0, 1, 1, 0, 1, 1, 0, 0, 1]"
2426,2,2,4,0.29629887016123524,"[0, 0, 0, 0, 0, 1, 0, 0, 0, 1]"
2427,2,2,4,0.7222420646344258,"[1, 1, 0, 0, 0, 0, 1, 0, 0, 1]"
2428,1,1,2,0.9769634949454198,"[0, 1, 1, 0, 0, 1, 0, 0, 1, 0]"
2429,2,2,4,0.48720311749696976,"[1, 0, 1, 1, 0, 1, 0, 0, 0, 1]"
2430,12,12,24,0.1827435715654676,"[1, 0, 1, 0, 1, 1, 1, 1, 0, 1]"
2431,3,3,6,0.1296761943757493,"[0, 1, 0, 1, 1, 0, 0, 1, 0, 0]"
2432,1,1,2,0.8786464787979802,"[0, 1, 1, 0, 0, 0, 1, 0, 1, 1]"
2433,5,5,10,0.14801265433218425,"[0, 0, 1, 1, 0, 1, 1, 1, 0, 0]"
2434,1,1,2,0.9587090836793475,"[1, 1, 0, 0, 0, 0, 0, 1, 0, 0]"
2435,6,6,12,0.08192640250093108,"[1, 1, 0, 1, 0, 1, 1, 1, 0, 0]"
2436,4,4,8,0.8330009489357756,"[1, 0, 1, 1, 0, 0, 0, 1, 0, 0]"
2437,16,16,32,0.18993028306899518,"[1, 0, 1, 1, 1, 1, 1, 0, 1, 0]"
2438,7,7,14,0.3320807833742184,"[1, 1, 0, 0, 1, 1, 0, 0, 1, 1]"
2439,1,1,2,0.9100563284494644,"[0, 0, 1, 1, 0, 0, 1, 0, 1, 1]"
2440,3,3,6,0.9425998719330698,"[1, 1, 0, 0, 1, 0, 0, 1, 0, 1]"
2441,1,1,2,0.5510435132365308,"[0, 0, 0, 0, 1, 0, 0, 0, 1, 1]"
2442,1,1,2,0.8873346204174793,"[0, 0, 0, 0, 1, 1, 0, 0, 0, 0]"
2443,2,2,4,0.7801008884514813,"[0, 1, 0, 1, 1, 0, 1, 0, 1, 1]"
2444,1,1,2,0.5365162847420369,"[0, 1, 0, 0, 0, 0, 0, 0, 1, 0]"
2445,1,1,2,0.4529784621798546,"[1, 0, 1, 1, 1, 1, 1, 0, 1, 0]"
2446,4,4,8,0.544639896807198,"[1, 0, 1, 1, 1, 0, 1, 1, 1, 0]"
2447,1,1,2,0.9397521872459695,"[0, 0, 1, 0, 1, 0, 1, 1, 0, 1]"
2448,2,2,4,0.028461889542211738,"[1, 0, 0, 1, 1, 1, 1, 0, 0, 0]"
2449,4,4,8,0.8311764094171249,"[1, 1, 0, 1, 0, 0, 0, 0, 0, 0]"
2450,2,2,4,0.17866896947891775,"[0, 0, 1, 1, 1, 0, 1, 1, 1, 1]"
2451,1,1,2,0.520526110736347,"[0, 1, 0, 0, 0, 1, 0, 1, 1, 0]"
2452,2,2,4,0.0942276707795453,"[1, 1, 0, 0, 0, 1, 0, 0, 1, 0]"
2453,1,1,2,0.770689092810868,"[1, 1, 0, 1, 1, 0, 1, 0, 1, 0]"
2454,12,12,24,0.03751982415070709,"[1, 0, 1, 0, 0, 1, 1, 1, 1, 0]"
2455,1,1,2,0.09590386879915935,"[0, 1, 1, 0, 0, 0, 0, 1, 1, 1]"
2456,2,2,4,0.5117936543208855,"[1, 1, 0, 0, 0, 0, 0, 1, 0, 1]"
2457,8,8,16,0.8519258826822002,"[1, 0, 1, 0, 1, 0, 0, 1, 1, 1]"
2458,1,1,2,0.6533558116868957,"[0, 0, 0, 0, 1, 0, 1, 0, 0, 1]"
2459,1,1,2,0.1767069644179361,"[0, 1, 1, 0, 0, 0, 0, 1, 0, 1]"
2460,1,1,2,0.39424266037961786,"[1, 0, 0, 0, 1, 0, 1, 0, 0, 0]"
2461,2,2,4,0.6687475555801328,"[0, 0, 0, 1, 1, 0, 0, 0, 1, 0]"
2462,3,3,6,0.45740379566811096,"[0, 1, 0, 1, 1, 1, 1, 1, 1, 0]"
2463,3,3,6,0.33770132674329867,"[1, 1, 0, 1, 0, 0, 1, 0, 0, 1]"
2464,2,2,4,0.599573424552431,"[1, 0, 0, 0, 1, 0, 1, 1, 0, 1]"
2465,1,1,2,0.12473622949318863,"[0, 0, 1, 1, 1, 1, 0, 0, 0, 1]"
2466,6,6,12,0.711167125796555,"[1, 0, 1, 0, 1, 1, 0, 1, 1, 0]"
2467,1,1,2,0.7125771479932637,"[0, 0, 1, 1, 0, 0, 0, 0, 0, 1]"
2468,1,1,2,0.6497933529556563,"[1, 0, 0, 0, 0, 0, 1, 1, 1, 1]"
2469,4,4,8,0.6794116176816899,"[0, 1, 0, 1, 1, 0, 0, 0, 1, 1]"
2470,2,2,4,0.7577107459721543,"[0, 1, 0, 0, 1, 0, 0, 1, 1, 0]"
2471,2,2,4,0.027907394491378912,"[1, 1, 0, 0, 0, 1, 0, 0, 1, 0]"
2472,1,1,2,0.464835066324397,"[1, 0, 0, 1, 0, 1, 0, 0, 1, 1]"
2473,3,3,6,0.07677355480591419,"[0, 1, 0, 0, 0, 1, 0, 0, 1, 0]"
2474,1,1,2,0.01639418885975763,"[0, 0, 0, 1, 0, 1, 1, 0, 1, 1]"
2475,2,2,4,0.09955338263596203,"[1, 1, 0, 0, 1, 1, 1, 1, 0, 0]"
2476,2,2,4,0.7525166781259728,"[0, 0, 0, 1, 1, 1, 1, 1, 0, 1]"
2477,2,2,4,0.12318353626506551,"[0, 1, 0, 1, 0, 1, 1, 0, 1, 1]"
2478,1,1,2,0.5179923556978439,"[0, 0, 0, 1, 1, 0, 1, 1, 0, 0]"
2479,2,2,4,0.57387630361594,"[0, 1, 0, 1, 1, 0, 0, 1, 0, 0]"
2480,2,2,4,0.4547275167039322,"[1, 0, 1, 1, 1, 1, 1, 0, 1, 0]"
2481,7,7,14,0.8853532539926846,"[1, 1, 1, 0, 1, 0, 1, 1, 0, 0]"
2482,4,4,8,0.5142631862909727,"[0, 1, 1, 1, 0, 0, 0, 1, 1, 0]"
2483,1,1,2,0.6080657304515835,"[1, 1, 0, 0, 1, 1, 0, 1, 1, 0]"
2484,5,5,10,0.8276561692478639,"[1, 0, 1, 0, 0, 1, 1, 1, 0, 0]"
2485,4,4,8,0.9258427376130851,"[0, 1, 0, 1, 1, 0, 0, 0, 0, 1]"
2486,2,2,4,0.47963996445724133,"[0, 0, 1, 1, 0, 1, 1, 1, 1, 0]"
2487,3,3,6,0.9153284545642772,"[0, 1, 0, 1, 1, 0, 1, 0, 0, 0]"
2488,2,2,4,0.8893628617785488,"[0, 0, 0, 0, 0, 0, 1, 1, 0, 0]"
2489,3,3,6,0.25243800973426833,"[0, 0, 0, 1, 0, 0, 1, 0, 1, 1]"
2490,13,13,26,0.7310264598395714,"[1, 0, 1, 1, 1, 1, 1, 0, 0, 1]"
2491,1,1,2,0.9600528108426987,"[0, 0, 1, 0, 0, 1, 0, 1, 0, 1]"
2492,1,1,2,0.31146021768590615,"[1, 0, 1, 1, 0, 0, 0, 0, 0, 0]"
2493,1,1,2,0.4044433472140806,"[0, 1, 0, 1, 1, 1, 1, 0, 1, 1]"
2494,2,2,4,0.41069255674539984,"[1, 0, 1, 0, 0, 0, 0, 1, 1, 0]"
2495,7,7,14,0.19807768444734164,"[1, 0, 1, 1, 1, 0, 0, 0, 0, 1]"
2496,5,5,10,0.7754608770278566,"[1, 0, 0, 0, 1, 1, 1, 1, 0, 1]"
2497,5,5,10,0.42903720908695964,"[0, 0, 1, 0, 0, 0, 1, 0, 1, 1]"
2498,5,5,10,0.9742167946897576,"[1, 1, 1, 0, 1, 0, 1, 1, 0, 1]"
2499,1,1,2,0.06128180000225658,"[1, 0, 1, 0, 0, 0, 1, 1, 0, 0]"
2500,4,4,8,0.22167785520735073,"[0, 1, 0, 0, 0, 0, 1, 0, 1, 0]"
2501,1,1,2,0.5228933364590692,"[1, 0, 1, 1, 0, 1, 1, 0, 0, 1]"
2502,1,1,2,0.9240560053226345,"[0, 0, 1, 0, 1, 1, 0, 0, 0, 1]"
2503,1,1,2,0.2686899226330898,"[1, 0, 0, 1, 1, 1, 0, 0, 1, 0]"
2504,1,1,2,0.515211378604312,"[1, 0, 1, 1, 0, 1, 1, 0, 0, 0]"
2505,2,2,4,0.06057243783864252,"[0, 1, 1, 1, 1, 0, 0, 0, 0, 0]"
2506,5,5,10,0.49619404532933375,"[1, 0, 1, 1, 1, 1, 0, 1, 1, 0]"
2507,2,2,4,0.7991248544744666,"[1, 0, 1, 1, 0, 1, 0, 0, 0, 1]"
2508,1,1,2,0.5601764773159484,"[0, 0, 1, 1, 1, 0, 1, 0, 0, 0]"
2509,1,1,2,0.01520802861602033,"[0, 0, 1, 1, 1, 1, 0, 1, 1, 0]"
2510,1,1,2,0.40140268169772053,"[0, 1, 0, 0, 1, 0, 0, 0, 0, 1]"
2511,1,1,2,0.5022706213173458,"[1, 1, 0, 1, 1, 1, 0, 1, 0, 1]"
2512,2,2,4,0.7548047647136618,"[0, 0, 1, 0, 0, 1, 0, 0, 0, 1]"
2513,1,1,2,0.8039449929946592,"[1, 1, 1, 1, 0, 0, 0, 0, 0, 0]"
2514,1,1,2,0.6430850311750795,"[0, 0, 0, 1, 1, 0, 1, 0, 0, 0]"
2515,6,6,12,0.8132623262901952,"[1, 1, 1, 1, 0, 1, 1, 1, 1, 0]"
2516,1,1,2,0.26851085006714903,"[0, 0, 1, 0, 0, 1, 1, 0, 1, 1]"
2517,1,1,2,0.8674856230630482,"[1, 0, 1, 0, 1, 1, 1, 0, 0, 0]"
2518,5,5,10,0.8037090336912911,"[1, 1, 0, 0, 1, 0, 1, 1, 1, 0]"
2519,1,1,2,0.40263727670933946,"[1, 1, 0, 0, 0, 1, 0, 1, 0, 0]"
2520,2,2,4,0.754254632992708,"[1, 1, 1, 1, 0, 1, 0, 0, 1, 1]"
2521,1,1,2,0.13477177364032755,"[0, 0, 0, 0, 1, 0, 0, 1, 0, 0]"
2522,3,3,6,0.9650174568635562,"[1, 1, 0, 0, 0, 0, 1, 0, 1, 1]"
2523,2,2,4,0.26473703447786734,"[0, 0, 0, 1, 1, 1, 1, 0, 1, 1]"
2524,1,1,2,0.7909043488981512,"[1, 0, 0, 1, 0, 1, 0, 0, 1, 0]"
2525,7,7,14,0.6066784879383278,"[0, 1, 1, 0, 1, 1, 0, 0, 1, 1]"
2526,3,3,6,0.21782006879784643,"[1, 1, 1, 1, 0, 1, 0, 0, 1, 0]"
2527,1,1,2,0.5861400805903288,"[1, 0, 0, 1, 1, 0, 1, 1, 0, 1]"
2528,5,5,10,0.35766278794422235,"[1, 0, 0, 1, 0, 1, 1, 1, 1, 0]"
2529,7,7,14,0.39015029718692906,"[1, 0, 1, 0, 0, 0, 1, 1, 0, 0]"
2530,4,4,8,0.5450816695932329,"[0, 1, 0, 0, 1, 0, 0, 1, 0, 1]"
2531,3,3,6,0.8277916347042691,"[1, 0, 1, 0, 1, 1, 1, 0, 0, 1]"
2532,1,1,2,0.631485027344606,"[0, 0, 0, 0, 1, 1, 1, 0, 0, 0]"
2533,5,5,10,0.013436289354356923,"[1, 0, 1, 1, 1, 1, 0, 1, 0, 0]"
2534,1,1,2,0.027307270832496844,"[0, 0, 1, 0, 0, 1, 1, 1, 1, 1]"
2535,1,1,2,0.5818842059790305,"[0, 1, 0, 1, 0, 1, 1, 1, 1, 0]"
2536,4,4,8,0.41009428290273253,"[0, 1, 0, 0, 1, 0, 0, 0, 1, 1]"
2537,4,4,8,0.44749426609255694,"[1, 0, 1, 1, 0, 0, 0, 0, 1, 1]"
2538,2,2,4,0.8037824062993376,"[1, 1, 0, 0, 1, 1, 1, 0, 1, 1]"
2539,7,7,14,0.8341022023864796,"[1, 0, 1, 1, 0, 0, 1, 1, 0, 1]"
2540,1,1,2,0.8993776608163958,"[0, 0, 0, 0, 0, 1, 1, 0, 1, 0]"
2541,1,1,2,0.028045189155474715,"[1, 1, 1, 0, 1, 1, 0, 0, 1, 1]"
2542,1,1,2,0.8349564889736798,"[0, 0, 1, 0, 1, 1, 1, 0, 1, 0]"
2543,3,3,6,0.35334771339037374,"[0, 0, 0, 0, 0, 0, 1, 1, 1, 0]"
2544,2,2,4,0.36662620310072613,"[0, 1, 1, 0, 0, 0, 1, 1, 0, 0]"
2545,1,1,2,0.7897722972438974,"[1, 1, 1, 0, 0, 0, 0, 0, 0, 0]"
2546,3,3,6,0.02016544960245248,"[0, 0, 0, 1, 0, 0, 1, 0, 0, 1]"
2547,2,2,4,0.03755614595172163,"[1, 1, 0, 1, 1, 0, 1, 0, 0, 0]"
2548,4,4,8,0.6676866579180017,"[1, 1, 0, 1, 0, 0, 1, 0, 0, 0]"
2549,1,1,2,0.4033608858161116,"[0, 0, 0, 0, 1, 0, 1, 1, 1, 0]"
2550,3,3,6,0.17086719033734954,"[0, 1, 0, 1, 0, 1, 1, 1, 1, 0]"
2551,2,2,4,0.6953211507672935,"[1, 0, 0, 0, 0, 1, 0, 1, 1, 0]"
2552,2,2,4,0.2304316693087758,"[1, 1, 0, 0, 0, 1, 1, 1, 1, 1]"
2553,6,6,12,0.7482463653646978,"[0, 0, 0, 1, 1, 1, 1, 0, 0, 0]"
2554,1,1,2,0.46966494146320237,"[0, 1, 0, 0, 1, 0, 0, 1, 1, 0]"
2555,5,5,10,0.6517196721781735,"[1, 1, 1, 1, 1, 0, 1, 1, 0, 1]"
2556,2,2,4,0.5544927400152895,"[1, 0, 0, 0, 0, 0, 0, 1, 0, 0]"
2557,1,1,2,0.8467149208999718,"[1, 0, 1, 0, 0, 0, 0, 0, 1, 1]"
2558,2,2,4,0.04000294455259734,"[0, 1, 0, 1, 0, 0, 0, 0, 1, 1]"
2559,1,1,2,0.35284398570777653,"[0, 0, 0, 1, 0, 0, 1, 0, 1, 0]"
2560,1,1,2,0.26444838693689154,"[0, 1, 0, 0, 0, 0, 1, 0, 1, 1]"
2561,1,1,2,0.03137213582857834,"[0, 0, 1, 0, 1, 0, 1, 1, 0, 0]"
2562,4,4,8,0.40745795718790756,"[0, 1, 1, 1, 0, 0, 1, 1, 1, 0]"
2563,2,2,4,0.22890084033625568,"[0, 1, 0, 0, 1, 1, 1, 1, 0, 1]"
2564,2,2,4,0.2409640799092001,"[0, 1, 1, 0, 0, 0, 1, 0, 1, 0]"
2565,1,1,2,0.5754553702670225,"[1, 0, 1, 1, 1, 1, 0, 0, 1, 0]"
2566,1,1,2,0.10605355193775623,"[0, 0, 1, 0, 0, 1, 0, 1, 1, 0]"
2567,2,2,4,0.022809497236392695,"[1, 0, 0, 0, 1, 0, 0, 1, 1, 1]"
2568,1,1,2,0.4513680319787201,"[1, 1, 0, 0, 1, 1, 0, 0, 1, 1]"
2569,4,4,8,0.8972685273723898,"[0, 1, 1, 0, 1, 0, 0, 0, 0, 1]"
2570,1,1,2,0.48423372492251426,"[0, 1, 0, 1, 1, 0, 1, 1, 0, 1]"
2571,1,1,2,0.5150246105956782,"[0, 1, 1, 1, 1, 1, 1, 0, 0, 0]"
2572,1,1,2,0.25410483186415944,"[1, 1, 1, 0, 0, 1, 1, 0, 1, 1]"
2573,2,2,4,0.19685244646991729,"[0, 0, 0, 0, 0, 0, 0, 1, 1, 1]"
2574,1,1,2,0.17681205066308636,"[0, 1, 0, 0, 0, 0, 0, 1, 1, 0]"
2575,5,5,10,0.7123433167914263,"[1, 1, 1, 1, 1, 1, 1, 1, 1, 1]"
2576,2,2,4,0.5985553524400561,"[1, 0, 0, 1, 0, 0, 1, 0, 0, 0]"
2577,4,4,8,0.6636687256176452,"[0, 1, 0, 1, 1, 1, 1, 1, 1, 1]"
2578,3,3,6,0.8347176705439736,"[1, 1, 0, 0, 1, 1, 0, 0, 1, 0]"
2579,2,2,4,0.4909978735717567,"[0, 1, 1, 1, 1, 0, 0, 0, 0, 0]"
2580,1,1,2,0.15406175428112479,"[1, 1, 0, 0, 1, 1, 1, 1, 1, 0]"
2581,1,1,2,0.12116704049441329,"[0, 1, 0, 0, 0, 1, 0, 1, 1, 1]"
2582,2,2,4,0.34178802544725184,"[0, 1, 1, 0, 0, 0, 1, 0, 0, 1]"
2583,2,2,4,0.10248948410266723,"[1, 0, 0, 0, 1, 1, 0, 0, 0, 1]"
2584,3,3,6,0.9751507377985824,"[0, 1, 1, 1, 0, 0, 0, 0, 1, 0]"
2585,1,1,2,0.9543374821514545,"[1, 1, 1, 0, 0, 0, 0, 0, 0, 0]"
2586,4,4,8,0.2184861678350698,"[1, 0, 1, 1, 1, 0, 1, 0, 0, 1]"
2587,2,2,4,0.34720290044750846,"[0, 0, 0, 0, 1, 1, 0, 0, 0, 1]"
2588,1,1,2,0.38880846081836085,"[1, 0, 1, 0, 1, 0, 0, 0, 1, 1]"
2589,1,1,2,0.8423236209561846,"[0, 0, 1, 0, 1, 0, 0, 0, 0, 1]"
2590,6,6,12,0.16405283341325239,"[1, 0, 1, 1, 0, 1, 0, 1, 0, 1]"
2591,1,1,2,0.45596285706335027,"[0, 0, 0, 1, 0, 1, 1, 0, 0, 1]"
2592,2,2,4,0.3118612728971387,"[0, 1, 1, 0, 0, 0, 1, 1, 0, 1]"
2593,1,1,2,0.37914307144166226,"[0, 0, 1, 1, 1, 0, 1, 1, 1, 0]"
2594,1,1,2,0.29557728539018113,"[0, 1, 1, 0, 1, 0, 1, 0, 1, 1]"
2595,1,1,2,0.042548909930446355,"[1, 1, 0, 1, 0, 1, 0, 0, 0, 0]"
2596,1,1,2,0.2462488155788951,"[1, 0, 1, 1, 0, 1, 0, 1, 0, 1]"
2597,7,7,14,0.18123169709092335,"[1, 1, 0, 0, 0, 0, 1, 1, 0, 0]"
2598,2,2,4,0.3593850390899278,"[0, 1, 0, 1, 1, 1, 0, 1, 1, 1]"
2599,5,5,10,0.5755665972198287,"[0, 0, 1, 1, 1, 1, 1, 1, 0, 1]"
2600,8,8,16,0.15222609894854522,"[1, 1, 1, 1, 0, 1, 0, 0, 1, 0]"
2601,2,2,4,0.9293502499269891,"[1, 0, 0, 0, 1, 1, 1, 0, 1, 0]"
2602,1,1,2,0.5263889155792153,"[1, 0, 0, 0, 0, 1, 0, 0, 0, 1]"
2603,2,2,4,0.6003801462829916,"[0, 0, 1, 1, 1, 0, 0, 1, 1, 1]"
2604,1,1,2,0.984702194296812,"[0, 0, 0, 0, 1, 1, 1, 1, 0, 1]"
2605,2,2,4,0.9832682395956257,"[0, 1, 0, 1, 1, 0, 1, 1, 0, 1]"
2606,1,1,2,0.8828935521131357,"[0, 0, 0, 0, 1, 1, 0, 1, 1, 1]"
2607,1,1,2,0.6667812895599321,"[0, 0, 1, 0, 0, 1, 1, 0, 1, 0]"
2608,1,1,2,0.6071688251372013,"[1, 0, 1, 0, 1, 1, 1, 0, 0, 0]"
2609,1,1,2,0.5140724059755599,"[1, 0, 0, 0, 1, 1, 1, 0, 0, 0]"
2610,2,2,4,0.9525598604764817,"[0, 0, 1, 1, 1, 0, 0, 1, 0, 1]"
2611,20,20,40,0.9708538102328718,"[1, 1, 1, 1, 1, 1, 0, 1, 0, 0]"
2612,1,1,2,0.6965060974031667,"[0, 1, 1, 0, 0, 1, 0, 1, 1, 0]"
2613,3,3,6,0.4637702355914948,"[0, 1, 0, 0, 1, 0, 1, 0, 0, 0]"
2614,1,1,2,0.693981970881071,"[0, 1, 1, 0, 0, 0, 0, 0, 0, 1]"
2615,1,1,2,0.28179685955765577,"[1, 0, 1, 1, 0, 1, 0, 0, 1, 0]"
2616,1,1,2,0.782815767473081,"[1, 1, 0, 0, 1, 0, 0, 0, 0, 0]"
2617,5,5,10,0.22099867443182164,"[1, 1, 0, 1, 1, 1, 0, 0, 1, 0]"
2618,4,4,8,0.9969474565749178,"[0, 1, 1, 1, 1, 1, 0, 0, 1, 1]"
2619,7,7,14,0.9653068716845218,"[0, 1, 1, 1, 1, 1, 1, 0, 0, 0]"
2620,2,2,4,0.37442237594549876,"[1, 1, 0, 1, 0, 0, 1, 0, 1, 0]"
2621,5,5,10,0.8504331264201325,"[1, 0, 1, 0, 1, 1, 1, 1, 1, 0]"
2622,2,2,4,0.8451085642139966,"[0, 1, 0, 0, 0, 1, 0, 1, 0, 1]"
2623,1,1,2,0.7661393644026352,"[0, 0, 1, 1, 1, 0, 1, 0, 0, 1]"
2624,1,1,2,0.8984140266834078,"[1, 0, 1, 1, 0, 1, 0, 0, 0, 0]"
2625,2,2,4,0.42055891010139346,"[0, 1, 1, 1, 1, 0, 1, 0, 1, 0]"
2626,1,1,2,0.015902764075422793,"[0, 1, 0, 0, 1, 0, 0, 0, 0, 0]"
2627,2,2,4,0.14343688038773383,"[1, 0, 0, 1, 1, 0, 0, 1, 0, 0]"
2628,1,1,2,0.9675568456048875,"[1, 1, 1, 0, 0, 0, 1, 1, 0, 1]"
2629,11,11,22,0.8975917284934309,"[0, 0, 0, 0, 1, 1, 1, 1, 0, 1]"
2630,1,1,2,0.48014661970035355,"[0, 1, 0, 0, 1, 0, 1, 1, 0, 0]"
2631,5,5,10,0.6473950863060548,"[1, 1, 0, 0, 1, 0, 1, 0, 1, 0]"
2632,1,1,2,0.29144326080096405,"[1, 0, 1, 0, 0, 0, 0, 1, 1, 0]"
2633,1,1,2,0.29179837071321224,"[0, 0, 1, 0, 1, 0, 0, 0, 0, 0]"
2634,7,7,14,0.5539424763903019,"[0, 0, 1, 1, 1, 1, 0, 1, 0, 1]"
2635,5,5,10,0.4895121432696682,"[0, 1, 0, 0, 0, 1, 0, 1, 1, 1]"
2636,8,8,16,0.012036347626415145,"[1, 0, 1, 1, 0, 0, 0, 1, 1, 0]"
2637,1,1,2,0.6050973984832732,"[0, 0, 0, 0, 1, 0, 0, 0, 1, 0]"
2638,6,6,12,0.30143455263920194,"[1, 0, 1, 1, 1, 1, 1, 1, 0, 1]"
2639,1,1,2,0.9521610436134664,"[0, 0, 1, 1, 0, 0, 1, 1, 1, 0]"
2640,1,1,2,0.39753055689375294,"[0, 1, 1, 1, 1, 0, 1, 0, 1, 0]"
2641,3,3,6,0.7091448450895689,"[0, 1, 0, 0, 0, 1, 1, 1, 0, 1]"
2642,2,2,4,0.5542336079360223,"[1, 0, 1, 1, 0, 1, 1, 1, 0, 0]"
2643,3,3,6,0.6408931068561253,"[0, 1, 0, 1, 0, 0, 1, 0, 0, 0]"
2644,1,1,2,0.41473371063542575,"[1, 1, 1, 0, 0, 0, 1, 0, 0, 0]"
2645,2,2,4,0.882503145374718,"[1, 1, 1, 1, 1, 1, 1, 1, 0, 0]"
2646,12,12,24,0.9680145303165977,"[1, 0, 1, 1, 1, 0, 0, 1, 1, 0]"
2647,1,1,2,0.7711298524047145,"[0, 1, 1, 1, 1, 0, 0, 1, 1, 0]"
2648,4,4,8,0.6981728298455495,"[1, 1, 0, 0, 1, 0, 1, 1, 0, 1]"
2649,5,5,10,0.8085647336011939,"[0, 1, 1, 1, 1, 0, 1, 1, 1, 0]"
2650,9,9,18,0.08542119599872655,"[1, 1, 1, 0, 1, 0, 1, 1, 0, 1]"
2651,1,1,2,0.007904541945674581,"[0, 1, 0, 0, 0, 1, 0, 0, 0, 1]"
2652,2,2,4,0.8467732611155835,"[1, 1, 0, 1, 1, 0, 0, 0, 0, 1]"
2653,3,3,6,0.2081816368390106,"[1, 1, 1, 0, 0, 0, 1, 1, 0, 0]"
2654,10,10,20,0.8447328044302982,"[1, 1, 1, 0, 0, 1, 0, 1, 0, 0]"
2655,4,4,8,0.12493622405341476,"[1, 1, 1, 1, 1, 0, 1, 1, 0, 0]"
2656,1,1,2,0.015375954849855433,"[1, 0, 1, 0, 1, 1, 1, 0, 1, 0]"
2657,2,2,4,0.7689807946835585,"[0, 1, 0, 0, 0, 1, 0, 1, 1, 0]"
2658,12,12,24,0.23753586584228226,"[0, 1, 1, 1, 1, 0, 1, 0, 0, 1]"
2659,2,2,4,0.04558350177764414,"[0, 0, 0, 1, 0, 1, 0, 1, 1, 1]"
2660,1,1,2,0.4044783338917626,"[1, 0, 1, 1, 1, 1, 1, 1, 1, 0]"
2661,1,1,2,0.8936405946116379,"[1, 0, 0, 0, 1, 0, 0, 0, 0, 1]"
2662,1,1,2,0.4771659690419684,"[1, 1, 1, 1, 0, 0, 1, 0, 1, 1]"
2663,1,1,2,0.7504950877521609,"[0, 0, 0, 0, 1, 1, 0, 1, 1, 0]"
2664,1,1,2,0.3403090251281182,"[1, 0, 0, 1, 0, 1, 1, 1, 1, 0]"
2665,2,2,4,0.5240070556994059,"[0, 1, 0, 0, 0, 1, 1, 1, 0, 0]"
2666,8,8,16,0.9221352226111399,"[1, 1, 1, 1, 0, 1, 1, 1, 0, 0]"
2667,1,1,2,0.3968677473651242,"[1, 1, 0, 0, 1, 1, 0, 1, 0, 0]"
2668,2,2,4,0.6815440167573338,"[1, 0, 1, 0, 0, 0, 0, 0, 1, 0]"
2669,3,3,6,0.5442745709672104,"[1, 0, 0, 1, 0, 0, 0, 1, 1, 1]"
2670,5,5,10,0.10283462213102934,"[1, 0, 0, 1, 1, 0, 0, 1, 0, 1]"
2671,4,4,8,0.7594555353706748,"[0, 1, 0, 1, 1, 1, 1, 1, 0, 0]"
2672,1,1,2,0.8529779921397931,"[0, 0, 0, 0, 1, 0, 0, 1, 1, 0]"
2673,1,1,2,0.4195281138378232,"[0, 0, 1, 1, 1, 1, 1, 0, 1, 0]"
2674,4,4,8,0.21717814799578328,"[0, 1, 1, 1, 0, 0, 0, 1, 1, 0]"
2675,2,2,4,0.9806554625486806,"[0, 0, 0, 0, 0, 1, 0, 0, 1, 1]"
2676,2,2,4,0.2884397686701544,"[0, 0, 0, 0, 1, 1, 0, 0, 0, 0]"
2677,2,2,4,0.951065640277515,"[1, 0, 1, 0, 1, 1, 1, 1, 1, 0]"
2678,3,3,6,0.8575679738624536,"[0, 1, 0, 0, 1, 1, 0, 0, 1, 0]"
2679,1,1,2,0.0015768587657998268,"[0, 1, 1, 1, 1, 1, 1, 0, 1, 0]"
2680,4,4,8,0.46391702627854325,"[1, 1, 1, 1, 0, 1, 0, 0, 0, 1]"
2681,4,4,8,0.8658539698122808,"[0, 0, 1, 0, 0, 0, 1, 1, 1, 1]"
2682,3,3,6,0.1895558339112453,"[0, 1, 0, 1, 1, 0, 0, 1, 1, 1]"
2683,4,4,8,0.7807996524522416,"[0, 1, 1, 1, 1, 0, 0, 1, 0, 1]"
2684,1,1,2,0.7361106450319531,"[0, 0, 0, 0, 0, 1, 1, 0, 0, 1]"
2685,1,1,2,0.6224876345754914,"[1, 1, 0, 1, 1, 1, 1, 1, 0, 1]"
2686,5,5,10,0.8200602808674555,"[1, 1, 0, 1, 0, 0, 1, 1, 1, 1]"
2687,1,1,2,0.637033757043874,"[1, 0, 1, 1, 0, 1, 1, 0, 1, 0]"
2688,2,2,4,0.040623461050254384,"[1, 1, 1, 1, 0, 1, 0, 1, 1, 1]"
2689,3,3,6,0.6338666285499125,"[1, 0, 1, 1, 1, 0, 0, 0, 0, 0]"
2690,1,1,2,0.34959821315169093,"[0, 0, 1, 1, 1, 1, 0, 0, 1, 1]"
2691,1,1,2,0.11625647869563838,"[1, 0, 1, 0, 0, 0, 0, 1, 1, 1]"
2692,1,1,2,0.970620966242374,"[1, 0, 0, 0, 1, 0, 0, 1, 1, 0]"
2693,1,1,2,0.6007658538121337,"[0, 0, 0, 0, 1, 0, 0, 0, 1, 1]"
2694,4,4,8,0.6687643584631708,"[1, 0, 0, 0, 0, 1, 1, 0, 1, 1]"
2695,2,2,4,0.6921935892030172,"[1, 1, 0, 1, 1, 1, 1, 0, 1, 1]"
2696,1,1,2,0.8980979348656302,"[1, 0, 0, 0, 0, 0, 0, 0, 1, 0]"
2697,1,1,2,0.8824072280479369,"[0, 1, 0, 1, 1, 0, 0, 1, 0, 0]"
2698,2,2,4,0.9023681290269958,"[1, 0, 0, 0, 0, 0, 1, 0, 0, 0]"
2699,2,2,4,0.6272901310440965,"[1, 0, 0, 1, 0, 1, 0, 0, 0, 0]"
2700,2,2,4,0.990767983118325,"[0, 0, 1, 1, 1, 0, 0, 0, 0, 0]"
2701,1,1,2,0.44226332232150467,"[1, 1, 1, 0, 0, 0, 1, 0, 0, 1]"
2702,2,2,4,0.07333330533106619,"[0, 0, 0, 1, 1, 0, 0, 1, 1, 1]"
2703,1,1,2,0.5731097769907247,"[1, 0, 0, 1, 1, 1, 0, 0, 0, 0]"
2704,3,3,6,0.08139272090858174,"[1, 1, 1, 1, 0, 1, 0, 1, 0, 1]"
2705,1,1,2,0.6237275610705469,"[1, 1, 0, 0, 0, 0, 1, 1, 1, 0]"
2706,1,1,2,0.00393729716477309,"[1, 0, 1, 1, 1, 1, 0, 1, 0, 1]"
2707,1,1,2,0.8846702476362104,"[0, 0, 0, 1, 0, 1, 0, 0, 1, 0]"
2708,1,1,2,0.9552901607049233,"[1, 1, 0, 0, 0, 0, 0, 0, 1, 0]"
2709,4,4,8,0.9747147555104112,"[1, 1, 0, 0, 0, 1, 1, 1, 0, 0]"
2710,1,1,2,0.8926175344073455,"[0, 1, 0, 1, 0, 0, 1, 0, 0, 1]"
2711,2,2,4,0.46179549496356787,"[1, 0, 0, 1, 0, 0, 1, 0, 0, 1]"
2712,3,3,6,0.3452632326464019,"[1, 1, 0, 1, 1, 0, 0, 1, 0, 1]"
2713,2,2,4,0.003076450476978021,"[0, 1, 1, 1, 1, 0, 0, 1, 1, 0]"
2714,2,2,4,0.8153225835980635,"[1, 0, 1, 1, 0, 0, 1, 0, 0, 1]"
2715,4,4,8,0.7856147816211505,"[0, 0, 1, 0, 1, 1, 1, 1, 1, 1]"
2716,3,3,6,0.49522247236157224,"[1, 0, 1, 1, 0, 0, 0, 1, 1, 0]"
2717,1,1,2,0.03346922811552788,"[0, 0, 0, 1, 1, 0, 0, 0, 1, 1]"
2718,1,1,2,0.6569237577343606,"[0, 0, 1, 0, 0, 0, 0, 1, 0, 1]"
2719,1,1,2,0.8058999915326875,"[0, 0, 0, 0, 0, 1, 0, 0, 1, 0]"
2720,2,2,4,0.23506865987751513,"[0, 1, 0, 1, 0, 0, 0, 0, 1, 1]"
2721,3,3,6,0.0869337313922004,"[0, 1, 1, 1, 0, 0, 0, 1, 1, 1]"
2722,2,2,4,0.31212139781165305,"[0, 0, 0, 0, 0, 1, 0, 0, 1, 0]"
2723,1,1,2,0.38585354592399557,"[1, 0, 1, 1, 1, 0, 0, 0, 0, 1]"
2724,1,1,2,0.5331614456050596,"[1, 1, 0, 1, 0, 1, 0, 1, 1, 1]"
2725,2,2,4,0.4456654448903007,"[1, 0, 1, 1, 1, 0, 1, 1, 1, 0]"
2726,1,1,2,0.3682738758667543,"[1, 1, 0, 0, 1, 1, 0, 1, 1, 0]"
2727,1,1,2,0.40853295608884066,"[0, 0, 0, 0, 0, 0, 1, 0, 0, 1]"
2728,4,4,8,0.6464678394967062,"[1, 0, 1, 1, 1, 0, 1, 0, 0, 0]"
2729,1,1,2,0.22599017048505388,"[1, 1, 0, 0, 0, 0, 0, 0, 0, 1]"
2730,2,2,4,0.9841954918885351,"[1, 1, 0, 1, 1, 1, 0, 0, 1, 1]"
2731,1,1,2,0.15814693247130385,"[1, 0, 1, 0, 1, 0, 1, 0, 0, 0]"
2732,3,3,6,0.03047031975887249,"[1, 0, 1, 1, 1, 1, 1, 0, 1, 0]"
2733,2,2,4,0.24185220342354974,"[1, 1, 1, 1, 1, 1, 0, 0, 0, 0]"
2734,2,2,4,0.16172594723193567,"[0, 0, 0, 0, 0, 1, 1, 0, 0, 1]"
2735,1,1,2,0.2429908050593238,"[0, 0, 0, 0, 0, 0, 1, 1, 1, 0]"
2736,1,1,2,0.03957020077742346,"[0, 1, 0, 0, 1, 0, 1, 0, 1, 0]"
2737,3,3,6,0.36783955173890137,"[1, 0, 1, 0, 1, 0, 1, 0, 0, 0]"
2738,1,1,2,0.19790639048056413,"[0, 1, 0, 0, 1, 0, 1, 0, 0, 0]"
2739,3,3,6,0.1679181294509534,"[0, 1, 0, 1, 0, 1, 1, 0, 1, 1]"
2740,3,3,6,0.4626564386526272,"[0, 0, 1, 1, 1, 0, 0, 1, 1, 0]"
2741,6,6,12,0.9246189442436329,"[1, 1, 1, 0, 1, 0, 0, 1, 0, 1]"
2742,1,1,2,0.20415393053262942,"[0, 1, 0, 1, 0, 1, 1, 1, 0, 0]"
2743,4,4,8,0.018249997298613208,"[0, 1, 0, 0, 1, 1, 1, 1, 1, 1]"
2744,1,1,2,0.8781319420782642,"[0, 0, 0, 0, 0, 1, 1, 0, 0, 1]"
2745,1,1,2,0.13480143210720819,"[1, 1, 1, 0, 1, 0, 1, 1, 0, 0]"
2746,1,1,2,0.6213967011619891,"[1, 1, 1, 0, 1, 1, 1, 0, 1, 0]"
2747,2,2,4,0.09882637291692098,"[0, 0, 0, 1, 1, 1, 1, 1, 0, 0]"
2748,9,9,18,0.4726483678974469,"[0, 0, 1, 1, 0, 0, 1, 1, 0, 1]"
2749,6,6,12,0.06408234059153417,"[0, 0, 1, 1, 1, 0, 0, 1, 0, 0]"
2750,3,3,6,0.9503319253939838,"[0, 1, 1, 1, 0, 0, 1, 0, 0, 0]"
2751,2,2,4,0.8336907073568517,"[1, 1, 0, 0, 0, 0, 1, 0, 0, 0]"
2752,2,2,4,0.13883950024506886,"[1, 1, 0, 1, 0, 0, 1, 1, 0, 1]"
2753,5,5,10,0.35262608237990645,"[1, 0, 1, 0, 0, 1, 0, 0, 1, 0]"
2754,2,2,4,0.727332931915723,"[1, 1, 1, 0, 0, 1, 0, 1, 1, 1]"
2755,8,8,16,0.6278391904751527,"[1, 0, 1, 0, 0, 0, 0, 0, 1, 1]"
2756,13,13,26,0.06395908659976113,"[1, 1, 1, 1, 0, 0, 0, 1, 1, 1]"
2757,2,2,4,0.8184353066582648,"[0, 0, 0, 0, 0, 0, 1, 0, 1, 0]"
2758,2,2,4,0.01371686137171546,"[0, 1, 0, 0, 1, 0, 1, 0, 1, 0]"
2759,1,1,2,0.6768392979997534,"[1, 1, 0, 1, 0, 1, 1, 1, 1, 0]"
2760,4,4,8,0.394837419940294,"[1, 1, 1, 1, 0, 1, 0, 1, 1, 1]"
2761,4,4,8,0.8380877230105045,"[1, 1, 1, 1, 0, 0, 1, 1, 0, 0]"
2762,2,2,4,0.36326933336451106,"[1, 0, 1, 0, 0, 1, 1, 0, 1, 1]"
2763,15,15,30,0.25729707354226283,"[1, 1, 0, 1, 1, 1, 0, 1, 1, 1]"
2764,2,2,4,0.2593976663588513,"[1, 1, 0, 0, 1, 0, 0, 0, 1, 1]"
2765,2,2,4,0.341337364204243,"[0, 1, 1, 0, 0, 0, 1, 1, 0, 0]"
2766,1,1,2,0.6998826795547135,"[0, 0, 1, 1, 0, 1, 0, 1, 1, 1]"
2767,2,2,4,0.7025206180841431,"[0, 1, 1, 0, 0, 0, 0, 0, 1, 1]"
2768,2,2,4,0.4648558539748968,"[1, 0, 1, 0, 0, 0, 1, 0, 1, 0]"
2769,4,4,8,0.8196668624748421,"[1, 0, 1, 0, 0, 1, 1, 0, 1, 1]"
2770,1,1,2,0.29203553519417424,"[1, 1, 0, 0, 1, 0, 1, 0, 0, 0]"
2771,2,2,4,0.4940835405096704,"[1, 0, 1, 1, 0, 0, 1, 0, 0, 0]"
2772,3,3,6,0.8314983548360144,"[0, 0, 0, 1, 0, 0, 1, 1, 1, 0]"
2773,3,3,6,0.08618211571085987,"[0, 0, 1, 0, 1, 1, 0, 1, 0, 0]"
2774,1,1,2,0.2563104808533986,"[0, 0, 1, 0, 0, 0, 1, 0, 1, 0]"
2775,1,1,2,0.03264054414886186,"[0, 0, 1, 0, 0, 0, 0, 1, 0, 0]"
2776,2,2,4,0.297068248998554,"[0, 0, 0, 0, 1, 1, 0, 1, 0, 1]"
2777,1,1,2,0.5462505594669753,"[0, 0, 1, 0, 1, 1, 0, 0, 1, 0]"
2778,1,1,2,0.8366919221391841,"[0, 0, 0, 1, 0, 1, 0, 0, 0, 0]"
2779,2,2,4,0.42487989281020033,"[1, 1, 1, 1, 0, 1, 0, 1, 0, 0]"
2780,1,1,2,0.4482961171074925,"[1, 0, 1, 1, 0, 0, 1, 0, 0, 1]"
2781,2,2,4,0.26726585232532685,"[0, 0, 0, 0, 0, 0, 1, 0, 0, 1]"
2782,1,1,2,0.6635055240102197,"[1, 0, 0, 1, 0, 0, 0, 0, 1, 1]"
2783,2,2,4,0.005676918483025428,"[0, 1, 1, 0, 1, 1, 1, 1, 0, 0]"
2784,1,1,2,0.6875340787794733,"[0, 1, 0, 1, 0, 1, 1, 1, 1, 0]"
2785,6,6,12,0.17640303554942804,"[1, 1, 1, 0, 1, 0, 0, 0, 0, 1]"
2786,7,7,14,0.8976317744596426,"[1, 1, 1, 0, 1, 0, 1, 0, 1, 0]"
2787,1,1,2,0.3962604672854375,"[1, 1, 0, 0, 1, 1, 1, 1, 1, 1]"
2788,2,2,4,0.0008161754617008743,"[1, 0, 1, 1, 0, 1, 0, 0, 1, 1]"
2789,2,2,4,0.14685750076819282,"[1, 0, 1, 0, 0, 0, 1, 0, 1, 0]"
2790,5,5,10,0.19093910327933716,"[1, 1, 0, 1, 1, 1, 0, 0, 1, 1]"
2791,3,3,6,0.8317072192332433,"[1, 1, 0, 1, 0, 0, 1, 0, 1, 1]"
2792,10,10,20,0.13408458422919423,"[1, 0, 0, 1, 0, 0, 1, 0, 1, 1]"
2793,3,3,6,0.6800155527616296,"[0, 0, 1, 0, 1, 1, 1, 1, 1, 1]"
2794,1,1,2,0.5067818747823182,"[1, 1, 1, 0, 0, 1, 0, 1, 0, 1]"
2795,1,1,2,0.8494928028541843,"[0, 0, 0, 0, 0, 1, 1, 0, 0, 1]"
2796,4,4,8,0.6268041151033338,"[1, 1, 1, 0, 1, 1, 1, 1, 0, 1]"
2797,3,3,6,0.5469731638210309,"[1, 1, 1, 1, 1, 0, 0, 0, 1, 1]"
2798,3,3,6,0.6424012356059474,"[1, 1, 1, 0, 1, 1, 1, 0, 1, 0]"
2799,1,1,2,0.4832440899148839,"[1, 0, 1, 0, 0, 1, 0, 0, 1, 0]"
2800,1,1,2,0.6341812995817019,"[0, 1, 0, 0, 0, 0, 0, 1, 0, 1]"
2801,4,4,8,0.03199223381049687,"[1, 0, 1, 1, 1, 1, 0, 0, 0, 1]"
2802,5,5,10,0.28332099998872695,"[0, 1, 1, 1, 0, 1, 1, 0, 0, 1]"
2803,5,5,10,0.32849346447014516,"[1, 0, 1, 1, 1, 0, 1, 1, 1, 0]"
2804,1,1,2,0.6346707807571449,"[1, 1, 0, 1, 0, 0, 1, 0, 0, 0]"
2805,1,1,2,0.531126071119762,"[1, 0, 1, 1, 0, 0, 0, 1, 1, 1]"
2806,1,1,2,0.8075339093156011,"[1, 1, 1, 0, 0, 0, 1, 0, 1, 1]"
2807,3,3,6,0.1593620765459446,"[0, 1, 0, 0, 1, 1, 0, 1, 1, 1]"
2808,7,7,14,0.18899205181138368,"[1, 1, 1, 0, 1, 0, 0, 1, 1, 0]"
2809,1,1,2,0.3409164741564762,"[1, 1, 0, 0, 0, 0, 1, 1, 0, 1]"
2810,1,1,2,0.4498552997267702,"[1, 0, 1, 0, 1, 1, 0, 1, 1, 0]"
2811,1,1,2,0.3059014680444627,"[0, 0, 0, 0, 0, 1, 0, 0, 0, 0]"
2812,2,2,4,0.8635551831991596,"[0, 1, 0, 1, 1, 0, 1, 1, 0, 1]"
2813,8,8,16,0.4539808375202159,"[0, 0, 0, 1, 1, 0, 1, 0, 0, 1]"
2814,4,4,8,0.9944582347041081,"[0, 1, 1, 1, 0, 1, 1, 1, 0, 1]"
2815,1,1,2,0.47187753610341865,"[0, 0, 1, 1, 1, 0, 0, 0, 0, 0]"
2816,2,2,4,0.26873246371337733,"[0, 0, 0, 1, 0, 0, 1, 1, 0, 0]"
2817,5,5,10,0.35254224385117916,"[0, 1, 0, 1, 1, 1, 1, 1, 1, 0]"
2818,1,1,2,0.08387077205933491,"[0, 0, 0, 0, 0, 0, 1, 1, 1, 1]"
2819,3,3,6,0.3411821801978038,"[0, 1, 1, 1, 1, 1, 0, 1, 0, 1]"
2820,1,1,2,0.44468022029390886,"[0, 1, 0, 0, 0, 1, 0, 0, 1, 1]"
2821,1,1,2,0.17134974092333322,"[1, 1, 0, 0, 0, 0, 1, 0, 0, 0]"
2822,1,1,2,0.7356963504806183,"[1, 1, 1, 0, 0, 1, 1, 1, 1, 1]"
2823,2,2,4,0.11956953230475831,"[1, 1, 1, 1, 1, 1, 1, 1, 1, 0]"
2824,1,1,2,0.09897009725553407,"[0, 0, 0, 0, 1, 0, 1, 1, 1, 1]"
2825,6,6,12,0.3451245401764944,"[0, 1, 1, 0, 1, 1, 0, 1, 1, 0]"
2826,2,2,4,0.7316259270701199,"[0, 1, 0, 1, 0, 1, 0, 1, 0, 0]"
2827,1,1,2,0.8850285900892461,"[0, 1, 1, 1, 1, 1, 1, 0, 0, 0]"
2828,2,2,4,0.9373380226774084,"[0, 0, 0, 0, 0, 0, 1, 1, 1, 1]"
2829,2,2,4,0.5537674172128972,"[1, 1, 0, 0, 1, 1, 0, 0, 0, 1]"
2830,1,1,2,0.9165863547460175,"[0, 0, 0, 0, 0, 1, 1, 1, 1, 0]"
2831,6,6,12,0.35883257800222546,"[0, 1, 1, 1, 1, 1, 0, 1, 1, 1]"
2832,1,1,2,0.07646907701611372,"[0, 1, 1, 0, 1, 0, 1, 0, 0, 1]"
2833,10,10,20,0.945522407123155,"[1, 0, 0, 1, 1, 1, 0, 1, 1, 1]"
2834,1,1,2,0.3336817808486454,"[0, 0, 1, 0, 1, 1, 1, 1, 0, 0]"
2835,2,2,4,0.6103969954064908,"[1, 0, 1, 1, 0, 1, 0, 0, 0, 0]"
2836,3,3,6,0.3342326789116993,"[0, 0, 1, 0, 1, 1, 1, 1, 0, 1]"
2837,1,1,2,0.4594129934862583,"[0, 1, 1, 1, 0, 1, 0, 0, 0, 1]"
2838,1,1,2,0.23606756879237045,"[1, 1, 0, 1, 0, 0, 0, 0, 1, 0]"
2839,1,1,2,0.14103984748044185,"[1, 0, 0, 0, 0, 1, 1, 1, 0, 1]"
2840,4,4,8,0.5349529879765587,"[0, 0, 1, 1, 0, 1, 1, 1, 1, 0]"
2841,1,1,2,0.11760243491466238,"[0, 1, 0, 0, 1, 0, 1, 1, 1, 0]"
2842,5,5,10,0.9075580364558148,"[1, 0, 1, 1, 0, 0, 1, 0, 0, 0]"
2843,1,1,2,0.15882747633457295,"[0, 0, 1, 1, 0, 0, 1, 0, 0, 0]"
2844,2,2,4,0.25895069478281363,"[1, 1, 1, 1, 0, 0, 1, 1, 1, 1]"
2845,1,1,2,0.36009043524994055,"[0, 0, 0, 0, 0, 0, 1, 0, 0, 0]"
2846,2,2,4,0.754214368679381,"[0, 0, 1, 1, 1, 0, 0, 0, 0, 1]"
2847,2,2,4,0.3834965035867698,"[0, 0, 0, 0, 0, 0, 1, 0, 0, 0]"
2848,2,2,4,0.5915937501984013,"[1, 1, 1, 1, 0, 0, 0, 1, 1, 1]"
2849,2,2,4,0.30147951647164783,"[1, 1, 0, 1, 1, 0, 1, 0, 1, 1]"
2850,1,1,2,0.6670466966009201,"[1, 0, 0, 0, 1, 0, 0, 0, 1, 1]"
2851,1,1,2,0.4307846591833576,"[1, 0, 0, 0, 1, 1, 0, 0, 0, 0]"
2852,3,3,6,0.23277277754991377,"[0, 1, 0, 0, 0, 0, 0, 1, 1, 1]"
2853,3,3,6,0.5621828123256728,"[1, 0, 1, 0, 1, 0, 1, 0, 1, 1]"
2854,1,1,2,0.9840134463058352,"[0, 0, 1, 0, 0, 0, 0, 1, 1, 0]"
2855,2,2,4,0.815895379565367,"[0, 1, 0, 0, 1, 1, 0, 1, 0, 0]"
2856,1,1,2,0.6242490178557046,"[0, 0, 1, 0, 1, 0, 1, 1, 1, 1]"
2857,5,5,10,0.6999245880368737,"[1, 0, 1, 0, 0, 0, 1, 1, 0, 0]"
2858,11,11,22,0.05792859400095829,"[1, 1, 1, 1, 1, 1, 0, 0, 0, 1]"
2859,1,1,2,0.7165151787554698,"[0, 1, 1, 0, 0, 0, 1, 0, 0, 1]"
2860,2,2,4,0.769139830364153,"[0, 1, 0, 0, 0, 0, 0, 0, 0, 1]"
2861,1,1,2,0.4343713022985246,"[0, 1, 0, 1, 0, 1, 1, 1, 0, 0]"
2862,1,1,2,0.09763412620326162,"[1, 0, 0, 0, 1, 1, 0, 0, 1, 0]"
2863,2,2,4,0.3769741129742683,"[1, 1, 0, 0, 1, 1, 0, 1, 1, 0]"
2864,12,12,24,0.6149012192886153,"[1, 1, 1, 0, 0, 1, 1, 0, 1, 1]"
2865,6,6,12,0.4432505423606222,"[0, 1, 1, 0, 1, 0, 0, 0, 1, 0]"
2866,2,2,4,0.3750479359639354,"[1, 1, 0, 0, 0, 0, 1, 0, 1, 1]"
2867,3,3,6,0.4841726358294953,"[0, 0, 1, 1, 0, 0, 1, 1, 0, 0]"
2868,2,2,4,0.09840641674130701,"[1, 0, 1, 1, 1, 0, 0, 0, 1, 1]"
2869,3,3,6,0.8499437443799074,"[0, 1, 0, 1, 0, 0, 0, 0, 1, 1]"
2870,1,1,2,0.8386569118889418,"[0, 0, 1, 0, 1, 1, 1, 1, 0, 1]"
2871,2,2,4,0.4440686479718753,"[1, 0, 1, 1, 0, 0, 0, 1, 0, 1]"
2872,3,3,6,0.6217379277966409,"[1, 0, 0, 0, 1, 0, 1, 1, 0, 1]"
2873,4,4,8,0.6110339234324199,"[0, 1, 0, 0, 1, 1, 0, 1, 1, 1]"
2874,4,4,8,0.30110089333213463,"[1, 1, 0, 1, 0, 0, 0, 1, 1, 0]"
2875,3,3,6,0.6533928834210279,"[0, 0, 1, 1, 0, 0, 0, 0, 0, 0]"
2876,1,1,2,0.022437707209303714,"[0, 1, 0, 1, 0, 0, 1, 0, 1, 0]"
2877,3,3,6,0.49712457732905757,"[1, 1, 1, 1, 0, 0, 0, 1, 0, 1]"
2878,1,1,2,0.027527331097847996,"[0, 1, 0, 1, 0, 1, 1, 0, 0, 1]"
2879,4,4,8,0.3982380449165981,"[0, 1, 1, 0, 1, 1, 0, 0, 1, 0]"
2880,1,1,2,0.9165860585562339,"[0, 1, 0, 1, 0, 0, 0, 1, 1, 0]"
2881,1,1,2,0.2644119402478218,"[1, 1, 0, 0, 0, 1, 0, 0, 0, 1]"
2882,1,1,2,0.005220696611083375,"[1, 0, 0, 0, 1, 1, 0, 1, 0, 0]"
2883,1,1,2,0.7515540103605368,"[0, 0, 1, 1, 0, 1, 1, 1, 1, 0]"
2884,2,2,4,0.33219533655059863,"[0, 0, 1, 1, 1, 1, 0, 1, 1, 1]"
2885,2,2,4,0.7865704051421003,"[1, 1, 0, 0, 0, 0, 0, 0, 1, 1]"
2886,1,1,2,0.4128286020249685,"[1, 1, 0, 0, 0, 1, 0, 0, 1, 0]"
2887,3,3,6,0.4993656683275728,"[1, 1, 1, 1, 1, 1, 1, 0, 0, 0]"
2888,3,3,6,0.29196838745523856,"[1, 1, 1, 1, 1, 1, 0, 0, 1, 0]"
2889,3,3,6,0.4784376219358376,"[0, 1, 1, 0, 0, 1, 0, 1, 0, 1]"
2890,4,4,8,0.43376417837482495,"[1, 0, 0, 0, 1, 0, 1, 0, 1, 1]"
2891,3,3,6,0.8415239144143108,"[0, 0, 0, 1, 0, 1, 1, 0, 0, 1]"
2892,2,2,4,0.14221019104815302,"[0, 1, 1, 1, 1, 0, 0, 0, 0, 0]"
2893,1,1,2,0.07160816822439964,"[0, 1, 1, 1, 0, 0, 0, 1, 0, 1]"
2894,2,2,4,0.9157958595402336,"[0, 0, 1, 0, 0, 1, 1, 0, 1, 0]"
2895,2,2,4,0.012031298259813972,"[1, 1, 0, 1, 0, 1, 1, 1, 1, 0]"
2896,1,1,2,0.28342436920049885,"[0, 0, 0, 0, 0, 0, 0, 0, 1, 0]"
2897,4,4,8,0.48437601509006956,"[1, 1, 0, 1, 1, 1, 0, 0, 1, 0]"
2898,2,2,4,0.5606896689173727,"[1, 1, 1, 0, 1, 0, 0, 0, 1, 0]"
2899,1,1,2,0.44898894069271456,"[0, 0, 0, 1, 1, 0, 1, 0, 0, 1]"
2900,1,1,2,0.9972727261154137,"[0, 1, 0, 0, 0, 1, 1, 1, 0, 1]"
2901,3,3,6,0.07310419932792733,"[1, 0, 0, 1, 0, 0, 0, 0, 1, 1]"
2902,22,22,44,0.7974472899114141,"[1, 1, 0, 1, 0, 1, 1, 1, 1, 1]"
2903,2,2,4,0.2738397258306816,"[0, 0, 0, 0, 0, 1, 1, 1, 1, 1]"
2904,3,3,6,0.6649105810225379,"[0, 1, 0, 1, 1, 0, 0, 1, 0, 1]"
2905,1,1,2,0.8969636722760538,"[0, 1, 0, 1, 0, 1, 1, 0, 0, 1]"
2906,2,2,4,0.11913595211726558,"[0, 1, 1, 1, 0, 1, 0, 1, 0, 1]"
2907,1,1,2,0.7969333203306158,"[1, 1, 0, 1, 0, 0, 0, 0, 1, 1]"
2908,1,1,2,0.7979971728299001,"[0, 0, 0, 1, 0, 1, 0, 1, 0, 1]"
2909,2,2,4,0.46347198447067584,"[0, 1, 1, 1, 0, 0, 1, 1, 1, 0]"
2910,1,1,2,0.4340157772204106,"[0, 1, 1, 1, 1, 0, 0, 0, 0, 0]"
2911,1,1,2,0.3361705769803184,"[0, 0, 0, 1, 1, 0, 1, 1, 1, 1]"
2912,1,1,2,0.842194668927298,"[0, 0, 1, 1, 0, 0, 0, 0, 1, 1]"
2913,1,1,2,0.8527383302116753,"[1, 1, 0, 1, 1, 1, 1, 0, 0, 1]"
2914,1,1,2,0.1542776441908209,"[0, 0, 1, 0, 1, 0, 1, 0, 0, 0]"
2915,6,6,12,0.5859555324819091,"[0, 1, 1, 1, 1, 1, 1, 0, 1, 0]"
2916,1,1,2,0.8998893024921281,"[0, 0, 1, 0, 0, 1, 1, 1, 0, 0]"
2917,5,5,10,0.47200847898142784,"[0, 0, 1, 0, 1, 1, 0, 1, 0, 1]"
2918,1,1,2,0.03301893520198729,"[1, 1, 1, 0, 0, 0, 1, 1, 1, 0]"
2919,2,2,4,0.7749566127859733,"[1, 1, 0, 0, 0, 0, 1, 1, 0, 1]"
2920,1,1,2,0.06379660171100376,"[1, 1, 0, 0, 0, 1, 0, 1, 0, 1]"
2921,2,2,4,0.1731176103925326,"[1, 1, 1, 1, 0, 0, 0, 1, 0, 1]"
2922,3,3,6,0.47395988659860755,"[1, 1, 0, 0, 0, 1, 1, 0, 0, 1]"
2923,1,1,2,0.5599375870375989,"[0, 1, 0, 1, 1, 0, 1, 0, 1, 0]"
2924,6,6,12,0.7525548301126785,"[1, 1, 1, 1, 1, 1, 0, 0, 0, 0]"
2925,1,1,2,0.8137188550495515,"[0, 0, 0, 1, 0, 1, 0, 0, 1, 1]"
2926,1,1,2,0.7250721428211802,"[1, 0, 0, 0, 0, 0, 0, 0, 1, 0]"
2927,4,4,8,0.6064870901170752,"[0, 1, 0, 0, 1, 1, 1, 1, 1, 0]"
2928,1,1,2,0.3691336720145434,"[1, 1, 0, 0, 0, 0, 0, 1, 1, 1]"
2929,2,2,4,0.31114446426190645,"[1, 1, 1, 0, 0, 0, 1, 1, 1, 1]"
2930,3,3,6,0.6941553300214993,"[1, 1, 0, 0, 1, 1, 0, 0, 1, 1]"
2931,2,2,4,0.27355801385969347,"[1, 0, 0, 0, 1, 1, 1, 0, 1, 1]"
2932,1,1,2,0.6511472843569482,"[0, 0, 0, 0, 0, 0, 0, 1, 0, 0]"
2933,2,2,4,0.9744433728262797,"[0, 0, 1, 1, 1, 1, 1, 1, 0, 0]"
2934,1,1,2,0.9878242885233011,"[0, 1, 1, 1, 1, 1, 1, 1, 0, 0]"
2935,1,1,2,0.5739420394747758,"[1, 1, 0, 0, 1, 0, 0, 0, 0, 1]"
2936,1,1,2,0.2655003048805932,"[0, 1, 1, 1, 0, 1, 1, 1, 1, 1]"
2937,2,2,4,0.05636287551441077,"[1, 0, 1, 1, 1, 0, 1, 0, 0, 0]"
2938,1,1,2,0.9122425274620937,"[1, 0, 0, 0, 1, 1, 0, 1, 0, 0]"
2939,3,3,6,0.23861505603775257,"[1, 1, 1, 1, 0, 1, 1, 0, 0, 1]"
2940,3,3,6,0.5456466829625546,"[0, 0, 1, 1, 0, 0, 0, 1, 0, 1]"
2941,2,2,4,0.46431727928374633,"[0, 1, 0, 0, 1, 1, 1, 1, 0, 1]"
2942,1,1,2,0.03961841831145596,"[1, 0, 1, 1, 1, 0, 1, 1, 0, 1]"
2943,4,4,8,0.2918222578942965,"[0, 1, 1, 0, 1, 1, 1, 0, 1, 0]"
2944,4,4,8,0.5405870025299485,"[1, 0, 1, 1, 0, 0, 0, 1, 0, 1]"
2945,1,1,2,0.14916651045228357,"[0, 0, 1, 1, 1, 0, 1, 0, 1, 0]"
2946,2,2,4,0.2190732939472113,"[1, 1, 0, 0, 0, 1, 1, 0, 1, 1]"
2947,1,1,2,0.34351104201687344,"[1, 0, 0, 0, 0, 0, 1, 0, 0, 0]"
2948,1,1,2,0.02771519657676713,"[0, 1, 1, 1, 0, 0, 1, 0, 1, 0]"
2949,3,3,6,0.07871303155385057,"[1, 0, 1, 0, 0, 1, 1, 1, 1, 0]"
2950,1,1,2,0.5508771684696849,"[0, 0, 0, 1, 0, 0, 1, 0, 0, 1]"
2951,1,1,2,0.5927537243639689,"[0, 1, 1, 0, 1, 0, 1, 0, 0, 1]"
2952,1,1,2,0.11659793147904929,"[0, 1, 1, 1, 0, 1, 1, 1, 0, 0]"
2953,1,1,2,0.7382636210412277,"[1, 1, 1, 1, 1, 1, 1, 0, 1, 1]"
2954,4,4,8,0.3350797392115038,"[1, 1, 0, 0, 1, 0, 0, 1, 1, 0]"
2955,1,1,2,0.9085887681646944,"[0, 0, 0, 0, 0, 0, 0, 0, 0, 0]"
2956,2,2,4,0.6790571608212992,"[0, 0, 0, 0, 0, 0, 0, 1, 0, 1]"
2957,4,4,8,0.6383730775088221,"[0, 1, 1, 1, 1, 0, 1, 0, 1, 1]"
2958,1,1,2,0.12089598377971023,"[0, 1, 1, 0, 0, 0, 1, 0, 1, 0]"
2959,3,3,6,0.40882461316321017,"[1, 0, 0, 0, 1, 1, 0, 1, 0, 0]"
2960,1,1,2,0.43778462418502173,"[0, 1, 0, 0, 0, 1, 1, 1, 1, 0]"
2961,3,3,6,0.727833029804203,"[0, 1, 1, 1, 1, 1, 0, 1, 0, 1]"
2962,2,2,4,0.8250739530141297,"[1, 1, 0, 0, 1, 1, 0, 0, 1, 0]"
2963,2,2,4,0.27707593215420423,"[1, 0, 0, 1, 1, 1, 1, 0, 0, 1]"
2964,21,21,42,0.5387782908866258,"[1, 1, 1, 1, 1, 1, 0, 1, 1, 0]"
2965,1,1,2,0.32758178506873104,"[1, 1, 0, 1, 0, 0, 0, 1, 1, 1]"
2966,6,6,12,0.8484914520434422,"[1, 0, 1, 1, 1, 0, 1, 0, 0, 1]"
2967,1,1,2,0.45890867574846084,"[0, 0, 0, 0, 1, 1, 0, 1, 0, 0]"
2968,11,11,22,0.43890005717017055,"[1, 1, 0, 1, 1, 0, 1, 0, 1, 1]"
2969,3,3,6,0.342511333819308,"[1, 1, 0, 1, 1, 0, 1, 1, 1, 0]"
2970,3,3,6,0.16362121717658995,"[0, 0, 0, 0, 1, 1, 1, 1, 0, 1]"
2971,11,11,22,0.6116066072006028,"[1, 0, 1, 1, 1, 1, 1, 1, 0, 1]"
2972,10,10,20,0.6467040602972941,"[1, 0, 1, 0, 1, 0, 1, 0, 1, 1]"
2973,5,5,10,0.14625099116193174,"[1, 0, 0, 1, 0, 1, 1, 1, 0, 1]"
2974,3,3,6,0.6058586557263933,"[0, 0, 0, 0, 1, 0, 1, 0, 1, 1]"
2975,3,3,6,0.3289044633337428,"[1, 0, 1, 0, 1, 1, 1, 1, 0, 0]"
2976,1,1,2,0.6393798573930783,"[1, 1, 1, 1, 1, 0, 1, 0, 0, 1]"
2977,2,2,4,0.2725149035578487,"[1, 1, 1, 1, 1, 1, 1, 0, 1, 0]"
2978,3,3,6,0.3538830216245048,"[0, 1, 1, 1, 1, 1, 0, 0, 1, 1]"
2979,1,1,2,0.7599545747746457,"[0, 0, 0, 0, 0, 1, 0, 1, 0, 1]"
2980,3,3,6,0.3842813580253943,"[0, 1, 1, 1, 1, 0, 0, 0, 1, 0]"
2981,4,4,8,0.9435915245769788,"[0, 0, 0, 1, 1, 1, 0, 0, 0, 0]"
2982,1,1,2,0.47553101223834293,"[0, 0, 0, 0, 1, 0, 0, 0, 1, 1]"
2983,1,1,2,0.2529902355766782,"[1, 0, 1, 1, 1, 0, 1, 0, 0, 1]"
2984,2,2,4,0.2096447032001486,"[1, 1, 0, 1, 1, 0, 1, 1, 0, 0]"
2985,1,1,2,0.28109346251978395,"[0, 0, 1, 1, 0, 0, 1, 1, 1, 1]"
2986,1,1,2,0.8141337741632758,"[0, 1, 1, 1, 0, 1, 0, 1, 0, 0]"
2987,2,2,4,0.36472239473114776,"[1, 0, 0, 0, 1, 1, 0, 1, 1, 0]"
2988,1,1,2,0.19083587299907578,"[0, 0, 0, 0, 1, 0, 0, 1, 1, 0]"
2989,2,2,4,0.05356646262783149,"[1, 1, 1, 1, 1, 1, 1, 1, 1, 0]"
2990,13,13,26,0.09552599522643312,"[1, 1, 1, 1, 0, 1, 1, 0, 0, 0]"
2991,1,1,2,0.015770717612889396,"[1, 0, 0, 0, 0, 0, 0, 0, 1, 0]"
2992,2,2,4,0.6888416182111005,"[0, 1, 0, 0, 0, 0, 0, 0, 0, 1]"
2993,2,2,4,0.6901177629899145,"[1, 1, 1, 1, 1, 1, 0, 0, 0, 1]"
2994,3,3,6,0.719601442632089,"[1, 0, 0, 0, 1, 0, 1, 1, 0, 1]"
2995,1,1,2,0.7340779297276445,"[1, 1, 0, 0, 1, 1, 0, 0, 0, 1]"
2996,3,3,6,0.20694008001914488,"[1, 0, 1, 1, 0, 0, 0, 1, 0, 1]"
2997,2,2,4,0.7756292359851982,"[0, 1, 1, 0, 0, 1, 1, 0, 1, 1]"
2998,5,5,10,0.9842578640677473,"[0, 1, 1, 0, 0, 0, 1, 1, 0, 1]"
2999,3,3,6,0.6593351165908987,"[1, 0, 1, 0, 1, 0, 0, 0, 0, 1]"
3000,2,2,4,0.2204337866238666,"[0, 0, 0, 1, 1, 1, 0, 1, 0, 0]"
3001,3,3,6,0.41556602726361414,"[0, 0, 0, 1, 0, 1, 1, 1, 1, 0]"
3002,3,3,6,0.4727249930568207,"[0, 0, 0, 1, 0, 1, 1, 1, 1, 0]"
3003,1,1,2,0.9393609686354432,"[0, 1, 1, 1, 0, 0, 0, 0, 0, 0]"
3004,1,1,2,0.08499544862267583,"[0, 1, 0, 0, 0, 1, 0, 1, 1, 1]"
3005,3,3,6,0.8711128608113957,"[1, 1, 1, 0, 0, 1, 1, 0, 1, 1]"
3006,2,2,4,0.8742754407691711,"[0, 0, 1, 0, 1, 1, 1, 0, 0, 0]"
3007,1,1,2,0.11536498433517328,"[1, 1, 1, 0, 0, 1, 1, 0, 1, 0]"
3008,2,2,4,0.8908861130215093,"[1, 1, 1, 1, 1, 1, 0, 0, 0, 1]"
3009,1,1,2,0.5486150967404391,"[0, 0, 0, 1, 0, 1, 0, 0, 0, 1]"
3010,2,2,4,0.5037368765297705,"[0, 0, 0, 0, 0, 1, 0, 0, 1, 1]"
3011,1,1,2,0.7943648986366131,"[0, 0, 0, 0, 0, 1, 0, 1, 0, 1]"
3012,1,1,2,0.8354570023689972,"[0, 1, 1, 1, 0, 0, 0, 1, 0, 1]"
3013,6,6,12,0.7080602332059628,"[1, 1, 1, 0, 1, 1, 1, 1, 1, 1]"
3014,1,1,2,0.2399350144170268,"[0, 1, 0, 1, 1, 0, 1, 0, 1, 0]"
3015,2,2,4,0.3369677688980909,"[1, 1, 1, 1, 0, 0, 1, 1, 0, 0]"
3016,1,1,2,0.0628389968215991,"[0, 1, 0, 1, 1, 0, 0, 0, 1, 1]"
3017,1,1,2,0.7511763199784801,"[1, 0, 0, 0, 1, 1, 1, 0, 0, 1]"
3018,2,2,4,0.00647254787939322,"[0, 1, 1, 1, 1, 0, 1, 0, 1, 1]"
3019,4,4,8,0.46262285122036273,"[1, 1, 0, 0, 0, 1, 0, 0, 1, 1]"
3020,3,3,6,0.9494607295870686,"[1, 1, 0, 1, 0, 1, 0, 1, 1, 0]"
3021,3,3,6,0.25615772118646263,"[0, 1, 0, 1, 0, 1, 0, 1, 0, 0]"
3022,1,1,2,0.41202396193132795,"[1, 0, 1, 0, 0, 1, 0, 0, 0, 0]"
3023,3,3,6,0.869186496025854,"[0, 0, 0, 1, 1, 1, 0, 0, 0, 0]"
3024,7,7,14,0.17852157646331368,"[1, 1, 0, 1, 0, 1, 1, 0, 1, 1]"
3025,1,1,2,0.817521099746142,"[0, 1, 1, 0, 1, 1, 0, 0, 0, 0]"
3026,3,3,6,0.11828710926848751,"[1, 0, 1, 1, 1, 0, 1, 1, 0, 0]"
3027,1,1,2,0.7951387646641614,"[1, 0, 0, 1, 0, 0, 1, 0, 0, 0]"
3028,1,1,2,0.5250593256117677,"[1, 1, 0, 0, 0, 1, 1, 1, 0, 1]"
3029,1,1,2,0.6824630356385655,"[0, 1, 0, 1, 1, 0, 1, 1, 1, 1]"
3030,2,2,4,0.3226492881984,"[0, 1, 1, 1, 1, 1, 0, 0, 0, 1]"
3031,3,3,6,0.22875273622475722,"[0, 1, 1, 0, 0, 0, 1, 1, 0, 1]"
3032,1,1,2,0.06832119815296267,"[1, 0, 0, 0, 1, 0, 1, 0, 0, 1]"
3033,3,3,6,0.6675946583276664,"[0, 0, 0, 0, 1, 1, 1, 1, 1, 0]"
3034,1,1,2,0.8821431983024485,"[1, 1, 1, 0, 0, 1, 0, 1, 0, 0]"
3035,4,4,8,0.8092612328940187,"[1, 0, 0, 0, 0, 0, 1, 1, 1, 0]"
3036,1,1,2,0.31144992518549675,"[0, 0, 1, 0, 0, 0, 0, 0, 0, 0]"
3037,1,1,2,0.9936922446462596,"[0, 1, 0, 1, 1, 1, 0, 0, 1, 1]"
3038,1,1,2,0.8650749109969269,"[0, 0, 1, 1, 1, 0, 0, 0, 0, 1]"
3039,5,5,10,0.7134092932530536,"[1, 1, 1, 1, 1, 1, 0, 0, 1, 1]"
3040,6,6,12,0.7695941918081446,"[1, 0, 0, 0, 1, 1, 1, 1, 1, 1]"
3041,1,1,2,0.9388985151138982,"[1, 1, 1, 0, 0, 1, 0, 0, 1, 1]"
3042,1,1,2,0.9943396080627833,"[0, 0, 1, 0, 0, 1, 0, 0, 1, 1]"
3043,3,3,6,0.579351767513108,"[0, 1, 0, 0, 0, 0, 1, 0, 1, 1]"
3044,5,5,10,0.6204119714390495,"[0, 0, 1, 1, 1, 0, 0, 0, 1, 1]"
3045,3,3,6,0.848310026664387,"[1, 0, 1, 0, 0, 1, 0, 0, 1, 0]"
3046,1,1,2,0.33505008287220206,"[0, 0, 0, 1, 1, 0, 0, 1, 0, 0]"
3047,1,1,2,0.2795087839621767,"[0, 0, 0, 1, 0, 0, 0, 1, 1, 0]"
3048,1,1,2,0.5708584716152487,"[1, 0, 1, 0, 1, 1, 0, 1, 0, 0]"
3049,1,1,2,0.7292199814858712,"[0, 1, 0, 1, 1, 0, 0, 1, 0, 0]"
3050,1,1,2,0.8486915190737544,"[0, 1, 1, 0, 1, 1, 1, 0, 1, 0]"
3051,4,4,8,0.9512336460276395,"[1, 1, 1, 1, 0, 0, 1, 1, 0, 0]"
3052,1,1,2,0.7749743355824534,"[1, 0, 0, 0, 1, 1, 0, 0, 0, 1]"
3053,1,1,2,0.9088103885579956,"[1, 0, 1, 0, 1, 0, 0, 0, 1, 1]"
3054,2,2,4,0.15201391629900796,"[0, 0, 1, 0, 0, 0, 0, 0, 0, 1]"
3055,1,1,2,0.5561924796640578,"[0, 0, 0, 0, 0, 0, 0, 1, 1, 1]"
3056,1,1,2,0.7104350981329303,"[1, 0, 0, 1, 0, 0, 1, 0, 0, 0]"
3057,2,2,4,0.7122481973909809,"[0, 0, 1, 1, 0, 1, 1, 1, 1, 0]"
3058,2,2,4,0.829274183641367,"[0, 1, 1, 1, 0, 1, 1, 1, 0, 0]"
3059,1,1,2,0.569223478989002,"[0, 1, 0, 1, 1, 0, 0, 0, 0, 0]"
3060,1,1,2,0.48311164312961785,"[1, 1, 0, 0, 0, 1, 1, 0, 1, 1]"
3061,1,1,2,0.14912941883220088,"[0, 1, 1, 1, 0, 0, 0, 1, 0, 0]"
3062,2,2,4,0.1944550132636358,"[1, 0, 1, 1, 1, 0, 1, 0, 1, 0]"
3063,3,3,6,0.7732733222331853,"[0, 1, 0, 1, 0, 0, 1, 1, 1, 1]"
3064,3,3,6,0.678100846605023,"[0, 1, 0, 0, 1, 0, 1, 0, 1, 0]"
3065,2,2,4,0.44665944770318877,"[0, 0, 1, 0, 0, 0, 1, 1, 0, 1]"
3066,6,6,12,0.12518797132141724,"[1, 1, 1, 1, 1, 1, 1, 0, 0, 0]"
3067,2,2,4,0.13187310789830087,"[0, 1, 1, 0, 1, 0, 1, 0, 0, 0]"
3068,1,1,2,0.9742716123958647,"[1, 0, 1, 1, 0, 1, 0, 0, 1, 0]"
3069,2,2,4,0.7755986078501781,"[1, 0, 0, 1, 0, 1, 1, 1, 0, 0]"
3070,1,1,2,0.3448210006082466,"[0, 1, 0, 1, 0, 1, 0, 1, 1, 1]"
3071,1,1,2,0.6570695416771013,"[0, 0, 0, 1, 1, 0, 0, 0, 0, 0]"
3072,4,4,8,0.7280409535095856,"[1, 1, 1, 1, 0, 1, 1, 1, 0, 1]"
3073,2,2,4,0.12753613519365858,"[1, 1, 0, 0, 1, 1, 1, 0, 1, 0]"
3074,2,2,4,0.4679277178386144,"[1, 0, 0, 1, 0, 1, 1, 0, 0, 1]"
3075,2,2,4,0.6047615014145972,"[0, 1, 1, 1, 1, 0, 0, 1, 0, 0]"
3076,1,1,2,0.9779643108199848,"[0, 0, 0, 1, 0, 1, 1, 0, 0, 0]"
3077,8,8,16,0.6625866427533391,"[0, 0, 1, 0, 0, 1, 0, 1, 1, 1]"
3078,5,5,10,0.4429253956331197,"[0, 1, 1, 1, 0, 1, 1, 1, 1, 0]"
3079,2,2,4,0.6488171153348733,"[1, 0, 1, 0, 1, 1, 1, 0, 0, 0]"
3080,1,1,2,0.6541800550604101,"[1, 1, 1, 0, 1, 1, 0, 0, 0, 1]"
3081,5,5,10,0.9178982785687317,"[0, 0, 1, 0, 0, 1, 1, 1, 1, 1]"
3082,2,2,4,0.11172611400193777,"[1, 0, 0, 1, 1, 0, 1, 1, 1, 0]"
3083,1,1,2,0.8038596463873778,"[0, 0, 1, 1, 1, 0, 1, 0, 0, 0]"
3084,3,3,6,0.8643085732825223,"[0, 0, 0, 1, 0, 0, 0, 1, 1, 0]"
3085,8,8,16,0.23620031726821933,"[1, 0, 1, 0, 1, 0, 1, 0, 1, 0]"
3086,5,5,10,0.6368950868186157,"[0, 0, 0, 0, 0, 0, 1, 0, 0, 1]"
3087,6,6,12,0.8655837172806227,"[1, 1, 0, 0, 1, 0, 0, 1, 1, 0]"
3088,12,12,24,0.6633675088448925,"[0, 1, 0, 1, 1, 1, 1, 1, 1, 0]"
3089,7,7,14,0.4394687261953769,"[0, 0, 0, 0, 1, 0, 1, 1, 1, 1]"
3090,1,1,2,0.6097225491479049,"[0, 0, 0, 0, 1, 0, 1, 0, 0, 1]"
3091,2,2,4,0.9475997985302211,"[1, 1, 1, 0, 1, 1, 0, 0, 0, 1]"
3092,1,1,2,0.16925089486735723,"[0, 1, 1, 1, 1, 0, 0, 0, 0, 0]"
3093,1,1,2,0.4923897519921504,"[0, 0, 0, 1, 1, 0, 0, 1, 0, 0]"
3094,7,7,14,0.824053467329642,"[1, 1, 1, 1, 1, 0, 1, 0, 0, 1]"
3095,2,2,4,0.13242412200989284,"[1, 1, 1, 1, 1, 1, 0, 0, 0, 0]"
3096,1,1,2,0.48646270096027333,"[1, 0, 0, 0, 0, 1, 0, 0, 0, 0]"
3097,1,1,2,0.7960585500601172,"[0, 0, 0, 1, 0, 1, 0, 0, 0, 0]"
3098,1,1,2,0.2752697437249104,"[1, 1, 0, 0, 1, 1, 1, 1, 0, 0]"
3099,1,1,2,0.4207760487780915,"[0, 0, 1, 1, 1, 1, 0, 0, 1, 1]"
3100,1,1,2,0.7106746464274857,"[1, 0, 0, 1, 0, 1, 0, 0, 0, 0]"
3101,3,3,6,0.5602023471344219,"[1, 1, 0, 0, 1, 0, 1, 1, 0, 0]"
3102,3,3,6,0.8249161608839713,"[0, 1, 1, 0, 1, 0, 0, 0, 1, 0]"
3103,1,1,2,0.8314841964451862,"[0, 0, 1, 0, 0, 1, 0, 1, 0, 1]"
3104,6,6,12,0.7235581530600095,"[1, 1, 0, 1, 0, 1, 1, 1, 1, 1]"
3105,5,5,10,0.8277935673105699,"[1, 1, 1, 0, 1, 0, 0, 1, 1, 1]"
3106,2,2,4,0.2300784548109699,"[0, 0, 1, 0, 1, 1, 1, 0, 0, 0]"
3107,8,8,16,0.48933521554458415,"[0, 1, 1, 1, 1, 1, 0, 0, 1, 1]"
3108,1,1,2,0.8519210219095691,"[1, 0, 1, 1, 1, 0, 1, 0, 0, 0]"
3109,1,1,2,0.4742519488570196,"[1, 0, 0, 1, 1, 0, 0, 0, 1, 1]"
3110,3,3,6,0.33998785210120497,"[1, 0, 1, 0, 1, 0, 0, 1, 1, 1]"
3111,4,4,8,0.2810893458205953,"[0, 1, 0, 0, 1, 0, 1, 0, 1, 0]"
3112,1,1,2,0.7945224061267662,"[1, 1, 1, 0, 1, 0, 0, 1, 0, 1]"
3113,2,2,4,0.29955222608295984,"[0, 1, 0, 1, 0, 0, 0, 0, 1, 0]"
3114,2,2,4,0.8394494240806887,"[1, 1, 1, 0, 0, 1, 1, 1, 1, 1]"
3115,1,1,2,0.20682260104121375,"[1, 0, 1, 0, 0, 0, 0, 1, 0, 0]"
3116,1,1,2,0.3235867459045879,"[0, 0, 0, 1, 1, 1, 0, 0, 1, 0]"
3117,2,2,4,0.7789028242257618,"[1, 0, 1, 1, 1, 1, 1, 1, 0, 0]"
3118,1,1,2,0.294936715766578,"[1, 1, 1, 0, 1, 0, 1, 1, 0, 1]"
3119,1,1,2,0.07322827144075217,"[0, 0, 0, 0, 0, 1, 1, 1, 0, 0]"
3120,1,1,2,0.4921339359622472,"[0, 0, 1, 0, 1, 0, 1, 1, 1, 0]"
3121,1,1,2,0.9006456172045119,"[1, 0, 1, 0, 0, 0, 0, 1, 0, 0]"
3122,1,1,2,0.3832919076609632,"[0, 1, 0, 1, 0, 0, 1, 0, 1, 0]"
3123,3,3,6,0.8472427468141073,"[0, 0, 1, 1, 0, 1, 1, 1, 1, 1]"
3124,2,2,4,0.6846092622278825,"[1, 1, 1, 0, 0, 1, 0, 1, 0, 0]"
3125,1,1,2,0.6111085924613154,"[0, 1, 1, 0, 1, 0, 0, 0, 0, 0]"
3126,28,28,56,0.33395307495616344,"[1, 1, 0, 1, 1, 1, 1, 1, 1, 0]"
3127,1,1,2,0.6053849177124117,"[1, 0, 0, 0, 1, 0, 0, 1, 1, 0]"
3128,7,7,14,0.9402177184004675,"[0, 0, 1, 1, 0, 0, 1, 1, 0, 1]"
3129,1,1,2,0.9459247646277021,"[1, 0, 0, 0, 1, 1, 1, 0, 1, 0]"
3130,1,1,2,0.2787894630663552,"[0, 0, 0, 1, 0, 1, 1, 0, 1, 1]"
3131,2,2,4,0.5298398437368858,"[0, 0, 0, 1, 1, 1, 0, 0, 1, 0]"
3132,7,7,14,0.8347808010868646,"[1, 0, 0, 1, 1, 0, 1, 0, 1, 1]"
3133,1,1,2,0.3710836971032764,"[0, 1, 0, 1, 0, 1, 0, 0, 0, 1]"
3134,1,1,2,0.5951865732251644,"[0, 1, 1, 1, 0, 0, 1, 0, 0, 0]"
3135,1,1,2,0.7646999818230344,"[0, 1, 0, 1, 0, 0, 0, 0, 1, 1]"
3136,1,1,2,0.4579562337107931,"[1, 1, 1, 1, 0, 0, 0, 0, 0, 0]"
3137,1,1,2,0.7448117006566107,"[0, 0, 0, 0, 1, 0, 1, 1, 0, 0]"
3138,1,1,2,0.42807835990059384,"[0, 0, 0, 1, 0, 1, 0, 1, 0, 0]"
3139,11,11,22,0.5760729361828505,"[1, 0, 0, 0, 1, 0, 1, 0, 1, 1]"
3140,1,1,2,0.847701829586849,"[1, 1, 1, 1, 1, 0, 1, 0, 1, 0]"
3141,1,1,2,0.30471881670075984,"[0, 0, 1, 0, 1, 0, 0, 1, 1, 1]"
3142,1,1,2,0.9744433435125894,"[0, 0, 0, 0, 1, 0, 0, 1, 1, 1]"
3143,1,1,2,0.4107323894729862,"[0, 1, 0, 0, 1, 0, 0, 1, 1, 0]"
3144,1,1,2,0.5445901598614113,"[1, 1, 0, 1, 1, 1, 0, 1, 0, 1]"
3145,5,5,10,0.5757539914793623,"[1, 0, 1, 1, 0, 1, 0, 1, 1, 1]"
3146,6,6,12,0.9957987197680236,"[1, 1, 0, 0, 1, 1, 1, 0, 0, 0]"
3147,8,8,16,0.5371029240006467,"[1, 1, 0, 1, 1, 1, 1, 1, 1, 1]"
3148,6,6,12,0.8172213454946604,"[1, 1, 1, 1, 1, 0, 1, 0, 0, 1]"
3149,1,1,2,0.5940381255513265,"[0, 1, 0, 1, 0, 0, 0, 1, 0, 0]"
3150,1,1,2,0.16910305344859788,"[1, 1, 0, 0, 0, 0, 1, 0, 1, 1]"
3151,11,11,22,0.6377551879653391,"[0, 1, 1, 0, 0, 1, 1, 1, 0, 1]"
3152,1,1,2,0.7036235783012966,"[0, 0, 0, 0, 0, 1, 1, 0, 1, 0]"
3153,1,1,2,0.40903035074535765,"[0, 1, 0, 0, 0, 1, 1, 0, 1, 0]"
3154,1,1,2,0.040205222844349686,"[0, 1, 1, 0, 0, 0, 1, 1, 0, 0]"
3155,5,5,10,0.9201485591249596,"[0, 0, 1, 1, 1, 0, 1, 1, 0, 0]"
3156,2,2,4,0.462590706258322,"[1, 0, 1, 0, 1, 1, 1, 1, 1, 0]"
3157,1,1,2,0.8973193656991604,"[1, 1, 1, 0, 1, 0, 1, 0, 0, 0]"
3158,1,1,2,0.05609388401302218,"[1, 0, 1, 1, 1, 1, 0, 0, 1, 1]"
3159,2,2,4,0.7371008939157945,"[0, 1, 0, 0, 1, 0, 0, 0, 1, 0]"
3160,2,2,4,0.09974594569133977,"[0, 0, 0, 0, 0, 0, 1, 1, 1, 1]"
3161,2,2,4,0.17537389534221237,"[1, 0, 0, 1, 1, 1, 0, 0, 0, 1]"
3162,1,1,2,0.05641453335879287,"[1, 0, 1, 0, 1, 0, 0, 0, 1, 0]"
3163,3,3,6,0.8935366331858686,"[0, 1, 0, 1, 0, 1, 0, 1, 1, 1]"
3164,1,1,2,0.6915756914418976,"[0, 1, 1, 0, 1, 1, 0, 0, 1, 0]"
3165,1,1,2,0.48809165897195117,"[0, 1, 1, 1, 1, 0, 1, 1, 0, 0]"
3166,1,1,2,0.4993356452184181,"[0, 1, 0, 0, 1, 1, 1, 0, 0, 1]"
3167,1,1,2,0.5664211314998526,"[1, 0, 0, 1, 0, 1, 1, 0, 0, 1]"
3168,7,7,14,0.4781551318462408,"[1, 0, 0, 1, 1, 1, 1, 0, 1, 0]"
3169,4,4,8,0.25408183154792263,"[1, 1, 1, 1, 1, 1, 1, 1, 0, 1]"
3170,2,2,4,0.6378692341610059,"[0, 1, 0, 0, 0, 1, 0, 1, 1, 0]"
3171,3,3,6,0.12064067895025277,"[1, 0, 0, 1, 1, 1, 0, 1, 1, 1]"
3172,1,1,2,0.9772292547080843,"[0, 1, 1, 1, 0, 1, 1, 0, 0, 1]"
3173,2,2,4,0.05589307637483276,"[0, 1, 0, 0, 1, 0, 1, 0, 1, 1]"
3174,2,2,4,0.08062229531296095,"[1, 1, 0, 0, 1, 1, 1, 1, 0, 0]"
3175,1,1,2,0.774990903106804,"[0, 0, 0, 0, 1, 1, 0, 0, 0, 0]"
3176,3,3,6,0.4886320002904502,"[0, 1, 0, 1, 1, 1, 1, 0, 1, 1]"
3177,2,2,4,0.008509443210899748,"[0, 0, 0, 1, 1, 0, 1, 0, 1, 1]"
3178,9,9,18,0.3462146679175643,"[1, 1, 1, 0, 0, 0, 0, 1, 0, 1]"
3179,1,1,2,0.19808872377155085,"[0, 0, 1, 0, 1, 1, 0, 1, 0, 0]"
3180,1,1,2,0.033206878647392135,"[0, 1, 1, 0, 0, 0, 0, 0, 0, 0]"
3181,1,1,2,0.5091044061819708,"[1, 0, 1, 0, 0, 0, 0, 1, 0, 0]"
3182,1,1,2,0.32262880534905614,"[0, 1, 0, 1, 1, 0, 1, 0, 0, 0]"
3183,1,1,2,0.9058173028516654,"[0, 0, 1, 0, 1, 0, 1, 1, 0, 1]"
3184,1,1,2,0.5698198751153354,"[1, 0, 0, 0, 0, 1, 1, 1, 0, 0]"
3185,2,2,4,0.08215431084137947,"[1, 1, 1, 0, 0, 1, 0, 0, 0, 0]"
3186,1,1,2,0.49324075420673674,"[0, 1, 0, 0, 0, 0, 1, 0, 0, 1]"
3187,2,2,4,0.9605529278019582,"[1, 1, 1, 1, 0, 0, 0, 1, 1, 0]"
3188,1,1,2,0.729200090095494,"[1, 0, 0, 1, 0, 0, 0, 0, 1, 0]"
3189,6,6,12,0.5942718529486795,"[1, 1, 1, 0, 0, 0, 0, 0, 1, 1]"
3190,1,1,2,0.9444058091751464,"[0, 0, 1, 0, 0, 0, 0, 0, 1, 0]"
3191,1,1,2,0.8362127603390427,"[0, 1, 0, 1, 0, 0, 0, 0, 1, 1]"
3192,1,1,2,0.6594533888136543,"[0, 1, 1, 1, 0, 0, 1, 1, 0, 0]"
3193,5,5,10,0.06287349238648543,"[0, 0, 1, 1, 0, 1, 0, 0, 1, 0]"
3194,1,1,2,0.15710752808439343,"[0, 0, 0, 1, 0, 1, 0, 1, 0, 1]"
3195,2,2,4,0.37298388607753363,"[0, 0, 0, 0, 1, 1, 1, 0, 1, 1]"
3196,6,6,12,0.7475889860128454,"[0, 1, 1, 0, 1, 1, 0, 1, 1, 1]"
3197,3,3,6,0.8217488358614623,"[1, 1, 1, 1, 0, 0, 1, 1, 0, 0]"
3198,1,1,2,0.01871353671519782,"[1, 0, 1, 0, 1, 0, 0, 0, 1, 1]"
3199,3,3,6,0.2468132764420239,"[1, 1, 1, 1, 1, 0, 1, 0, 1, 1]"
3200,6,6,12,0.8941129511839233,"[0, 1, 1, 1, 0, 0, 0, 1, 1, 1]"
3201,3,3,6,0.15490430702848623,"[0, 1, 0, 0, 0, 1, 1, 0, 1, 1]"
3202,1,1,2,0.8995793489647835,"[0, 1, 0, 0, 1, 1, 1, 0, 1, 1]"
3203,2,2,4,0.7505210830375507,"[0, 1, 1, 1, 1, 0, 1, 0, 0, 0]"
3204,2,2,4,0.6678582993665453,"[1, 1, 0, 0, 1, 0, 1, 0, 1, 1]"
3205,1,1,2,0.7417764286255772,"[1, 1, 1, 0, 1, 1, 0, 1, 1, 0]"
3206,1,1,2,0.6512276074449858,"[0, 0, 0, 0, 0, 0, 1, 1, 1, 0]"
3207,2,2,4,0.6928852126060618,"[1, 0, 0, 0, 0, 0, 0, 1, 0, 1]"
3208,3,3,6,0.2821439727463112,"[1, 0, 0, 0, 1, 0, 0, 0, 0, 1]"
3209,1,1,2,0.4649550045365851,"[0, 0, 0, 0, 1, 0, 0, 0, 0, 1]"
3210,1,1,2,0.8202424725027476,"[1, 1, 0, 0, 0, 0, 0, 0, 0, 0]"
3211,1,1,2,0.9012652589288683,"[1, 0, 1, 1, 0, 1, 0, 0, 0, 0]"
3212,1,1,2,0.0599828342848423,"[0, 0, 1, 0, 1, 0, 0, 1, 0, 0]"
3213,2,2,4,0.472046195555342,"[0, 0, 0, 0, 0, 1, 1, 0, 1, 0]"
3214,1,1,2,0.0468294338291253,"[0, 1, 0, 1, 0, 0, 0, 1, 1, 0]"
3215,1,1,2,0.26020009539916933,"[0, 0, 0, 1, 1, 0, 0, 1, 1, 0]"
3216,4,4,8,0.5539896333464381,"[1, 1, 1, 1, 1, 0, 0, 0, 1, 0]"
3217,1,1,2,0.32866805613690575,"[1, 0, 0, 0, 0, 1, 1, 0, 0, 0]"
3218,5,5,10,0.05540804940925981,"[1, 0, 1, 0, 1, 0, 0, 1, 1, 1]"
3219,1,1,2,0.9741937393699412,"[1, 0, 1, 0, 0, 0, 0, 0, 1, 0]"
3220,6,6,12,0.16120781198276368,"[1, 0, 0, 1, 0, 1, 1, 1, 0, 1]"
3221,1,1,2,0.2783940083495945,"[0, 0, 1, 0, 1, 0, 1, 0, 1, 1]"
3222,2,2,4,0.23805592260439878,"[0, 1, 0, 1, 0, 0, 1, 0, 1, 0]"
3223,3,3,6,0.9634081407026182,"[0, 1, 1, 0, 1, 1, 1, 1, 0, 0]"
3224,1,1,2,0.7379682995737182,"[0, 0, 1, 0, 0, 0, 0, 0, 1, 1]"
3225,2,2,4,0.2650346623175849,"[1, 1, 0, 0, 1, 1, 0, 1, 0, 0]"
3226,1,1,2,0.27687829859731383,"[0, 1, 1, 0, 1, 0, 1, 0, 1, 0]"
3227,1,1,2,0.6607665945027197,"[1, 1, 0, 1, 0, 1, 0, 1, 1, 0]"
3228,1,1,2,0.8651350132346151,"[1, 0, 0, 1, 0, 0, 0, 1, 1, 0]"
3229,3,3,6,0.6557351400432574,"[1, 1, 1, 1, 1, 1, 1, 1, 1, 1]"
3230,1,1,2,0.696616068960689,"[0, 0, 1, 1, 0, 1, 0, 1, 0, 1]"
3231,2,2,4,0.3026883424406137,"[1, 1, 1, 0, 1, 0, 1, 1, 1, 1]"
3232,5,5,10,0.7025069394855222,"[1, 0, 0, 0, 1, 0, 1, 1, 0, 1]"
3233,1,1,2,0.06461114323886186,"[1, 0, 0, 0, 0, 1, 0, 0, 0, 0]"
3234,2,2,4,0.10075274580451765,"[1, 0, 0, 0, 0, 1, 1, 1, 0, 0]"
3235,1,1,2,0.4702184811294059,"[0, 1, 0, 0, 1, 0, 1, 0, 1, 1]"
3236,1,1,2,0.5822561297783113,"[1, 1, 0, 0, 0, 0, 1, 1, 0, 0]"
3237,6,6,12,0.9592194126751363,"[1, 1, 1, 0, 0, 1, 1, 0, 1, 1]"
3238,2,2,4,0.03256757856157588,"[0, 0, 1, 1, 1, 1, 1, 1, 1, 1]"
3239,1,1,2,0.3932926346337008,"[1, 0, 1, 1, 1, 1, 0, 0, 1, 1]"
3240,2,2,4,0.4241605984626069,"[1, 0, 1, 0, 0, 0, 1, 1, 1, 1]"
3241,1,1,2,0.3204855065732045,"[0, 0, 0, 1, 0, 0, 1, 0, 1, 0]"
3242,2,2,4,0.14223853447006074,"[1, 0, 0, 1, 1, 0, 1, 1, 0, 1]"
3243,1,1,2,0.04507317514194653,"[0, 0, 1, 0, 0, 1, 1, 0, 0, 0]"
3244,1,1,2,0.3576014514257092,"[0, 0, 0, 1, 1, 0, 1, 0, 0, 1]"
3245,3,3,6,0.27069002380136487,"[0, 0, 1, 1, 0, 0, 0, 0, 0, 0]"
3246,1,1,2,0.27653797684642056,"[0, 1, 0, 1, 0, 1, 1, 1, 1, 0]"
3247,2,2,4,0.6399574906830172,"[0, 1, 1, 0, 0, 0, 0, 0, 0, 1]"
3248,1,1,2,0.6852683827379148,"[1, 0, 1, 0, 1, 0, 0, 1, 0, 0]"
3249,1,1,2,0.8865738675503944,"[1, 1, 1, 0, 0, 1, 0, 0, 0, 1]"
3250,1,1,2,0.35169957363976956,"[0, 1, 1, 0, 0, 0, 0, 0, 1, 1]"
3251,3,3,6,0.08204978868694168,"[1, 1, 1, 0, 1, 1, 1, 1, 0, 0]"
3252,2,2,4,0.9986140525322103,"[0, 1, 0, 1, 0, 1, 0, 0, 0, 0]"
3253,1,1,2,0.3080215189622241,"[1, 0, 1, 0, 0, 0, 0, 1, 1, 0]"
3254,3,3,6,0.2384835093262705,"[0, 1, 1, 1, 1, 0, 0, 1, 1, 1]"
3255,1,1,2,0.05898032379697504,"[1, 1, 0, 0, 0, 1, 1, 1, 0, 0]"
3256,4,4,8,0.9665728499475711,"[0, 1, 1, 1, 1, 0, 0, 0, 1, 1]"
3257,2,2,4,0.21096751851228468,"[0, 1, 1, 1, 0, 1, 1, 0, 1, 0]"
3258,4,4,8,0.3549385650011423,"[0, 1, 1, 1, 1, 1, 1, 0, 0, 0]"
3259,2,2,4,0.7670863788889419,"[0, 1, 1, 1, 0, 1, 1, 1, 1, 1]"
3260,1,1,2,0.8166156003315233,"[0, 0, 1, 0, 0, 0, 0, 0, 0, 0]"
3261,1,1,2,0.5015605480578332,"[1, 1, 0, 1, 0, 0, 1, 0, 0, 0]"
3262,1,1,2,0.5704978775680061,"[1, 1, 0, 0, 0, 1, 1, 0, 1, 1]"
3263,3,3,6,0.10204813212283381,"[0, 1, 1, 1, 0, 1, 0, 1, 0, 1]"
3264,2,2,4,0.2864514744361225,"[0, 0, 0, 1, 0, 0, 0, 1, 0, 0]"
3265,3,3,6,0.5548616561914963,"[0, 1, 0, 0, 0, 1, 1, 1, 1, 0]"
3266,11,11,22,0.36221635057190416,"[1, 1, 0, 1, 0, 1, 1, 1, 1, 1]"
3267,1,1,2,0.9011504876505321,"[0, 1, 0, 1, 1, 1, 0, 1, 1, 1]"
3268,2,2,4,0.9142997686310902,"[1, 0, 0, 0, 1, 1, 0, 1, 1, 0]"
3269,1,1,2,0.1283229109913009,"[0, 0, 1, 1, 1, 0, 0, 1, 1, 0]"
3270,2,2,4,0.10936909408912576,"[0, 1, 0, 0, 1, 0, 1, 0, 0, 1]"
3271,3,3,6,0.03180494646032439,"[0, 1, 0, 1, 1, 1, 1, 1, 1, 0]"
3272,2,2,4,0.22327069684775747,"[1, 1, 1, 0, 0, 0, 0, 0, 1, 0]"
3273,1,1,2,0.3710984316036331,"[1, 0, 0, 0, 0, 1, 0, 1, 1, 0]"
3274,1,1,2,0.5259605209295651,"[0, 1, 1, 1, 0, 1, 1, 1, 0, 0]"
3275,1,1,2,0.8115941112653846,"[0, 0, 1, 0, 0, 1, 1, 1, 1, 0]"
3276,1,1,2,0.5036683280019267,"[1, 0, 0, 1, 0, 1, 0, 0, 0, 1]"
3277,1,1,2,0.8507941995055939,"[1, 1, 1, 0, 0, 1, 1, 0, 0, 1]"
3278,1,1,2,0.6802195766249334,"[1, 0, 1, 0, 0, 0, 1, 0, 1, 1]"
3279,2,2,4,0.5759973305544521,"[1, 1, 0, 1, 1, 0, 1, 1, 0, 1]"
3280,1,1,2,0.5217682278683542,"[1, 0, 1, 1, 0, 1, 0, 0, 0, 0]"
3281,1,1,2,0.4718372763354237,"[0, 0, 0, 1, 0, 0, 1, 0, 0, 0]"
3282,1,1,2,0.5909476390639276,"[1, 1, 0, 0, 1, 1, 0, 0, 0, 0]"
3283,2,2,4,0.382146355235666,"[0, 0, 0, 0, 0, 1, 0, 0, 1, 1]"
3284,1,1,2,0.6091030853045318,"[0, 1, 0, 0, 0, 1, 1, 0, 1, 0]"
3285,2,2,4,0.9015001208746694,"[0, 0, 0, 0, 1, 1, 1, 1, 0, 0]"
3286,3,3,6,0.6112911894624881,"[1, 0, 1, 0, 0, 0, 0, 1, 0, 0]"
3287,2,2,4,0.24896290501655804,"[0, 1, 1, 0, 1, 1, 0, 0, 1, 1]"
3288,2,2,4,0.8798437692357024,"[0, 1, 0, 0, 0, 0, 1, 1, 1, 0]"
3289,1,1,2,0.9569611174422529,"[1, 0, 0, 1, 1, 0, 0, 0, 1, 1]"
3290,3,3,6,0.8246489182375568,"[1, 0, 0, 1, 0, 0, 0, 1, 1, 0]"
3291,3,3,6,0.8652160633193963,"[0, 1, 0, 0, 1, 1, 1, 0, 1, 1]"
3292,2,2,4,0.28514623270853734,"[0, 0, 0, 1, 0, 1, 1, 1, 1, 0]"
3293,2,2,4,0.9756787051473977,"[1, 0, 1, 0, 0, 1, 0, 1, 1, 1]"
3294,1,1,2,0.7105682872317617,"[1, 0, 0, 1, 0, 1, 0, 0, 0, 1]"
3295,1,1,2,0.14393487742172395,"[0, 0, 0, 0, 1, 1, 0, 1, 0, 0]"
3296,1,1,2,0.9091880293999876,"[0, 0, 1, 0, 1, 0, 0, 1, 0, 1]"
3297,1,1,2,0.37703446949656405,"[0, 1, 0, 1, 1, 0, 0, 1, 0, 1]"
3298,1,1,2,0.9826567741859318,"[1, 0, 1, 0, 1, 0, 1, 0, 1, 0]"
3299,2,2,4,0.29665843149063953,"[0, 1, 1, 1, 1, 0, 0, 1, 0, 0]"
3300,2,2,4,0.7037909884233218,"[0, 1, 0, 1, 1, 1, 0, 1, 0, 0]"
3301,1,1,2,0.6840711309052574,"[1, 1, 0, 1, 1, 0, 1, 1, 0, 0]"
3302,4,4,8,0.7635929730277918,"[1, 0, 0, 0, 0, 1, 0, 0, 1, 1]"
3303,2,2,4,0.7658082376163596,"[1, 0, 0, 1, 1, 1, 1, 0, 1, 0]"
3304,11,11,22,0.36071585597635825,"[0, 1, 1, 1, 1, 0, 1, 1, 1, 1]"
3305,4,4,8,0.2611844544469136,"[1, 0, 1, 1, 1, 0, 1, 0, 0, 1]"
3306,3,3,6,0.13633825920511577,"[1, 1, 1, 0, 1, 1, 0, 0, 1, 1]"
3307,3,3,6,0.9120292659778377,"[0, 0, 0, 0, 1, 0, 0, 1, 0, 0]"
3308,2,2,4,0.8409404065300656,"[0, 1, 1, 0, 0, 1, 1, 1, 1, 1]"
3309,2,2,4,0.5447407884768333,"[1, 0, 1, 1, 0, 1, 1, 1, 0, 1]"
3310,1,1,2,0.24399683811464712,"[1, 0, 0, 0, 0, 0, 0, 0, 1, 1]"
3311,1,1,2,0.8130121171882803,"[1, 0, 0, 1, 0, 1, 1, 0, 0, 0]"
3312,2,2,4,0.7995998137377479,"[0, 0, 0, 0, 1, 0, 1, 0, 0, 0]"
3313,2,2,4,0.8169922968922151,"[0, 0, 1, 1, 0, 1, 0, 1, 1, 1]"
3314,4,4,8,0.02337332219087973,"[0, 1, 1, 0, 1, 1, 0, 1, 1, 0]"
3315,3,3,6,0.44606846780826825,"[1, 0, 0, 1, 1, 0, 1, 1, 0, 1]"
3316,1,1,2,0.5289985952273708,"[0, 0, 1, 0, 1, 1, 0, 1, 1, 1]"
3317,5,5,10,0.1156423737591108,"[1, 1, 0, 0, 0, 1, 1, 1, 1, 1]"
3318,2,2,4,0.8456961920472392,"[0, 0, 0, 0, 0, 0, 1, 1, 0, 1]"
3319,1,1,2,0.9534111629774387,"[0, 1, 1, 1, 1, 0, 0, 0, 0, 0]"
3320,2,2,4,0.6530779564317355,"[1, 0, 0, 0, 1, 0, 0, 1, 1, 0]"
3321,2,2,4,0.984254345147647,"[1, 0, 0, 1, 1, 1, 1, 1, 1, 0]"
3322,1,1,2,0.26217524208313414,"[1, 0, 0, 1, 1, 1, 1, 0, 1, 1]"
3323,2,2,4,0.6461818116608448,"[1, 1, 0, 0, 1, 0, 0, 1, 0, 1]"
3324,1,1,2,0.39872050223307276,"[0, 1, 0, 1, 1, 0, 1, 0, 0, 0]"
3325,1,1,2,0.43986609947597033,"[0, 1, 0, 1, 1, 0, 1, 1, 1, 0]"
3326,2,2,4,0.21853561494594398,"[1, 1, 0, 1, 0, 0, 1, 1, 1, 1]"
3327,1,1,2,0.4075199927667684,"[1, 0, 0, 0, 0, 1, 1, 0, 0, 0]"
3328,1,1,2,0.7600320646254964,"[0, 1, 0, 1, 1, 1, 1, 0, 1, 1]"
3329,1,1,2,0.8614281873543256,"[0, 0, 1, 0, 0, 1, 0, 1, 0, 1]"
3330,1,1,2,0.3462056554332468,"[1, 1, 1, 0, 1, 0, 0, 0, 0, 0]"
3331,3,3,6,0.5681257871014623,"[0, 1, 0, 1, 1, 0, 1, 1, 0, 1]"
3332,5,5,10,0.14875865345002703,"[0, 1, 1, 1, 1, 0, 1, 1, 0, 1]"
3333,1,1,2,0.24802456204663548,"[0, 0, 0, 0, 1, 0, 1, 0, 0, 0]"
3334,1,1,2,0.6546059968466547,"[0, 0, 1, 0, 0, 0, 1, 1, 1, 0]"
3335,1,1,2,0.5958870355899234,"[1, 0, 1, 1, 0, 0, 0, 1, 1, 0]"
3336,2,2,4,0.3224843075571231,"[0, 0, 1, 1, 1, 0, 0, 0, 0, 1]"
3337,2,2,4,0.3247479989014922,"[0, 0, 0, 1, 1, 1, 1, 0, 1, 1]"
3338,3,3,6,0.1928587736475631,"[0, 1, 1, 0, 1, 1, 1, 0, 1, 0]"
3339,2,2,4,0.11551701693925476,"[0, 1, 0, 0, 1, 0, 1, 1, 1, 1]"
3340,4,4,8,0.9828134403829437,"[1, 1, 1, 1, 1, 1, 0, 0, 0, 0]"
3341,2,2,4,0.7550358581460018,"[1, 0, 0, 1, 0, 1, 1, 0, 0, 1]"
3342,4,4,8,0.32783101169341977,"[1, 1, 1, 1, 0, 1, 1, 0, 1, 1]"
3343,1,1,2,0.022160841324724734,"[0, 1, 1, 0, 0, 0, 0, 0, 0, 1]"
3344,3,3,6,0.3578210431596792,"[1, 0, 1, 1, 1, 1, 0, 0, 0, 0]"
3345,1,1,2,0.27700668112492877,"[0, 1, 1, 0, 1, 1, 0, 1, 1, 0]"
3346,1,1,2,0.3206492255178396,"[0, 0, 0, 1, 1, 1, 0, 1, 0, 1]"
3347,1,1,2,0.22954174550839046,"[0, 0, 1, 0, 1, 0, 1, 0, 1, 0]"
3348,1,1,2,0.5669049364591353,"[0, 1, 0, 0, 1, 0, 0, 0, 0, 1]"
3349,2,2,4,0.2948570514120922,"[1, 1, 0, 0, 0, 0, 0, 1, 0, 0]"
3350,1,1,2,0.2380655456693863,"[1, 1, 1, 1, 1, 0, 1, 0, 1, 1]"
3351,1,1,2,0.20227390497565556,"[0, 1, 0, 1, 0, 0, 1, 0, 0, 1]"
3352,1,1,2,0.19331882290136693,"[0, 0, 1, 0, 0, 0, 0, 1, 0, 0]"
3353,5,5,10,0.08234789371636331,"[1, 1, 0, 0, 0, 1, 1, 0, 1, 1]"
3354,11,11,22,0.5872882891990825,"[0, 1, 1, 1, 1, 1, 1, 1, 1, 1]"
3355,1,1,2,0.2613584960189592,"[0, 0, 1, 1, 0, 0, 1, 0, 0, 0]"
3356,1,1,2,0.4346121449583279,"[1, 0, 1, 1, 0, 0, 1, 1, 1, 1]"
3357,3,3,6,0.6505719948299841,"[0, 0, 1, 0, 0, 1, 1, 1, 1, 1]"
3358,3,3,6,0.7397454375227613,"[1, 1, 0, 1, 1, 1, 1, 0, 1, 0]"
3359,5,5,10,0.07486919726121666,"[1, 0, 0, 1, 0, 0, 0, 1, 1, 1]"
3360,1,1,2,0.6302322798659388,"[0, 0, 0, 1, 0, 0, 1, 0, 0, 0]"
3361,1,1,2,0.7344683529732926,"[0, 0, 1, 0, 0, 0, 1, 1, 0, 1]"
3362,2,2,4,0.9663726235834234,"[0, 0, 0, 1, 0, 1, 0, 1, 1, 1]"
3363,5,5,10,0.004488267909879773,"[1, 0, 1, 0, 1, 1, 1, 0, 1, 0]"
3364,2,2,4,0.6521538552653138,"[0, 0, 1, 0, 1, 1, 1, 1, 0, 0]"
3365,5,5,10,0.1079196575450867,"[0, 1, 1, 1, 1, 0, 0, 1, 1, 1]"
3366,1,1,2,0.07648839683810371,"[1, 0, 0, 0, 0, 1, 1, 1, 1, 0]"
3367,3,3,6,0.7014244208107145,"[1, 1, 1, 1, 1, 1, 0, 0, 1, 1]"
3368,1,1,2,0.16500701554290265,"[1, 1, 1, 1, 1, 0, 0, 1, 1, 0]"
3369,2,2,4,0.5337992738735705,"[1, 0, 1, 1, 0, 0, 1, 0, 1, 0]"
3370,1,1,2,0.5119752781349048,"[1, 1, 0, 0, 0, 0, 1, 1, 0, 1]"
3371,3,3,6,0.32482093577721727,"[0, 1, 0, 1, 1, 0, 1, 0, 0, 0]"
3372,1,1,2,0.3106104810083814,"[1, 1, 1, 1, 1, 0, 1, 0, 0, 1]"
3373,4,4,8,0.2086224423775126,"[0, 1, 0, 0, 1, 1, 1, 1, 1, 1]"
3374,1,1,2,0.4383667039075524,"[1, 0, 0, 1, 0, 1, 1, 0, 0, 0]"
3375,2,2,4,0.34605522634021024,"[0, 1, 0, 1, 1, 1, 0, 1, 1, 1]"
3376,8,8,16,0.5343193009452079,"[0, 0, 1, 1, 1, 0, 0, 1, 1, 0]"
3377,3,3,6,0.9877526787405628,"[0, 0, 0, 0, 0, 1, 1, 1, 1, 1]"
3378,1,1,2,0.5125142951499682,"[0, 0, 1, 0, 0, 1, 0, 0, 0, 1]"
3379,1,1,2,0.12813002890041247,"[0, 0, 1, 1, 1, 0, 1, 1, 1, 0]"
3380,2,2,4,0.7887943677681967,"[1, 1, 0, 0, 1, 0, 1, 0, 1, 0]"
3381,2,2,4,0.028330812049103482,"[0, 1, 0, 0, 1, 1, 0, 1, 0, 0]"
3382,2,2,4,0.6858913406744052,"[0, 0, 1, 0, 0, 0, 0, 1, 0, 0]"
3383,3,3,6,0.0757142975484244,"[0, 0, 1, 0, 1, 1, 0, 0, 0, 1]"
3384,2,2,4,0.8329214457754033,"[0, 0, 0, 1, 0, 1, 0, 1, 1, 1]"
3385,1,1,2,0.7063626410162182,"[0, 0, 1, 0, 0, 1, 1, 0, 0, 0]"
3386,7,7,14,0.6922577179211854,"[1, 1, 1, 1, 1, 0, 1, 1, 1, 1]"
3387,3,3,6,0.06790761693303793,"[1, 0, 1, 1, 1, 1, 1, 0, 1, 0]"
3388,2,2,4,0.8421065661114089,"[1, 0, 1, 1, 0, 0, 0, 1, 1, 1]"
3389,3,3,6,0.28293208098647193,"[1, 1, 0, 1, 0, 1, 0, 1, 1, 1]"
3390,2,2,4,0.5693668161485093,"[1, 0, 1, 1, 1, 1, 0, 1, 1, 1]"
3391,4,4,8,0.7469372191615458,"[0, 0, 0, 1, 1, 0, 1, 1, 0, 0]"
3392,1,1,2,0.4403098229636887,"[0, 0, 1, 1, 1, 0, 1, 1, 0, 0]"
3393,3,3,6,0.35625290746923566,"[0, 0, 1, 0, 1, 1, 0, 0, 0, 0]"
3394,1,1,2,0.8026752159531805,"[1, 0, 1, 0, 0, 1, 0, 0, 0, 1]"
3395,2,2,4,0.5660669984696128,"[0, 0, 1, 1, 0, 0, 0, 1, 0, 1]"
3396,1,1,2,0.3333015247654687,"[0, 1, 0, 0, 0, 0, 1, 0, 0, 0]"
3397,3,3,6,0.9053425853821003,"[0, 0, 1, 1, 0, 0, 0, 1, 0, 0]"
3398,1,1,2,0.20584991299229716,"[1, 1, 0, 0, 1, 1, 0, 0, 0, 1]"
3399,1,1,2,0.8912975197287918,"[1, 0, 1, 0, 0, 0, 1, 0, 0, 1]"
3400,1,1,2,0.38500337982276334,"[1, 1, 0, 1, 0, 1, 0, 1, 1, 0]"
3401,8,8,16,0.9870487569808004,"[1, 1, 0, 0, 1, 1, 0, 1, 1, 1]"
3402,4,4,8,0.47920133624645145,"[0, 0, 1, 1, 1, 0, 1, 1, 0, 1]"
3403,7,7,14,0.3800047382301669,"[1, 1, 0, 1, 0, 1, 1, 0, 0, 1]"
3404,1,1,2,0.4188378352897829,"[1, 0, 1, 0, 1, 0, 1, 0, 1, 1]"
3405,3,3,6,0.5400488487508742,"[1, 1, 0, 0, 0, 0, 0, 1, 0, 0]"
3406,3,3,6,0.4074805678498997,"[1, 1, 1, 0, 1, 0, 1, 1, 0, 0]"
3407,3,3,6,0.5222867410905132,"[0, 1, 1, 1, 0, 0, 0, 1, 0, 1]"
3408,3,3,6,0.5168373838714888,"[0, 0, 0, 0, 1, 1, 1, 0, 1, 1]"
3409,1,1,2,0.6918359307155656,"[0, 0, 1, 1, 1, 1, 0, 1, 1, 0]"
3410,1,1,2,0.8221888034660962,"[0, 0, 1, 1, 1, 0, 0, 0, 0, 0]"
3411,1,1,2,0.9726523096800703,"[0, 0, 0, 0, 0, 0, 1, 0, 1, 1]"
3412,3,3,6,0.9239483696437034,"[1, 1, 0, 0, 1, 1, 0, 1, 1, 1]"
3413,1,1,2,0.600910266094105,"[0, 0, 1, 0, 0, 0, 0, 1, 1, 0]"
3414,1,1,2,0.3501689788134744,"[0, 1, 0, 0, 1, 0, 1, 0, 1, 0]"
3415,1,1,2,0.7725890553484054,"[1, 1, 1, 1, 1, 1, 1, 0, 1, 1]"
3416,4,4,8,0.7084955830893245,"[0, 1, 1, 0, 1, 1, 0, 1, 0, 1]"
3417,3,3,6,0.7831739594160596,"[1, 0, 0, 0, 0, 0, 0, 0, 0, 0]"
3418,6,6,12,0.15881761158884888,"[1, 1, 1, 1, 1, 1, 1, 1, 0, 0]"
3419,2,2,4,0.23952690190615633,"[1, 0, 0, 0, 1, 0, 0, 1, 0, 0]"
3420,3,3,6,0.1485900576966953,"[0, 1, 1, 0, 1, 1, 0, 1, 1, 1]"
3421,1,1,2,0.04839141498461175,"[0, 0, 1, 0, 0, 0, 1, 0, 1, 0]"
3422,1,1,2,0.5906122469374514,"[1, 1, 0, 0, 0, 1, 1, 1, 0, 0]"
3423,2,2,4,0.3647898557568302,"[0, 1, 1, 1, 0, 1, 0, 1, 1, 1]"
3424,4,4,8,0.5392000199532379,"[0, 1, 0, 1, 1, 1, 1, 0, 1, 1]"
3425,3,3,6,0.6706940024705583,"[1, 0, 0, 0, 0, 1, 0, 0, 1, 1]"
3426,2,2,4,0.008528897161616422,"[1, 0, 1, 0, 1, 0, 1, 0, 1, 0]"
3427,2,2,4,0.15542915541732671,"[0, 1, 0, 0, 0, 0, 0, 1, 0, 1]"
3428,2,2,4,0.7011747868573514,"[0, 0, 1, 0, 0, 0, 1, 1, 1, 1]"
3429,1,1,2,0.8633207401808664,"[1, 1, 0, 0, 0, 0, 0, 1, 1, 0]"
3430,2,2,4,0.49719081807079757,"[0, 0, 1, 0, 1, 0, 0, 0, 1, 1]"
3431,3,3,6,0.46967609541177635,"[1, 0, 0, 1, 1, 0, 0, 0, 0, 1]"
3432,2,2,4,0.08868159873603598,"[1, 0, 1, 0, 1, 1, 0, 1, 1, 0]"
3433,2,2,4,0.6150457276337734,"[0, 1, 0, 1, 0, 0, 0, 0, 0, 1]"
3434,1,1,2,0.7728370386600643,"[0, 0, 0, 0, 0, 1, 0, 0, 1, 1]"
3435,1,1,2,0.9324936712553307,"[1, 0, 0, 1, 1, 1, 1, 1, 1, 1]"
3436,1,1,2,0.7765561714761392,"[0, 0, 1, 0, 1, 0, 1, 0, 0, 1]"
3437,6,6,12,0.6794549221846573,"[1, 0, 0, 1, 1, 1, 1, 1, 0, 0]"
3438,2,2,4,0.6372630111631475,"[0, 1, 0, 0, 1, 1, 1, 1, 1, 0]"
3439,1,1,2,0.07300400362639503,"[0, 1, 0, 1, 1, 1, 0, 0, 1, 1]"
3440,1,1,2,0.47549469580478987,"[0, 0, 0, 1, 1, 1, 0, 0, 0, 1]"
3441,3,3,6,0.6553461958077107,"[1, 1, 0, 1, 0, 0, 1, 1, 1, 1]"
3442,1,1,2,0.5874498141923428,"[0, 1, 0, 1, 0, 0, 0, 0, 0, 0]"
3443,4,4,8,0.5215320001747821,"[1, 1, 0, 1, 1, 1, 0, 0, 0, 1]"
3444,2,2,4,0.662814018166635,"[1, 1, 1, 0, 1, 0, 0, 0, 0, 1]"
3445,1,1,2,0.7682306130329241,"[0, 0, 0, 1, 0, 0, 1, 1, 0, 0]"
3446,1,1,2,0.8432684020637156,"[0, 0, 1, 1, 0, 0, 0, 0, 0, 0]"
3447,1,1,2,0.31349751870507214,"[1, 0, 0, 0, 0, 0, 1, 0, 0, 0]"
3448,1,1,2,0.30084412712612296,"[0, 0, 1, 1, 1, 0, 1, 0, 0, 0]"
3449,1,1,2,0.4098490924507294,"[1, 0, 1, 1, 0, 0, 0, 0, 0, 0]"
3450,7,7,14,0.5040906011967097,"[1, 1, 0, 1, 0, 1, 1, 0, 1, 0]"
3451,1,1,2,0.7320230743603084,"[0, 1, 1, 1, 0, 0, 1, 1, 1, 0]"
3452,10,10,20,0.297048511263447,"[1, 1, 1, 1, 0, 1, 0, 1, 0, 0]"
3453,1,1,2,0.5040020610993557,"[0, 1, 0, 0, 0, 0, 1, 0, 1, 0]"
3454,1,1,2,0.6993047824582929,"[1, 0, 1, 0, 0, 0, 0, 1, 0, 0]"
3455,1,1,2,0.5265649419537812,"[0, 0, 0, 0, 1, 0, 1, 0, 0, 0]"
3456,10,10,20,0.328567901679244,"[0, 1, 1, 1, 1, 1, 0, 1, 1, 0]"
3457,3,3,6,0.4780106664797623,"[0, 1, 1, 0, 0, 0, 0, 0, 1, 0]"
3458,2,2,4,0.7850305636262062,"[1, 1, 0, 1, 0, 0, 0, 1, 1, 0]"
3459,1,1,2,0.5517320828211741,"[0, 0, 0, 1, 0, 1, 0, 1, 1, 0]"
3460,1,1,2,0.9172667237811901,"[1, 1, 0, 0, 1, 1, 1, 0, 0, 1]"
3461,1,1,2,0.6335859241711722,"[1, 0, 1, 1, 1, 1, 0, 1, 1, 0]"
3462,2,2,4,0.5821561028816642,"[1, 0, 1, 1, 0, 0, 1, 1, 0, 1]"
3463,2,2,4,0.29007012943557686,"[0, 1, 1, 0, 0, 1, 1, 1, 0, 0]"
3464,3,3,6,0.8003611638138441,"[1, 1, 1, 0, 1, 1, 1, 1, 0, 0]"
3465,1,1,2,0.1364861371609214,"[0, 0, 1, 0, 0, 0, 0, 0, 0, 1]"
3466,1,1,2,0.7167516659668509,"[0, 0, 1, 1, 1, 1, 1, 1, 1, 1]"
3467,1,1,2,0.8534621742962281,"[1, 1, 0, 0, 1, 1, 0, 1, 1, 0]"
3468,3,3,6,0.47751053694082335,"[1, 1, 0, 1, 0, 0, 1, 1, 1, 0]"
3469,1,1,2,0.8102031765737977,"[0, 0, 1, 0, 1, 1, 0, 1, 1, 0]"
3470,2,2,4,0.825474481321167,"[0, 1, 0, 0, 0, 1, 0, 0, 0, 0]"
3471,2,2,4,0.2277531710287456,"[0, 1, 1, 0, 1, 0, 0, 0, 1, 1]"
3472,1,1,2,0.7187762055073182,"[0, 0, 1, 1, 1, 0, 0, 0, 0, 0]"
3473,5,5,10,0.7336010481430265,"[0, 0, 1, 1, 1, 1, 1, 0, 1, 1]"
3474,10,10,20,0.42207419489062625,"[1, 0, 1, 1, 1, 1, 0, 0, 1, 1]"
3475,1,1,2,0.3970085284180065,"[1, 1, 1, 0, 1, 0, 1, 1, 0, 0]"
3476,4,4,8,0.8694733321213034,"[0, 0, 0, 1, 0, 0, 1, 0, 1, 1]"
3477,2,2,4,0.18375892430360363,"[0, 0, 1, 1, 1, 1, 0, 1, 1, 0]"
3478,3,3,6,0.8863347702907945,"[1, 0, 1, 0, 0, 1, 0, 1, 1, 0]"
3479,1,1,2,0.05158480898835549,"[0, 0, 0, 0, 0, 0, 0, 1, 0, 0]"
3480,4,4,8,0.23287436869329403,"[0, 0, 0, 0, 1, 0, 1, 1, 0, 1]"
3481,8,8,16,0.3132047758032094,"[1, 1, 0, 1, 0, 1, 0, 1, 1, 1]"
3482,2,2,4,0.24958282378933283,"[1, 0, 0, 1, 1, 0, 1, 1, 1, 1]"
3483,2,2,4,0.3358997048816611,"[0, 1, 1, 0, 1, 1, 0, 1, 1, 1]"
3484,4,4,8,0.9357358804156605,"[0, 0, 1, 1, 1, 1, 1, 0, 0, 1]"
3485,2,2,4,0.07962844399911728,"[1, 1, 0, 0, 1, 0, 0, 0, 1, 1]"
3486,1,1,2,0.13809419784506327,"[1, 0, 1, 1, 1, 1, 1, 0, 1, 1]"
3487,1,1,2,0.9593371234180567,"[1, 0, 0, 0, 1, 1, 1, 0, 1, 1]"
3488,5,5,10,0.22821874232583372,"[1, 1, 1, 0, 0, 0, 0, 1, 1, 1]"
3489,2,2,4,0.030857312110276203,"[0, 0, 1, 1, 0, 0, 0, 1, 1, 0]"
3490,3,3,6,0.33476508368725133,"[1, 1, 0, 1, 0, 0, 1, 1, 1, 1]"
3491,2,2,4,0.8764112095811553,"[0, 1, 1, 0, 0, 1, 1, 0, 1, 0]"
3492,1,1,2,0.9855479746967583,"[0, 0, 1, 1, 0, 1, 0, 1, 0, 0]"
3493,1,1,2,0.0637916032961724,"[0, 1, 1, 0, 0, 0, 1, 1, 1, 1]"
3494,1,1,2,0.19182203408051612,"[0, 0, 0, 0, 0, 0, 0, 1, 1, 1]"
3495,1,1,2,0.4144876963283274,"[0, 0, 0, 0, 0, 1, 1, 0, 0, 0]"
3496,1,1,2,0.5531736524555472,"[1, 0, 0, 0, 0, 1, 1, 0, 1, 1]"
3497,3,3,6,0.8271909940613099,"[1, 0, 0, 1, 1, 1, 1, 1, 0, 1]"
3498,2,2,4,0.4046239406049418,"[1, 0, 1, 1, 0, 1, 0, 0, 0, 0]"
3499,2,2,4,0.09132981195241285,"[0, 1, 1, 1, 1, 1, 0, 0, 0, 0]"
3500,3,3,6,0.04534359495607709,"[0, 1, 0, 0, 0, 0, 1, 0, 0, 1]"
3501,4,4,8,0.8522679830537315,"[1, 1, 1, 0, 1, 0, 0, 1, 0, 1]"
3502,1,1,2,0.6985242161572928,"[0, 0, 1, 1, 0, 0, 1, 0, 1, 0]"
3503,5,5,10,0.961081415858955,"[1, 0, 1, 1, 1, 1, 0, 0, 1, 0]"
3504,3,3,6,0.07744530923129112,"[1, 0, 1, 1, 1, 1, 1, 0, 0, 1]"
3505,1,1,2,0.47957646400622134,"[1, 0, 0, 1, 0, 1, 0, 1, 0, 1]"
3506,2,2,4,0.6171957230158199,"[0, 1, 1, 0, 0, 1, 0, 1, 1, 1]"
3507,1,1,2,0.9592915463227412,"[1, 0, 0, 1, 1, 0, 1, 1, 1, 0]"
3508,4,4,8,0.5474878740905228,"[1, 1, 0, 0, 1, 0, 1, 1, 0, 0]"
3509,1,1,2,0.05242354594217424,"[0, 0, 0, 0, 0, 0, 0, 0, 1, 0]"
3510,2,2,4,0.6507022070300437,"[1, 1, 0, 0, 0, 0, 1, 1, 1, 0]"
3511,1,1,2,0.4673066258498749,"[0, 0, 1, 1, 1, 1, 1, 0, 0, 1]"
3512,1,1,2,0.9613259411052449,"[1, 1, 1, 1, 1, 0, 1, 1, 0, 0]"
3513,1,1,2,0.2690891768250663,"[1, 0, 0, 0, 0, 0, 1, 1, 0, 1]"
3514,1,1,2,0.3989846312050662,"[0, 1, 1, 0, 1, 0, 0, 1, 0, 1]"
3515,1,1,2,0.8500205350366788,"[1, 1, 0, 0, 0, 0, 0, 0, 0, 0]"
3516,1,1,2,0.006921884848248405,"[0, 0, 0, 1, 0, 0, 0, 0, 1, 1]"
3517,2,2,4,0.5224069337946013,"[1, 0, 1, 1, 0, 0, 1, 1, 1, 0]"
3518,2,2,4,0.6534403010996167,"[1, 0, 0, 0, 1, 1, 0, 1, 1, 0]"
3519,2,2,4,0.3720697883033781,"[0, 1, 0, 0, 1, 1, 0, 1, 1, 0]"
3520,3,3,6,0.45106058776597846,"[0, 0, 1, 0, 1, 1, 0, 0, 0, 1]"
3521,1,1,2,0.605546553930387,"[0, 0, 1, 1, 0, 0, 0, 0, 1, 0]"
3522,1,1,2,0.5435758275634406,"[0, 1, 0, 0, 1, 1, 1, 1, 1, 1]"
3523,4,4,8,0.400432753461208,"[0, 0, 1, 1, 1, 0, 0, 1, 0, 0]"
3524,1,1,2,0.5412349764958123,"[1, 0, 0, 1, 1, 1, 0, 1, 0, 1]"
3525,2,2,4,0.5082445829389408,"[1, 1, 0, 1, 1, 1, 0, 0, 1, 0]"
3526,3,3,6,0.01362004000794692,"[0, 0, 0, 0, 1, 0, 0, 1, 1, 0]"
3527,3,3,6,0.015560987486939681,"[1, 0, 1, 0, 0, 1, 1, 1, 0, 0]"
3528,1,1,2,0.7512486001495362,"[0, 1, 0, 0, 0, 0, 1, 0, 1, 0]"
3529,1,1,2,0.27803191714218656,"[1, 1, 1, 1, 1, 0, 1, 0, 0, 1]"
3530,1,1,2,0.5469675898065425,"[1, 1, 0, 0, 0, 0, 0, 0, 1, 0]"
3531,1,1,2,0.7969151122662167,"[1, 0, 0, 1, 0, 1, 1, 1, 1, 0]"
3532,4,4,8,0.867449787120812,"[1, 0, 0, 1, 0, 0, 1, 0, 0, 1]"
3533,2,2,4,0.34837553471956195,"[0, 1, 0, 1, 1, 0, 0, 0, 0, 1]"
3534,4,4,8,0.4666685840960415,"[0, 0, 1, 1, 1, 1, 1, 1, 1, 0]"
3535,2,2,4,0.353654445924798,"[0, 1, 1, 0, 0, 0, 0, 0, 1, 0]"
3536,2,2,4,0.15752924030349158,"[0, 0, 1, 0, 1, 0, 0, 1, 0, 0]"
3537,4,4,8,0.6720265038623637,"[1, 1, 1, 1, 1, 0, 0, 0, 1, 1]"
3538,2,2,4,0.8030227131674104,"[0, 1, 1, 1, 1, 1, 1, 1, 1, 1]"
3539,1,1,2,0.8611320428652336,"[0, 1, 0, 1, 1, 0, 1, 1, 1, 1]"
3540,1,1,2,0.5054581934279994,"[0, 0, 1, 1, 0, 1, 1, 0, 0, 1]"
3541,2,2,4,0.9567656710939656,"[1, 1, 0, 1, 0, 0, 0, 1, 1, 0]"
3542,7,7,14,0.977673791993871,"[0, 1, 0, 1, 1, 1, 0, 1, 1, 0]"
3543,1,1,2,0.9299452400121336,"[1, 0, 0, 0, 1, 0, 1, 1, 0, 1]"
3544,1,1,2,0.6129988387968112,"[1, 0, 1, 0, 1, 0, 0, 0, 0, 0]"
3545,1,1,2,0.5027751485902896,"[1, 0, 1, 0, 0, 0, 0, 1, 1, 0]"
3546,4,4,8,0.9378137248610413,"[1, 1, 1, 0, 1, 0, 1, 1, 1, 0]"
3547,9,9,18,0.9468209632709917,"[0, 1, 0, 1, 1, 0, 1, 1, 1, 0]"
3548,1,1,2,0.5633202413985222,"[1, 0, 0, 0, 1, 0, 1, 0, 1, 0]"
3549,1,1,2,0.9496384849329934,"[1, 0, 1, 0, 0, 1, 1, 1, 0, 0]"
3550,1,1,2,0.26341469679456164,"[1, 1, 0, 0, 0, 0, 0, 0, 1, 0]"
3551,1,1,2,0.3517243659041287,"[0, 1, 0, 1, 0, 1, 1, 0, 1, 0]"
3552,3,3,6,0.020120420898561697,"[0, 1, 1, 0, 0, 1, 0, 1, 0, 1]"
3553,1,1,2,0.5968243490292419,"[0, 0, 1, 1, 0, 1, 1, 0, 1, 0]"
3554,2,2,4,0.45556415992282884,"[0, 0, 1, 1, 1, 0, 0, 1, 1, 0]"
3555,4,4,8,0.10703099711131803,"[0, 1, 0, 1, 1, 1, 1, 0, 1, 1]"
3556,1,1,2,0.9250678114408885,"[0, 1, 1, 0, 1, 1, 1, 0, 0, 0]"
3557,3,3,6,0.40301363105167887,"[1, 1, 0, 1, 0, 0, 1, 1, 0, 1]"
3558,9,9,18,0.8313623275110639,"[1, 0, 0, 0, 0, 1, 0, 1, 1, 0]"
3559,1,1,2,0.7468750234806089,"[0, 0, 0, 1, 1, 1, 0, 0, 1, 0]"
3560,2,2,4,0.3299639431735816,"[0, 0, 1, 0, 1, 1, 1, 1, 0, 1]"
3561,1,1,2,0.6883304834832591,"[0, 1, 0, 1, 1, 0, 0, 0, 1, 1]"
3562,3,3,6,0.46527003185026394,"[1, 1, 0, 1, 0, 0, 1, 1, 1, 1]"
3563,1,1,2,0.6109323371339169,"[0, 1, 0, 1, 0, 1, 0, 1, 0, 0]"
3564,1,1,2,0.4060803516379563,"[0, 1, 0, 0, 0, 0, 0, 0, 0, 1]"
3565,3,3,6,0.7361886377737362,"[1, 1, 1, 1, 1, 0, 0, 1, 0, 0]"
3566,2,2,4,0.5893100953910209,"[1, 1, 1, 1, 0, 1, 1, 0, 1, 1]"
3567,4,4,8,0.9649879362796376,"[0, 0, 0, 1, 0, 1, 0, 1, 1, 1]"
3568,3,3,6,0.5056007074827878,"[1, 1, 0, 0, 0, 0, 1, 0, 1, 1]"
3569,2,2,4,0.8727971071753428,"[1, 0, 1, 1, 1, 1, 0, 1, 0, 0]"
3570,1,1,2,0.3296630293555932,"[0, 1, 1, 0, 0, 0, 1, 0, 0, 1]"
3571,6,6,12,0.6653217597378008,"[1, 1, 1, 1, 0, 0, 0, 1, 1, 1]"
3572,3,3,6,0.8261136512412243,"[0, 1, 1, 0, 0, 1, 0, 0, 1, 0]"
3573,1,1,2,0.6056171749569473,"[1, 1, 1, 0, 1, 1, 1, 0, 0, 0]"
3574,2,2,4,0.9079579739546598,"[1, 0, 1, 1, 1, 0, 0, 1, 1, 0]"
3575,5,5,10,0.39540171066857377,"[0, 0, 0, 1, 1, 0, 1, 1, 1, 1]"
3576,2,2,4,0.8486057385676452,"[0, 0, 1, 0, 0, 1, 0, 1, 1, 1]"
3577,1,1,2,0.49593119076827863,"[1, 1, 0, 0, 1, 1, 0, 0, 0, 1]"
3578,7,7,14,0.36402320773103247,"[1, 0, 1, 1, 0, 1, 1, 0, 0, 0]"
3579,1,1,2,0.1935578582985663,"[1, 1, 0, 0, 0, 1, 0, 0, 0, 0]"
3580,1,1,2,0.41370944453872416,"[1, 0, 0, 1, 1, 1, 1, 0, 1, 0]"
3581,2,2,4,0.1743408936757712,"[1, 0, 1, 0, 0, 1, 0, 0, 1, 0]"
3582,3,3,6,0.8154724964075393,"[1, 0, 0, 0, 0, 1, 0, 1, 1, 1]"
3583,1,1,2,0.47499848841237,"[0, 1, 1, 1, 1, 1, 0, 0, 0, 0]"
3584,1,1,2,0.3314453497404187,"[0, 0, 0, 0, 0, 1, 1, 1, 0, 1]"
3585,1,1,2,0.35678995923277723,"[1, 0, 1, 0, 0, 1, 1, 0, 1, 1]"
3586,1,1,2,0.4587543817326626,"[1, 0, 1, 1, 1, 1, 1, 0, 1, 1]"
3587,1,1,2,0.22599703314296338,"[1, 0, 1, 0, 1, 0, 0, 0, 0, 0]"
3588,1,1,2,0.03719485735400685,"[1, 0, 0, 1, 0, 1, 1, 0, 0, 1]"
3589,1,1,2,0.4413712474852173,"[0, 1, 0, 0, 1, 1, 0, 0, 1, 0]"
3590,4,4,8,0.7801431270530341,"[1, 1, 0, 1, 1, 0, 1, 0, 0, 1]"
3591,4,4,8,0.2543359451928745,"[0, 0, 0, 0, 1, 0, 0, 1, 0, 1]"
3592,7,7,14,0.39614283561418995,"[0, 1, 1, 1, 0, 1, 0, 1, 1, 0]"
3593,2,2,4,0.2691505496027742,"[1, 1, 1, 0, 0, 0, 0, 0, 1, 0]"
3594,5,5,10,0.12334089917314117,"[1, 1, 0, 1, 0, 1, 1, 0, 1, 1]"
3595,3,3,6,0.06099562966900296,"[0, 1, 1, 0, 1, 0, 0, 1, 1, 0]"
3596,9,9,18,0.8958313048563243,"[0, 1, 1, 1, 0, 0, 0, 1, 1, 1]"
3597,1,1,2,0.5085255177780226,"[1, 0, 1, 1, 1, 0, 0, 0, 0, 0]"
3598,5,5,10,0.48332600224196454,"[1, 1, 0, 0, 0, 0, 1, 1, 0, 1]"
3599,1,1,2,0.06777005190126717,"[0, 1, 1, 0, 1, 1, 1, 0, 1, 0]"
3600,1,1,2,0.6931114434534278,"[0, 1, 0, 0, 0, 1, 1, 1, 0, 1]"
3601,2,2,4,0.8527005065115218,"[1, 0, 1, 0, 1, 0, 1, 1, 1, 0]"
3602,3,3,6,0.5001324960841194,"[1, 1, 1, 1, 1, 0, 1, 1, 0, 0]"
3603,2,2,4,0.13358974347870478,"[0, 1, 0, 1, 1, 1, 1, 1, 1, 0]"
3604,1,1,2,0.3800534895184612,"[0, 0, 0, 1, 0, 0, 1, 0, 1, 0]"
3605,1,1,2,0.09013840231159109,"[1, 0, 0, 1, 1, 1, 0, 0, 0, 1]"
3606,3,3,6,0.18623735735405922,"[1, 0, 1, 1, 1, 1, 0, 1, 1, 1]"
3607,1,1,2,0.04495594536786973,"[1, 1, 1, 0, 1, 0, 1, 1, 0, 1]"
3608,2,2,4,0.10066291064707533,"[1, 0, 0, 0, 0, 0, 1, 1, 1, 1]"
3609,3,3,6,0.4359301432675634,"[1, 1, 1, 1, 0, 1, 0, 1, 0, 0]"
3610,1,1,2,0.9058206143871665,"[1, 1, 1, 1, 1, 0, 0, 1, 0, 0]"
3611,1,1,2,0.8052424073201249,"[1, 1, 1, 0, 0, 0, 0, 0, 0, 0]"
3612,5,5,10,0.3238030176995643,"[1, 1, 1, 0, 1, 1, 0, 0, 1, 0]"
3613,1,1,2,0.5025667730528016,"[0, 0, 0, 0, 1, 1, 0, 1, 0, 0]"
3614,1,1,2,0.732436452183493,"[1, 1, 1, 0, 0, 0, 1, 0, 0, 0]"
3615,1,1,2,0.775898583708452,"[1, 1, 0, 1, 1, 1, 1, 0, 0, 1]"
3616,3,3,6,0.8554226854497278,"[0, 1, 0, 0, 0, 1, 0, 0, 0, 1]"
3617,1,1,2,0.6839218649542925,"[0, 1, 0, 0, 0, 0, 0, 0, 0, 1]"
3618,2,2,4,0.19510340242650204,"[0, 1, 0, 0, 0, 1, 1, 0, 1, 1]"
3619,2,2,4,0.9570224272598938,"[0, 0, 1, 0, 1, 1, 1, 1, 1, 0]"
3620,1,1,2,0.4059017035240433,"[0, 1, 0, 1, 0, 0, 1, 1, 1, 0]"
3621,2,2,4,0.2683241652623598,"[1, 0, 1, 0, 0, 0, 0, 1, 1, 1]"
3622,3,3,6,0.8873571507907951,"[1, 0, 1, 1, 1, 0, 0, 1, 1, 1]"
3623,2,2,4,0.5621406667388269,"[1, 1, 0, 0, 1, 1, 0, 0, 0, 0]"
3624,1,1,2,0.5633696060387154,"[0, 1, 0, 1, 0, 0, 1, 1, 0, 0]"
3625,1,1,2,0.6125117244087682,"[1, 1, 0, 1, 1, 0, 1, 1, 1, 0]"
3626,1,1,2,0.18618866376524135,"[0, 0, 1, 1, 1, 0, 0, 0, 1, 1]"
3627,2,2,4,0.5356284527595615,"[0, 1, 0, 0, 0, 0, 1, 1, 0, 0]"
3628,1,1,2,0.84633216524462,"[0, 0, 0, 1, 1, 1, 1, 1, 1, 1]"
3629,1,1,2,0.11175123153621003,"[1, 1, 1, 0, 1, 0, 1, 1, 1, 0]"
3630,3,3,6,0.7475887537717304,"[0, 0, 1, 1, 0, 1, 0, 0, 0, 0]"
3631,1,1,2,0.9810627824347615,"[1, 1, 0, 1, 0, 0, 1, 0, 0, 0]"
3632,1,1,2,0.8528921899564514,"[1, 1, 0, 0, 1, 0, 0, 1, 0, 0]"
3633,5,5,10,0.3816492205840212,"[1, 1, 1, 1, 1, 0, 1, 1, 0, 1]"
3634,2,2,4,0.11461194919694917,"[0, 0, 0, 0, 1, 0, 0, 0, 0, 0]"
3635,1,1,2,0.3827550691572573,"[1, 0, 0, 1, 0, 0, 0, 0, 0, 0]"
3636,1,1,2,0.5427739174262322,"[0, 0, 1, 0, 0, 1, 0, 1, 0, 1]"
3637,2,2,4,0.3306964957462457,"[0, 1, 1, 1, 0, 1, 0, 0, 1, 0]"
3638,5,5,10,0.7020352483515593,"[0, 0, 1, 0, 0, 0, 0, 1, 0, 1]"
3639,1,1,2,0.856310502785199,"[0, 0, 1, 1, 1, 0, 0, 1, 1, 0]"
3640,1,1,2,0.5296932104723308,"[1, 0, 1, 0, 0, 0, 0, 0, 1, 1]"
3641,3,3,6,0.4952820310848707,"[0, 0, 1, 0, 1, 1, 0, 1, 0, 1]"
3642,1,1,2,0.23225385312112345,"[0, 1, 1, 0, 1, 0, 1, 1, 1, 1]"
3643,1,1,2,0.18123962572862418,"[0, 1, 0, 0, 0, 0, 0, 1, 1, 0]"
3644,2,2,4,0.1881063048755086,"[1, 0, 1, 0, 1, 0, 0, 0, 0, 0]"
3645,1,1,2,0.9912547580040028,"[0, 0, 0, 1, 0, 0, 1, 1, 0, 0]"
3646,1,1,2,0.5149070842075091,"[1, 0, 0, 1, 0, 1, 0, 0, 1, 0]"
3647,1,1,2,0.3887072061332737,"[0, 1, 1, 0, 0, 1, 0, 1, 0, 1]"
3648,4,4,8,0.9916326701816146,"[1, 0, 0, 1, 1, 1, 0, 0, 0, 0]"
3649,1,1,2,0.4319319819586295,"[1, 0, 0, 0, 1, 1, 0, 0, 0, 0]"
3650,1,1,2,0.56152095317309,"[0, 0, 0, 0, 0, 0, 0, 1, 1, 1]"
3651,3,3,6,0.7331733372702389,"[1, 0, 1, 0, 1, 0, 0, 0, 0, 1]"
3652,2,2,4,0.3230286856131961,"[0, 0, 1, 0, 1, 1, 1, 1, 0, 1]"
3653,1,1,2,0.2324846098317993,"[0, 0, 1, 0, 0, 1, 0, 0, 0, 0]"
3654,2,2,4,0.7653423367769255,"[1, 0, 1, 1, 1, 1, 1, 0, 0, 1]"
3655,1,1,2,0.9305331280583229,"[0, 0, 0, 0, 1, 0, 1, 0, 1, 1]"
3656,2,2,4,0.6895444890450462,"[1, 0, 0, 1, 0, 0, 0, 0, 1, 1]"
3657,2,2,4,0.20417957111142504,"[1, 1, 1, 0, 0, 1, 0, 0, 1, 1]"
3658,4,4,8,0.72325077352307,"[1, 0, 0, 1, 0, 1, 1, 0, 1, 0]"
3659,8,8,16,0.15410386390944997,"[1, 1, 1, 0, 0, 1, 1, 1, 1, 1]"
3660,1,1,2,0.6468861763585547,"[1, 0, 0, 1, 1, 0, 0, 0, 1, 1]"
3661,1,1,2,0.9504948548699652,"[1, 1, 1, 1, 0, 1, 1, 0, 1, 1]"
3662,3,3,6,0.978939733903865,"[1, 1, 0, 0, 0, 0, 1, 0, 1, 1]"
3663,4,4,8,0.10993631811258686,"[1, 1, 1, 1, 0, 1, 1, 1, 1, 1]"
3664,1,1,2,0.07116030934377149,"[1, 1, 1, 0, 1, 1, 1, 0, 1, 1]"
3665,3,3,6,0.5411604809918327,"[0, 0, 0, 1, 1, 0, 0, 1, 0, 1]"
3666,3,3,6,0.7091902453152081,"[1, 1, 1, 0, 1, 1, 0, 1, 0, 1]"
3667,1,1,2,0.4525390616947874,"[0, 1, 1, 1, 1, 0, 1, 1, 1, 0]"
3668,1,1,2,0.17880972261082106,"[0, 0, 0, 0, 1, 1, 0, 0, 1, 1]"
3669,2,2,4,0.24732537568546997,"[1, 0, 1, 0, 1, 0, 1, 1, 0, 1]"
3670,2,2,4,0.3876512779868895,"[1, 0, 1, 0, 0, 0, 0, 1, 0, 0]"
3671,5,5,10,0.4092264478509905,"[0, 1, 0, 0, 0, 1, 1, 0, 1, 1]"
3672,12,12,24,0.6592117353877005,"[1, 1, 0, 1, 1, 0, 1, 0, 0, 1]"
3673,1,1,2,0.9850051067233808,"[0, 1, 1, 1, 1, 0, 0, 1, 0, 1]"
3674,1,1,2,0.047583275280452475,"[1, 1, 0, 1, 0, 0, 0, 0, 0, 0]"
3675,1,1,2,0.6449808904830221,"[0, 0, 0, 0, 0, 0, 1, 1, 1, 0]"
3676,1,1,2,0.16285812693439883,"[0, 1, 0, 1, 1, 0, 0, 1, 1, 0]"
3677,1,1,2,0.6522046574682376,"[0, 1, 0, 0, 0, 1, 1, 1, 1, 0]"
3678,1,1,2,0.9221327595458585,"[1, 0, 1, 0, 1, 0, 1, 0, 1, 0]"
3679,1,1,2,0.28017134234250185,"[1, 0, 1, 1, 0, 0, 0, 0, 0, 1]"
3680,3,3,6,0.6090654830602962,"[0, 1, 1, 1, 0, 1, 0, 1, 1, 1]"
3681,2,2,4,0.11983700897857441,"[1, 1, 1, 1, 1, 1, 1, 1, 0, 1]"
3682,7,7,14,0.2577543200443295,"[1, 1, 1, 1, 1, 0, 0, 1, 1, 1]"
3683,1,1,2,0.20576542573682044,"[0, 0, 0, 0, 1, 1, 0, 1, 0, 1]"
3684,3,3,6,0.3582539101384391,"[1, 0, 1, 0, 1, 0, 0, 0, 0, 0]"
3685,4,4,8,0.20014220782030423,"[1, 1, 1, 0, 0, 1, 1, 0, 0, 0]"
3686,4,4,8,0.45857599297435647,"[1, 1, 0, 0, 0, 1, 1, 1, 1, 0]"
3687,1,1,2,0.7083822609198309,"[0, 0, 0, 0, 0, 0, 1, 0, 0, 1]"
3688,2,2,4,0.9292763566524223,"[0, 1, 0, 0, 0, 0, 0, 1, 1, 0]"
3689,3,3,6,0.23428936158894798,"[0, 1, 0, 1, 0, 1, 1, 0, 0, 0]"
3690,6,6,12,0.7522852055341438,"[1, 1, 0, 0, 0, 1, 1, 1, 1, 1]"
3691,1,1,2,0.848185932465039,"[1, 1, 0, 0, 0, 1, 1, 0, 0, 1]"
3692,1,1,2,0.8302978216049451,"[0, 0, 1, 0, 0, 1, 1, 0, 0, 1]"
3693,1,1,2,0.19785425855951044,"[1, 0, 1, 1, 0, 1, 1, 1, 1, 1]"
3694,2,2,4,0.32756530402552264,"[0, 0, 0, 1, 1, 0, 1, 0, 1, 1]"
3695,1,1,2,0.6450057044018677,"[1, 1, 0, 1, 1, 0, 0, 1, 0, 1]"
3696,3,3,6,0.27629331747101105,"[1, 1, 1, 0, 1, 0, 0, 1, 0, 0]"
3697,2,2,4,0.276688161266162,"[1, 0, 1, 1, 1, 1, 0, 1, 1, 0]"
3698,1,1,2,0.7369253591948891,"[0, 0, 1, 1, 0, 0, 1, 0, 1, 0]"
3699,1,1,2,0.6592252339790348,"[0, 1, 0, 0, 0, 1, 0, 1, 0, 0]"
3700,4,4,8,0.9482796641123434,"[1, 0, 1, 1, 1, 1, 1, 1, 0, 0]"
3701,1,1,2,0.8858207991906053,"[0, 1, 0, 1, 1, 0, 0, 1, 1, 0]"
3702,2,2,4,0.09089810766690842,"[1, 0, 1, 1, 1, 1, 0, 0, 0, 0]"
3703,4,4,8,0.8421287218481698,"[1, 1, 0, 1, 1, 0, 1, 1, 0, 1]"
3704,5,5,10,0.1892758200816158,"[0, 1, 0, 0, 1, 1, 1, 1, 1, 1]"
3705,3,3,6,0.5607109541679388,"[1, 1, 0, 0, 0, 1, 1, 0, 1, 1]"
3706,1,1,2,0.7274152018474878,"[1, 0, 0, 0, 1, 1, 0, 0, 0, 1]"
3707,1,1,2,0.05539213950220778,"[1, 1, 0, 0, 1, 0, 0, 1, 1, 0]"
3708,7,7,14,0.7111774601994193,"[0, 0, 1, 0, 1, 0, 0, 1, 1, 1]"
3709,1,1,2,0.037918902896775686,"[1, 0, 0, 0, 0, 0, 1, 0, 1, 1]"
3710,3,3,6,0.8941949938084008,"[0, 0, 1, 1, 1, 1, 0, 1, 0, 0]"
3711,1,1,2,0.6372530647649013,"[0, 1, 0, 0, 1, 0, 1, 1, 1, 1]"
3712,1,1,2,0.8034287403440906,"[0, 0, 0, 0, 1, 1, 0, 0, 1, 1]"
3713,1,1,2,0.19655206643650558,"[0, 0, 0, 1, 0, 1, 1, 1, 1, 0]"
3714,1,1,2,0.07142065981244694,"[0, 0, 0, 1, 0, 1, 1, 0, 1, 0]"
3715,7,7,14,0.030699610692105694,"[1, 1, 0, 0, 1, 1, 0, 1, 1, 0]"
3716,2,2,4,0.9908428404030843,"[1, 0, 1, 0, 1, 0, 1, 0, 1, 1]"
3717,1,1,2,0.9068089849479523,"[1, 1, 1, 0, 0, 1, 0, 0, 1, 1]"
3718,2,2,4,0.4111237100643399,"[0, 1, 1, 0, 1, 1, 0, 1, 0, 0]"
3719,7,7,14,0.5301418012387186,"[1, 0, 0, 1, 1, 0, 0, 0, 1, 1]"
3720,1,1,2,0.7885342207099737,"[1, 0, 0, 0, 0, 0, 1, 0, 0, 0]"
3721,1,1,2,0.01910882436583583,"[0, 0, 1, 1, 0, 1, 0, 1, 0, 0]"
3722,1,1,2,0.09985060941946111,"[1, 1, 1, 0, 1, 0, 1, 0, 0, 0]"
3723,2,2,4,0.3213035288515599,"[0, 0, 1, 1, 0, 1, 0, 0, 0, 0]"
3724,1,1,2,0.7119901234738393,"[0, 1, 1, 1, 1, 0, 0, 0, 1, 0]"
3725,2,2,4,0.7301241736496842,"[1, 0, 0, 1, 0, 1, 1, 0, 1, 1]"
3726,8,8,16,0.7290054373781827,"[1, 1, 1, 1, 1, 0, 0, 0, 1, 0]"
3727,1,1,2,0.9864778710633554,"[0, 1, 1, 1, 0, 0, 1, 1, 1, 1]"
3728,3,3,6,0.2916345485579511,"[1, 1, 1, 0, 1, 0, 1, 1, 1, 1]"
3729,4,4,8,0.4913436789627257,"[0, 0, 0, 1, 0, 0, 1, 0, 1, 1]"
3730,1,1,2,0.1800808865208674,"[1, 0, 0, 0, 1, 1, 0, 1, 1, 1]"
3731,12,12,24,0.46058590343925276,"[1, 1, 1, 1, 0, 1, 1, 1, 1, 1]"
3732,1,1,2,0.8419869503529955,"[0, 0, 0, 0, 0, 0, 1, 0, 1, 1]"
3733,4,4,8,0.9715043054939222,"[1, 1, 0, 1, 1, 1, 1, 1, 1, 1]"
3734,1,1,2,0.61915047598663,"[0, 1, 1, 1, 0, 1, 0, 0, 1, 1]"
3735,3,3,6,0.9046051286171447,"[1, 0, 1, 0, 1, 1, 1, 0, 0, 0]"
3736,1,1,2,0.8501160232695486,"[1, 1, 0, 1, 1, 0, 1, 0, 1, 0]"
3737,1,1,2,0.1629438795099145,"[1, 1, 0, 0, 0, 0, 1, 0, 1, 0]"
3738,1,1,2,0.8926595522622822,"[0, 0, 1, 1, 0, 1, 1, 0, 0, 1]"
3739,1,1,2,0.8576949057698982,"[1, 1, 1, 0, 1, 0, 0, 0, 1, 1]"
3740,2,2,4,0.3663317524825739,"[0, 1, 0, 1, 0, 1, 0, 1, 1, 0]"
3741,1,1,2,0.8691327698794582,"[1, 1, 1, 0, 0, 1, 0, 1, 1, 0]"
3742,1,1,2,0.9024389596572673,"[0, 1, 0, 0, 0, 0, 1, 1, 0, 0]"
3743,1,1,2,0.4409528701316292,"[0, 1, 1, 0, 1, 1, 1, 0, 0, 0]"
3744,1,1,2,0.5160562724757296,"[1, 1, 0, 0, 0, 0, 0, 1, 0, 1]"
3745,1,1,2,0.08521872513427642,"[1, 1, 0, 0, 0, 0, 1, 1, 1, 0]"
3746,1,1,2,0.9179404754874262,"[0, 0, 1, 0, 0, 0, 1, 1, 1, 1]"
3747,1,1,2,0.2643184251615782,"[0, 0, 0, 1, 1, 0, 0, 0, 1, 0]"
3748,3,3,6,0.7829337057473529,"[1, 1, 0, 0, 1, 1, 1, 1, 0, 0]"
3749,4,4,8,0.4632215222630979,"[0, 0, 0, 1, 1, 0, 1, 0, 1, 1]"
3750,2,2,4,0.27514094025850877,"[0, 0, 0, 0, 0, 1, 0, 0, 1, 0]"
3751,4,4,8,0.31361317911342246,"[1, 1, 1, 1, 1, 0, 1, 0, 0, 0]"
3752,2,2,4,0.9310667430444269,"[0, 1, 1, 1, 0, 0, 1, 0, 0, 0]"
3753,1,1,2,0.8597750929509508,"[0, 1, 0, 0, 0, 0, 0, 1, 1, 1]"
3754,3,3,6,0.159202062655034,"[1, 0, 0, 0, 1, 0, 1, 1, 1, 0]"
3755,1,1,2,0.28367753118290984,"[1, 0, 0, 1, 1, 0, 0, 1, 1, 1]"
3756,2,2,4,0.07155840315406536,"[0, 1, 0, 0, 1, 1, 0, 0, 1, 0]"
3757,3,3,6,0.07180631433843754,"[0, 1, 0, 0, 1, 0, 1, 1, 0, 0]"
3758,1,1,2,0.8787890823685215,"[0, 0, 0, 1, 0, 1, 1, 0, 0, 0]"
3759,1,1,2,0.33514825418004435,"[0, 0, 0, 1, 1, 1, 0, 1, 1, 0]"
3760,1,1,2,0.8379117168273646,"[1, 0, 1, 1, 0, 1, 0, 1, 1, 0]"
3761,2,2,4,0.3150557356519066,"[0, 1, 1, 1, 1, 1, 1, 0, 0, 0]"
3762,3,3,6,0.25989912831628714,"[1, 1, 0, 0, 0, 1, 1, 0, 0, 1]"
3763,2,2,4,0.1578395539304137,"[1, 0, 0, 1, 1, 1, 1, 1, 1, 0]"
3764,3,3,6,0.5049782668113021,"[0, 0, 0, 0, 1, 0, 0, 0, 1, 1]"
3765,1,1,2,0.18468811406694152,"[1, 1, 1, 1, 1, 0, 1, 0, 1, 0]"
3766,2,2,4,0.2054398359186449,"[1, 0, 0, 0, 1, 1, 1, 0, 1, 0]"
3767,1,1,2,0.9927874899461974,"[1, 0, 0, 1, 1, 0, 1, 0, 1, 1]"
3768,1,1,2,0.5051940844067248,"[0, 0, 1, 0, 0, 0, 0, 1, 0, 0]"
3769,2,2,4,0.014429486409824999,"[1, 1, 0, 1, 1, 1, 0, 1, 0, 0]"
3770,5,5,10,0.9027278336656871,"[1, 1, 0, 0, 1, 1, 0, 1, 0, 1]"
3771,2,2,4,0.42384393531316833,"[1, 0, 1, 0, 0, 1, 0, 1, 0, 0]"
3772,1,1,2,0.979700144546283,"[0, 0, 1, 0, 1, 1, 0, 0, 0, 1]"
3773,2,2,4,0.04474927068349421,"[0, 0, 0, 0, 1, 1, 1, 1, 0, 1]"
3774,2,2,4,0.1656904926080548,"[1, 1, 0, 1, 0, 1, 0, 0, 0, 1]"
3775,4,4,8,0.9589220606192583,"[1, 1, 0, 0, 1, 0, 1, 0, 0, 1]"
3776,7,7,14,0.713372565518633,"[1, 1, 0, 1, 1, 0, 1, 1, 1, 1]"
3777,2,2,4,0.6251163243569291,"[0, 1, 1, 1, 0, 1, 1, 1, 1, 0]"
3778,2,2,4,0.4723636435855083,"[1, 0, 1, 1, 0, 1, 1, 0, 1, 0]"
3779,1,1,2,0.8094442296293931,"[1, 1, 0, 1, 0, 0, 0, 1, 0, 1]"
3780,2,2,4,0.4196718496305676,"[1, 1, 1, 1, 1, 0, 0, 0, 1, 0]"
3781,2,2,4,0.23410132197052613,"[0, 0, 1, 0, 0, 1, 0, 1, 1, 1]"
3782,1,1,2,0.890380772781439,"[1, 1, 0, 0, 0, 0, 0, 1, 1, 0]"
3783,1,1,2,0.1558238804278691,"[0, 0, 0, 1, 0, 1, 1, 0, 0, 1]"
3784,1,1,2,0.8053259176425812,"[0, 1, 1, 0, 0, 0, 0, 1, 1, 1]"
3785,1,1,2,0.6275974634499026,"[1, 1, 0, 0, 0, 0, 0, 0, 0, 0]"
3786,3,3,6,0.20579581991498286,"[0, 0, 1, 1, 0, 0, 1, 1, 1, 1]"
3787,1,1,2,0.33440630156837425,"[1, 1, 1, 1, 1, 1, 0, 0, 0, 1]"
3788,1,1,2,0.989795823961492,"[0, 0, 1, 0, 1, 1, 1, 1, 0, 1]"
3789,1,1,2,0.036141992578947124,"[0, 0, 0, 0, 0, 0, 1, 1, 1, 1]"
3790,1,1,2,0.23654271547874062,"[1, 0, 1, 0, 0, 1, 1, 0, 0, 0]"
3791,4,4,8,0.2566495224786477,"[1, 1, 1, 1, 1, 0, 0, 1, 0, 1]"
3792,3,3,6,0.8239311872784575,"[1, 0, 0, 0, 0, 1, 0, 0, 0, 0]"
3793,1,1,2,0.3860628990957701,"[1, 1, 0, 1, 0, 0, 0, 0, 0, 1]"
3794,1,1,2,0.3866391047020088,"[1, 1, 1, 1, 0, 1, 1, 0, 0, 0]"
3795,1,1,2,0.4691528721377801,"[1, 0, 1, 1, 0, 0, 0, 0, 1, 1]"
3796,1,1,2,0.7973285783659136,"[0, 1, 1, 0, 1, 1, 0, 1, 1, 0]"
3797,1,1,2,0.11502647870789329,"[0, 1, 1, 0, 0, 1, 1, 1, 0, 0]"
3798,3,3,6,0.7102277868089901,"[0, 0, 1, 1, 1, 1, 0, 0, 0, 1]"
3799,3,3,6,0.35247681868091907,"[1, 1, 1, 1, 0, 0, 1, 1, 1, 1]"
3800,2,2,4,0.9053152450043542,"[0, 1, 1, 1, 1, 0, 0, 0, 1, 0]"
3801,1,1,2,0.9924667628167007,"[0, 0, 1, 0, 1, 0, 1, 1, 0, 0]"
3802,4,4,8,0.10546361514749847,"[0, 1, 0, 1, 0, 1, 0, 1, 0, 0]"
3803,1,1,2,0.2904234988874147,"[0, 0, 0, 1, 1, 1, 0, 0, 1, 1]"
3804,5,5,10,0.5833427557204095,"[0, 0, 1, 1, 1, 1, 0, 1, 1, 1]"
3805,7,7,14,0.9524965849003142,"[0, 1, 0, 1, 1, 1, 1, 0, 1, 0]"
3806,1,1,2,0.3718476807924782,"[1, 1, 1, 1, 1, 1, 0, 1, 1, 0]"
3807,4,4,8,0.7598176879667092,"[1, 1, 1, 1, 1, 1, 0, 0, 0, 0]"
3808,2,2,4,0.7151894347783027,"[0, 1, 0, 0, 0, 1, 0, 1, 1, 1]"
3809,2,2,4,0.8733452046956083,"[0, 0, 0, 0, 0, 0, 1, 1, 1, 0]"
3810,1,1,2,0.03331157528056328,"[1, 0, 0, 0, 0, 1, 0, 0, 0, 0]"
3811,1,1,2,0.023955871545134233,"[0, 0, 1, 0, 0, 1, 0, 0, 1, 0]"
3812,2,2,4,0.6669196245196313,"[1, 1, 0, 1, 1, 1, 1, 1, 1, 1]"
3813,1,1,2,0.6037190785823716,"[0, 0, 0, 0, 1, 1, 0, 1, 1, 1]"
3814,2,2,4,0.5435545671088676,"[1, 1, 1, 1, 0, 1, 1, 0, 0, 0]"
3815,5,5,10,0.6642816119635293,"[1, 1, 1, 1, 0, 1, 1, 0, 1, 0]"
3816,13,13,26,0.8977207148963643,"[1, 1, 0, 1, 1, 1, 0, 1, 1, 1]"
3817,1,1,2,0.40178193500540305,"[0, 1, 1, 1, 1, 0, 1, 1, 1, 0]"
3818,3,3,6,0.8636227250993825,"[1, 1, 0, 0, 0, 0, 0, 0, 1, 1]"
3819,1,1,2,0.2531159281324299,"[1, 1, 0, 1, 0, 0, 1, 0, 0, 1]"
3820,2,2,4,0.6623208393984065,"[0, 0, 1, 0, 1, 1, 0, 1, 0, 1]"
3821,1,1,2,0.8700975196001869,"[0, 1, 1, 1, 1, 1, 0, 0, 0, 0]"
3822,7,7,14,0.2362769517558807,"[0, 1, 1, 0, 1, 0, 1, 1, 0, 1]"
3823,2,2,4,0.9517281685801764,"[0, 1, 0, 0, 1, 0, 0, 1, 0, 1]"
3824,1,1,2,0.9609128353046981,"[0, 1, 0, 1, 1, 1, 1, 1, 1, 1]"
3825,1,1,2,0.5400876423497615,"[0, 1, 1, 1, 1, 0, 0, 1, 0, 0]"
3826,2,2,4,0.8433911905209537,"[1, 1, 0, 1, 0, 1, 0, 0, 0, 1]"
3827,3,3,6,0.6707115261666785,"[1, 0, 0, 1, 0, 1, 1, 0, 1, 0]"
3828,1,1,2,0.6210846708631043,"[0, 1, 1, 0, 1, 1, 1, 0, 0, 1]"
3829,1,1,2,0.08826595555856898,"[0, 1, 0, 1, 1, 0, 0, 1, 0, 1]"
3830,1,1,2,0.5069506316582638,"[1, 1, 1, 0, 1, 0, 0, 0, 1, 1]"
3831,2,2,4,0.7446927769682696,"[0, 1, 0, 0, 1, 0, 0, 0, 0, 1]"
3832,1,1,2,0.5849745132688169,"[1, 0, 0, 0, 1, 0, 1, 0, 0, 1]"
3833,3,3,6,0.5389898798127036,"[0, 0, 1, 1, 1, 1, 1, 1, 0, 0]"
3834,3,3,6,0.19371137456045406,"[1, 1, 0, 1, 1, 0, 1, 1, 0, 0]"
3835,4,4,8,0.8640438590664735,"[1, 0, 0, 1, 0, 1, 1, 1, 0, 1]"
3836,1,1,2,0.0001840118618852138,"[0, 1, 1, 1, 1, 0, 0, 0, 0, 1]"
3837,1,1,2,0.448734004745996,"[0, 1, 1, 1, 0, 1, 0, 0, 0, 0]"
3838,1,1,2,0.48111631641229324,"[0, 0, 1, 1, 1, 0, 1, 0, 0, 1]"
3839,3,3,6,0.525199416431685,"[0, 1, 1, 0, 1, 0, 1, 1, 0, 1]"
3840,3,3,6,0.5885721745863018,"[1, 0, 0, 1, 1, 0, 1, 0, 1, 1]"
3841,1,1,2,0.5649919023469109,"[1, 0, 0, 1, 0, 0, 0, 1, 0, 0]"
3842,3,3,6,0.2628064351155216,"[1, 1, 0, 0, 1, 0, 0, 0, 1, 1]"
3843,1,1,2,0.18835790023936883,"[0, 0, 1, 0, 0, 0, 0, 1, 0, 0]"
3844,4,4,8,0.44064326887452476,"[1, 1, 1, 1, 0, 0, 0, 1, 0, 1]"
3845,3,3,6,0.3591483279476425,"[1, 0, 1, 0, 1, 0, 0, 1, 1, 0]"
3846,4,4,8,0.46245826249560396,"[0, 1, 0, 1, 0, 1, 0, 1, 0, 1]"
3847,1,1,2,0.19238243227630447,"[1, 0, 1, 0, 0, 0, 0, 1, 1, 0]"
3848,3,3,6,0.962357406048196,"[0, 1, 1, 1, 1, 1, 1, 0, 0, 0]"
3849,2,2,4,0.11470826135546597,"[1, 0, 1, 0, 1, 1, 0, 1, 1, 0]"
3850,1,1,2,0.17830435335132755,"[1, 1, 1, 1, 1, 1, 0, 0, 0, 1]"
3851,4,4,8,0.7999394969579413,"[1, 0, 1, 0, 1, 0, 0, 1, 1, 1]"
3852,1,1,2,0.9173423838008276,"[0, 0, 0, 0, 0, 1, 1, 1, 1, 0]"
3853,2,2,4,0.8078113741372156,"[0, 0, 1, 1, 1, 1, 0, 0, 0, 0]"
3854,1,1,2,0.22507009480812679,"[0, 1, 1, 0, 1, 1, 0, 0, 0, 0]"
3855,1,1,2,0.9243061078842589,"[0, 1, 1, 0, 0, 1, 1, 1, 0, 1]"
3856,1,1,2,0.6435021656295711,"[0, 0, 0, 1, 1, 0, 1, 1, 0, 0]"
3857,1,1,2,0.6619276515768071,"[0, 0, 1, 1, 0, 1, 0, 1, 1, 1]"
3858,3,3,6,0.6633228513763512,"[1, 1, 1, 1, 1, 1, 1, 1, 1, 0]"
3859,1,1,2,0.8748479904378867,"[1, 1, 0, 1, 1, 0, 1, 1, 0, 0]"
3860,3,3,6,0.7797810711589515,"[1, 0, 1, 1, 1, 0, 0, 0, 1, 0]"
3861,2,2,4,0.44239997996529157,"[0, 0, 1, 0, 1, 1, 0, 1, 0, 1]"
3862,2,2,4,0.4721560009859551,"[0, 1, 0, 0, 1, 1, 1, 0, 0, 1]"
3863,4,4,8,0.4845838846201107,"[1, 0, 1, 0, 1, 1, 1, 0, 1, 0]"
3864,1,1,2,0.18387185281269847,"[0, 1, 0, 0, 0, 0, 1, 0, 0, 1]"
3865,3,3,6,0.3516882431502083,"[0, 1, 1, 0, 1, 0, 1, 0, 1, 0]"
3866,1,1,2,0.7605722707608582,"[1, 0, 1, 0, 1, 1, 1, 0, 0, 1]"
3867,2,2,4,0.3148127709579941,"[0, 0, 1, 0, 1, 0, 1, 0, 1, 0]"
3868,4,4,8,0.9838692775275487,"[1, 1, 1, 1, 1, 0, 0, 1, 1, 0]"
3869,5,5,10,0.7745563978061646,"[0, 1, 0, 1, 0, 0, 1, 0, 0, 0]"
3870,2,2,4,0.18200701838548072,"[0, 1, 1, 1, 1, 1, 0, 0, 1, 1]"
3871,1,1,2,0.6970604175355751,"[1, 1, 0, 1, 0, 0, 0, 0, 1, 1]"
3872,1,1,2,0.5702830825456984,"[1, 1, 0, 0, 0, 0, 1, 0, 0, 0]"
3873,2,2,4,0.28636390768737774,"[1, 1, 0, 1, 1, 0, 0, 1, 0, 0]"
3874,1,1,2,0.037843588181078025,"[0, 1, 1, 0, 1, 1, 1, 1, 1, 0]"
3875,7,7,14,0.3724666089003499,"[1, 0, 0, 0, 0, 1, 1, 1, 1, 0]"
3876,1,1,2,0.145469864569845,"[0, 1, 1, 0, 0, 0, 0, 0, 0, 0]"
3877,1,1,2,0.48666345221322915,"[1, 0, 0, 0, 1, 1, 0, 0, 0, 1]"
3878,1,1,2,0.1352629236532129,"[1, 1, 1, 1, 0, 1, 0, 0, 0, 1]"
3879,4,4,8,0.5683645322733671,"[0, 0, 1, 1, 1, 1, 0, 1, 1, 1]"
3880,11,11,22,0.20147963318293205,"[1, 0, 1, 1, 1, 0, 1, 0, 1, 1]"
3881,1,1,2,0.503282494182549,"[0, 0, 0, 1, 1, 1, 1, 0, 0, 1]"
3882,1,1,2,0.5875237779790622,"[0, 1, 1, 0, 1, 0, 0, 1, 1, 1]"
3883,1,1,2,0.2450799629757484,"[1, 1, 1, 0, 1, 0, 1, 1, 1, 1]"
3884,1,1,2,0.11959570476515102,"[0, 0, 0, 0, 0, 1, 0, 1, 1, 1]"
3885,1,1,2,0.15574765542064883,"[0, 1, 0, 1, 1, 0, 1, 1, 0, 0]"
3886,4,4,8,0.22979300173085437,"[0, 1, 1, 0, 1, 1, 1, 0, 0, 1]"
3887,1,1,2,0.6307613700014393,"[0, 1, 1, 1, 1, 1, 0, 0, 1, 0]"
3888,1,1,2,0.776237730702501,"[1, 1, 0, 0, 0, 1, 0, 0, 0, 1]"
3889,2,2,4,0.02018009465104964,"[0, 1, 0, 1, 1, 0, 0, 1, 0, 1]"
3890,1,1,2,0.07887668867903552,"[1, 1, 1, 0, 1, 1, 1, 0, 0, 0]"
3891,1,1,2,0.4381414782065485,"[1, 0, 1, 0, 1, 1, 1, 0, 0, 1]"
3892,1,1,2,0.8867564023626127,"[0, 0, 0, 1, 0, 1, 0, 0, 1, 1]"
3893,1,1,2,0.891764846017219,"[1, 1, 0, 0, 1, 0, 1, 1, 0, 1]"
3894,1,1,2,0.20065276672259957,"[1, 1, 1, 1, 1, 1, 1, 0, 0, 1]"
3895,6,6,12,0.8470984548995194,"[1, 1, 1, 0, 1, 1, 0, 0, 0, 0]"
3896,2,2,4,0.48220705765936656,"[1, 1, 0, 0, 0, 0, 0, 1, 0, 1]"
3897,1,1,2,0.325430519361684,"[0, 0, 0, 1, 0, 0, 1, 0, 0, 0]"
3898,1,1,2,0.9401919327980004,"[0, 0, 1, 1, 0, 1, 0, 1, 0, 0]"
3899,1,1,2,0.8705077858948183,"[0, 1, 0, 1, 1, 1, 1, 0, 1, 0]"
3900,2,2,4,0.09041997617036113,"[0, 0, 1, 1, 0, 0, 0, 1, 1, 0]"
3901,1,1,2,0.6124462604911162,"[0, 1, 0, 1, 0, 1, 0, 0, 0, 1]"
3902,6,6,12,0.035843559481012255,"[0, 1, 1, 1, 0, 0, 1, 0, 1, 0]"
3903,1,1,2,0.2549523257070717,"[1, 0, 1, 0, 1, 0, 0, 1, 1, 0]"
3904,1,1,2,0.08234129931838308,"[0, 1, 0, 0, 1, 1, 1, 0, 0, 0]"
3905,1,1,2,0.10149227454330789,"[0, 0, 1, 0, 1, 0, 0, 1, 0, 0]"
3906,3,3,6,0.7021025631475113,"[1, 1, 0, 1, 1, 0, 0, 0, 0, 0]"
3907,1,1,2,0.4216362556447385,"[1, 0, 1, 0, 0, 1, 1, 1, 1, 1]"
3908,3,3,6,0.06667144986157025,"[0, 1, 0, 1, 0, 1, 0, 0, 0, 0]"
3909,1,1,2,0.7907327920193709,"[1, 0, 1, 0, 1, 0, 0, 0, 0, 1]"
3910,3,3,6,0.7288470327377541,"[1, 0, 0, 1, 0, 0, 1, 1, 0, 0]"
3911,2,2,4,0.8286471163370576,"[0, 1, 1, 0, 1, 1, 0, 0, 1, 1]"
3912,1,1,2,0.9051613287023087,"[0, 0, 1, 0, 0, 1, 0, 0, 0, 0]"
3913,1,1,2,0.5030856673040969,"[0, 0, 1, 1, 1, 0, 0, 0, 0, 1]"
3914,1,1,2,0.4591598231697639,"[0, 0, 1, 1, 1, 1, 1, 1, 1, 0]"
3915,2,2,4,0.9715157499338357,"[0, 0, 1, 0, 0, 0, 0, 0, 1, 1]"
3916,1,1,2,0.3513472470737007,"[0, 0, 1, 1, 1, 0, 0, 0, 1, 0]"
3917,1,1,2,0.7934166493333872,"[0, 1, 0, 1, 0, 0, 1, 1, 0, 0]"
3918,1,1,2,0.43444018427622244,"[0, 1, 1, 0, 1, 0, 0, 0, 0, 0]"
3919,5,5,10,0.15229074186419578,"[1, 1, 1, 1, 0, 0, 0, 0, 1, 0]"
3920,1,1,2,0.7093158717785724,"[0, 0, 1, 1, 1, 1, 1, 0, 1, 0]"
3921,3,3,6,0.9190881139220631,"[1, 0, 1, 1, 1, 0, 0, 1, 1, 0]"
3922,1,1,2,0.9217301124533057,"[0, 1, 1, 0, 1, 1, 1, 1, 1, 0]"
3923,4,4,8,0.40399670890987327,"[0, 0, 0, 0, 0, 0, 1, 0, 1, 1]"
3924,2,2,4,0.4595121621252495,"[0, 1, 0, 1, 0, 0, 1, 0, 0, 1]"
3925,3,3,6,0.866827049171025,"[1, 1, 0, 1, 1, 1, 0, 1, 0, 1]"
3926,2,2,4,0.1489648336674093,"[1, 0, 1, 1, 0, 0, 0, 1, 1, 0]"
3927,7,7,14,0.5438732058226743,"[1, 0, 1, 1, 1, 0, 0, 0, 0, 1]"
3928,3,3,6,0.10094911309493115,"[1, 1, 1, 1, 1, 0, 1, 1, 0, 0]"
3929,1,1,2,0.6398068550890622,"[0, 1, 0, 1, 1, 0, 1, 0, 1, 0]"
3930,2,2,4,0.1123030725945744,"[1, 0, 0, 0, 1, 0, 1, 0, 0, 0]"
3931,1,1,2,0.72292085359512,"[1, 0, 1, 0, 1, 0, 1, 0, 0, 1]"
3932,3,3,6,0.09740771770643186,"[0, 0, 0, 1, 1, 0, 1, 0, 1, 1]"
3933,1,1,2,0.8147055280715746,"[0, 1, 1, 0, 0, 0, 1, 1, 0, 0]"
3934,6,6,12,0.6643072145758296,"[0, 0, 0, 1, 0, 0, 0, 1, 1, 0]"
3935,1,1,2,0.3782221679713953,"[1, 1, 0, 0, 0, 1, 1, 0, 0, 1]"
3936,2,2,4,0.6071710585190341,"[1, 1, 1, 1, 1, 1, 1, 0, 1, 0]"
3937,3,3,6,0.22103200314816296,"[1, 1, 0, 1, 0, 0, 0, 1, 0, 1]"
3938,1,1,2,0.8114733403220526,"[0, 1, 0, 0, 0, 0, 0, 1, 1, 1]"
3939,3,3,6,0.7964982142662422,"[1, 0, 1, 1, 1, 0, 0, 0, 0, 1]"
3940,1,1,2,0.861020424016277,"[1, 0, 1, 1, 1, 0, 0, 0, 0, 1]"
3941,2,2,4,0.9050020922624106,"[0, 0, 1, 1, 0, 1, 1, 1, 0, 0]"
3942,1,1,2,0.7361356554509124,"[0, 1, 0, 1, 0, 1, 1, 0, 0, 0]"
3943,1,1,2,0.37896880124369636,"[1, 1, 1, 0, 1, 0, 0, 0, 1, 0]"
3944,1,1,2,0.33913877810265736,"[1, 1, 1, 0, 0, 1, 0, 0, 1, 1]"
3945,1,1,2,0.0551821517063702,"[0, 0, 1, 0, 0, 1, 1, 0, 1, 0]"
3946,3,3,6,0.15896418119665578,"[0, 0, 1, 1, 1, 0, 0, 1, 0, 1]"
3947,1,1,2,0.8949987632370515,"[1, 1, 0, 0, 0, 1, 0, 0, 0, 0]"
3948,2,2,4,0.5287619198137192,"[0, 1, 1, 1, 1, 1, 0, 0, 0, 1]"
3949,2,2,4,0.6485367390111668,"[0, 1, 0, 1, 1, 1, 0, 0, 1, 0]"
3950,1,1,2,0.9702275446321327,"[1, 0, 1, 1, 1, 0, 1, 0, 0, 1]"
3951,3,3,6,0.8904263225036038,"[0, 1, 0, 1, 1, 0, 0, 0, 1, 1]"
3952,1,1,2,0.7106971873510103,"[1, 1, 0, 0, 0, 1, 1, 1, 1, 0]"
3953,1,1,2,0.8677072452063305,"[1, 0, 0, 0, 1, 1, 1, 0, 1, 0]"
3954,2,2,4,0.4274441617209679,"[1, 1, 1, 0, 1, 0, 1, 0, 1, 0]"
3955,2,2,4,0.5539885194352709,"[0, 0, 1, 1, 1, 0, 1, 0, 1, 1]"
3956,4,4,8,0.46865129824294416,"[0, 1, 0, 1, 0, 1, 1, 0, 1, 1]"
3957,1,1,2,0.3112036355060557,"[0, 0, 0, 0, 1, 0, 0, 1, 0, 0]"
3958,8,8,16,0.20571067635872398,"[1, 1, 1, 0, 1, 0, 1, 0, 1, 1]"
3959,3,3,6,0.963604983282994,"[1, 1, 1, 0, 1, 1, 1, 1, 1, 0]"
3960,1,1,2,0.4587722562140534,"[1, 1, 0, 0, 1, 0, 0, 0, 0, 1]"
3961,5,5,10,0.7241469181299298,"[0, 0, 1, 0, 0, 1, 1, 0, 1, 0]"
3962,2,2,4,0.3596796964982605,"[1, 0, 0, 0, 1, 1, 1, 0, 1, 0]"
3963,3,3,6,0.7059207164286455,"[0, 1, 0, 1, 0, 1, 1, 0, 1, 0]"
3964,1,1,2,0.2166623174425405,"[1, 1, 1, 0, 1, 0, 0, 1, 0, 0]"
3965,3,3,6,0.2726687827675348,"[0, 1, 1, 1, 1, 0, 1, 1, 1, 0]"
3966,2,2,4,0.20250018581099527,"[0, 0, 0, 0, 1, 1, 0, 0, 0, 1]"
3967,1,1,2,0.6002449115454639,"[1, 1, 0, 0, 1, 1, 1, 0, 0, 0]"
3968,2,2,4,0.9626560377680136,"[0, 1, 0, 0, 0, 1, 1, 1, 1, 1]"
3969,2,2,4,0.5125247676687635,"[0, 1, 0, 0, 0, 1, 1, 1, 0, 1]"
3970,4,4,8,0.1832045684813648,"[1, 1, 0, 1, 0, 1, 0, 0, 0, 1]"
3971,3,3,6,0.057622768265867985,"[0, 0, 1, 1, 0, 0, 1, 0, 1, 0]"
3972,1,1,2,0.5340804243231587,"[1, 0, 0, 0, 0, 0, 0, 0, 0, 0]"
3973,5,5,10,0.2124902756033803,"[0, 1, 0, 0, 1, 1, 1, 0, 1, 1]"
3974,1,1,2,0.9228468817624537,"[1, 0, 0, 1, 0, 0, 1, 0, 0, 0]"
3975,1,1,2,0.6318001335116017,"[0, 0, 0, 0, 0, 0, 1, 1, 1, 0]"
3976,2,2,4,0.9242164971497339,"[0, 0, 0, 0, 0, 0, 1, 0, 1, 1]"
3977,4,4,8,0.8871138584987663,"[0, 0, 0, 0, 1, 1, 1, 1, 1, 1]"
3978,2,2,4,0.3645033563111785,"[0, 0, 1, 0, 1, 1, 1, 1, 1, 1]"
3979,1,1,2,0.7577046901490644,"[1, 0, 1, 0, 1, 1, 0, 0, 1, 0]"
3980,1,1,2,0.063040351324812,"[0, 1, 1, 0, 1, 1, 1, 0, 0, 1]"
3981,1,1,2,0.8316346412963087,"[1, 0, 1, 1, 1, 0, 0, 0, 0, 1]"
3982,2,2,4,0.5066753463277186,"[0, 0, 0, 1, 0, 1, 0, 1, 0, 0]"
3983,2,2,4,0.11999901473294683,"[0, 0, 1, 1, 0, 1, 0, 1, 0, 0]"
3984,2,2,4,0.5618673287411939,"[0, 1, 1, 0, 1, 1, 0, 1, 1, 1]"
3985,1,1,2,0.4232013432548808,"[0, 0, 0, 1, 1, 1, 0, 0, 0, 0]"
3986,3,3,6,0.22349734109931563,"[0, 1, 0, 1, 1, 0, 1, 0, 1, 1]"
3987,1,1,2,0.4975172667995884,"[0, 0, 0, 1, 1, 1, 1, 0, 0, 0]"
3988,4,4,8,0.840069973920651,"[1, 1, 0, 0, 1, 1, 0, 0, 0, 0]"
3989,1,1,2,0.8554790919644945,"[1, 1, 1, 1, 0, 1, 1, 1, 0, 0]"
3990,1,1,2,0.15605330546554308,"[1, 0, 0, 0, 0, 0, 0, 1, 1, 1]"
3991,2,2,4,0.5301614715075622,"[1, 0, 0, 1, 0, 0, 1, 0, 1, 1]"
3992,3,3,6,0.28152263021840085,"[0, 0, 0, 0, 0, 1, 0, 0, 1, 1]"
3993,1,1,2,0.6829847570878219,"[0, 1, 0, 0, 0, 0, 0, 0, 0, 0]"
3994,1,1,2,0.1553126824173663,"[0, 0, 0, 0, 1, 1, 1, 1, 1, 0]"
3995,1,1,2,0.27141349292820816,"[1, 1, 0, 1, 1, 1, 0, 1, 1, 1]"
3996,1,1,2,0.9570410005163205,"[0, 0, 0, 0, 1, 0, 0, 1, 0, 1]"
3997,2,2,4,0.9246750073250602,"[0, 0, 1, 1, 1, 1, 1, 1, 1, 0]"
3998,2,2,4,0.5582136871879687,"[1, 1, 0, 1, 1, 0, 0, 1, 1, 0]"
3999,1,1,2,0.997317992313446,"[1, 0, 0, 0, 0, 0, 0, 1, 0, 1]"
4000,1,1,2,0.033083030182789464,"[1, 0, 1, 1, 0, 1, 1, 1, 1, 1]"
4001,1,1,2,0.17719781116617428,"[1, 0, 0, 0, 1, 0, 1, 1, 1, 0]"
4002,3,3,6,0.38409261390634963,"[0, 0, 1, 1, 0, 0, 1, 0, 0, 0]"
4003,1,1,2,0.4952156938467497,"[1, 0, 1, 1, 0, 0, 0, 0, 0, 0]"
4004,1,1,2,0.734886554573617,"[0, 0, 1, 1, 1, 0, 0, 1, 0, 0]"
4005,3,3,6,0.30712767888923365,"[0, 1, 1, 1, 0, 1, 1, 1, 1, 0]"
4006,2,2,4,0.2599193613335351,"[0, 0, 1, 1, 0, 0, 0, 0, 0, 0]"
4007,4,4,8,0.1124038472007074,"[0, 1, 0, 1, 0, 0, 1, 1, 1, 0]"
4008,1,1,2,0.5578404918218994,"[1, 1, 1, 1, 0, 1, 1, 0, 1, 1]"
4009,2,2,4,0.01719384919710054,"[0, 0, 1, 0, 1, 0, 1, 0, 1, 0]"
4010,1,1,2,0.024997201918063316,"[0, 0, 1, 0, 1, 1, 0, 0, 0, 0]"
4011,1,1,2,0.5530943509504195,"[1, 1, 0, 1, 0, 0, 0, 0, 0, 1]"
4012,3,3,6,0.9295583379537414,"[0, 1, 0, 0, 1, 1, 0, 1, 0, 0]"
4013,2,2,4,0.48934169750660317,"[0, 0, 1, 0, 1, 0, 1, 0, 0, 0]"
4014,4,4,8,0.09549185695820339,"[0, 0, 0, 1, 0, 1, 0, 0, 1, 1]"
4015,1,1,2,0.293649888632612,"[0, 0, 0, 0, 0, 0, 0, 0, 0, 1]"
4016,11,11,22,0.5546206078522621,"[1, 1, 1, 0, 1, 1, 0, 1, 1, 0]"
4017,2,2,4,0.373389824915634,"[1, 1, 1, 0, 0, 0, 1, 1, 1, 0]"
4018,2,2,4,0.7599759411464087,"[1, 0, 0, 1, 1, 1, 0, 0, 1, 1]"
4019,3,3,6,0.5580075789734653,"[1, 1, 0, 0, 0, 0, 1, 1, 1, 1]"
4020,2,2,4,0.6141772297861009,"[0, 1, 0, 1, 0, 0, 0, 1, 1, 0]"
4021,3,3,6,0.9604086247081255,"[1, 0, 1, 0, 1, 1, 0, 0, 0, 0]"
4022,2,2,4,0.9940893865914604,"[1, 0, 0, 0, 1, 1, 1, 0, 1, 1]"
4023,2,2,4,0.5098196513796736,"[1, 0, 0, 1, 1, 1, 1, 0, 0, 0]"
4024,4,4,8,0.1925860698933961,"[0, 1, 1, 0, 1, 1, 0, 1, 0, 1]"
4025,3,3,6,0.6585495830687084,"[1, 1, 0, 0, 1, 0, 1, 1, 1, 1]"
4026,1,1,2,0.7052173647889065,"[1, 1, 0, 1, 0, 0, 1, 0, 0, 0]"
4027,2,2,4,0.9435537528935627,"[1, 0, 1, 0, 0, 1, 1, 0, 0, 1]"
4028,3,3,6,0.7746586874735577,"[0, 0, 0, 1, 1, 1, 0, 0, 1, 0]"
4029,4,4,8,0.5334840933711064,"[1, 1, 1, 1, 1, 1, 0, 1, 1, 0]"
4030,4,4,8,0.2925263600424234,"[1, 0, 1, 1, 1, 1, 1, 0, 1, 0]"
4031,1,1,2,0.17747039742008885,"[1, 1, 1, 0, 0, 0, 1, 0, 0, 0]"
4032,10,10,20,0.45285747613462135,"[0, 1, 1, 1, 0, 1, 1, 1, 1, 0]"
4033,2,2,4,0.04782999483640793,"[0, 1, 1, 0, 0, 0, 0, 0, 0, 0]"
4034,5,5,10,0.9317029438207995,"[1, 1, 1, 1, 1, 0, 0, 0, 0, 1]"
4035,1,1,2,0.4154086326287285,"[0, 0, 1, 1, 0, 0, 1, 1, 1, 1]"
4036,4,4,8,0.35551682276153096,"[0, 1, 0, 0, 0, 1, 0, 1, 1, 1]"
4037,3,3,6,0.5674460304233355,"[0, 1, 1, 1, 1, 0, 0, 0, 0, 0]"
4038,1,1,2,0.6605695618672803,"[0, 0, 1, 0, 0, 1, 0, 0, 0, 1]"
4039,1,1,2,0.5921095443887358,"[0, 0, 1, 0, 0, 1, 1, 1, 1, 1]"
4040,1,1,2,0.031710777324862605,"[0, 0, 1, 1, 0, 1, 0, 1, 1, 1]"
4041,2,2,4,0.2828332425004365,"[0, 1, 1, 0, 0, 0, 1, 0, 1, 1]"
4042,3,3,6,0.2683006752129806,"[0, 1, 1, 1, 1, 1, 1, 0, 0, 0]"
4043,1,1,2,0.017411004886351056,"[1, 0, 1, 0, 1, 1, 1, 1, 1, 1]"
4044,2,2,4,0.6598065333003267,"[0, 0, 1, 0, 0, 0, 1, 1, 1, 0]"
4045,1,1,2,0.24434204428729056,"[1, 1, 0, 1, 1, 1, 0, 1, 0, 1]"
4046,2,2,4,0.5160638827224872,"[1, 1, 0, 0, 1, 1, 0, 0, 0, 0]"
4047,7,7,14,0.27169938777502756,"[0, 0, 1, 0, 1, 1, 1, 0, 1, 1]"
4048,1,1,2,0.6104560256930793,"[0, 0, 1, 1, 0, 0, 1, 1, 1, 0]"
4049,1,1,2,0.174736024812709,"[1, 1, 0, 0, 1, 0, 0, 0, 1, 0]"
4050,2,2,4,0.3407489844645438,"[1, 0, 1, 1, 1, 1, 0, 0, 1, 1]"
4051,1,1,2,0.12014035817671809,"[0, 0, 0, 0, 1, 1, 0, 1, 0, 1]"
4052,2,2,4,0.2941030549194771,"[1, 0, 0, 0, 1, 0, 1, 0, 0, 0]"
4053,4,4,8,0.6770325744948036,"[1, 1, 0, 0, 1, 1, 1, 1, 0, 0]"
4054,5,5,10,0.33419904406413026,"[1, 0, 0, 0, 0, 0, 1, 1, 1, 1]"
4055,3,3,6,0.83102336512729,"[1, 0, 1, 1, 1, 0, 0, 1, 0, 0]"
4056,1,1,2,0.9048019341508826,"[0, 1, 1, 1, 1, 1, 1, 1, 1, 0]"
4057,3,3,6,0.2583446271728854,"[1, 0, 1, 1, 0, 0, 0, 0, 0, 0]"
4058,3,3,6,0.6162137340768227,"[1, 1, 0, 0, 0, 0, 0, 0, 0, 1]"
4059,1,1,2,0.6474586521953757,"[1, 0, 1, 1, 1, 0, 1, 1, 1, 1]"
4060,3,3,6,0.8982798137160318,"[0, 1, 0, 0, 1, 1, 0, 0, 1, 0]"
4061,1,1,2,0.2084167676734362,"[1, 1, 0, 0, 0, 1, 0, 0, 1, 0]"
4062,3,3,6,0.5916491671987778,"[1, 1, 0, 1, 1, 1, 0, 0, 1, 0]"
4063,1,1,2,0.36397956063388304,"[0, 1, 0, 0, 1, 0, 0, 1, 0, 0]"
4064,3,3,6,0.6025848955185744,"[0, 0, 1, 1, 1, 1, 1, 0, 1, 0]"
4065,1,1,2,0.8722449199624849,"[0, 0, 0, 0, 1, 1, 1, 1, 1, 1]"
4066,1,1,2,0.6950791977978751,"[1, 1, 1, 1, 1, 0, 0, 0, 0, 0]"
4067,1,1,2,0.36169947551106485,"[0, 1, 0, 1, 1, 0, 1, 0, 0, 0]"
4068,3,3,6,0.037131713045206904,"[0, 0, 0, 1, 0, 0, 0, 0, 1, 0]"
4069,1,1,2,0.1344374333545323,"[0, 1, 1, 0, 1, 1, 0, 1, 0, 0]"
4070,3,3,6,0.8513046142483915,"[0, 1, 1, 1, 1, 1, 1, 0, 0, 0]"
4071,1,1,2,0.02377487941899037,"[1, 0, 1, 0, 0, 0, 1, 1, 0, 0]"
4072,3,3,6,0.032583501243474644,"[1, 0, 1, 0, 1, 1, 1, 0, 1, 1]"
4073,2,2,4,0.24862697295055902,"[0, 1, 1, 1, 1, 0, 0, 0, 1, 0]"
4074,1,1,2,0.2534077197964639,"[1, 0, 0, 1, 0, 0, 1, 0, 1, 1]"
4075,2,2,4,0.20912416857099336,"[0, 0, 0, 0, 0, 1, 0, 1, 1, 0]"
4076,1,1,2,0.8722977182295547,"[1, 0, 1, 0, 0, 1, 0, 0, 0, 0]"
4077,2,2,4,0.0712217304335716,"[0, 1, 0, 1, 0, 0, 0, 0, 0, 0]"
4078,2,2,4,0.2662095567530559,"[0, 1, 1, 0, 0, 1, 1, 1, 0, 1]"
4079,10,10,20,0.04903410299224098,"[0, 1, 1, 1, 1, 1, 1, 1, 0, 1]"
4080,3,3,6,0.4156556781992531,"[1, 0, 1, 1, 1, 0, 0, 1, 1, 1]"
4081,3,3,6,0.11381199385832952,"[1, 1, 1, 0, 0, 0, 1, 0, 0, 1]"
4082,3,3,6,0.8262542383464652,"[0, 0, 1, 1, 0, 0, 1, 1, 1, 1]"
4083,5,5,10,0.904975992582804,"[0, 1, 0, 0, 1, 1, 0, 1, 0, 1]"
4084,3,3,6,0.15099318009026752,"[0, 1, 0, 1, 0, 0, 1, 0, 1, 1]"
4085,2,2,4,0.5911646803218907,"[0, 0, 0, 0, 1, 0, 1, 0, 0, 0]"
4086,3,3,6,0.049676665563637035,"[0, 1, 0, 1, 1, 0, 1, 1, 1, 1]"
4087,2,2,4,0.8430644387760763,"[0, 0, 1, 1, 1, 0, 1, 0, 1, 1]"
4088,2,2,4,0.23747808296032613,"[1, 0, 0, 0, 1, 1, 1, 1, 0, 1]"
4089,1,1,2,0.9782049205626779,"[0, 0, 0, 0, 0, 1, 0, 1, 0, 0]"
4090,1,1,2,0.057389593597424904,"[0, 0, 1, 0, 1, 0, 0, 1, 1, 1]"
4091,4,4,8,0.4952864625266158,"[0, 1, 0, 1, 0, 0, 1, 0, 1, 1]"
4092,3,3,6,0.028794922019165115,"[0, 1, 1, 1, 0, 1, 1, 0, 0, 1]"
4093,2,2,4,0.33839551173072546,"[1, 0, 0, 0, 1, 1, 0, 1, 1, 1]"
4094,2,2,4,0.7596090652693953,"[1, 0, 0, 1, 1, 1, 1, 1, 0, 0]"
4095,2,2,4,0.7713954154751931,"[1, 0, 0, 0, 1, 0, 1, 0, 0, 1]"
4096,2,2,4,0.20826051067658868,"[0, 1, 1, 0, 1, 1, 1, 1, 0, 1]"
4097,1,1,2,0.644196216839806,"[1, 1, 1, 1, 1, 0, 0, 1, 1, 0]"
4098,1,1,2,0.27512106824158133,"[1, 1, 1, 1, 1, 1, 0, 0, 0, 0]"
4099,4,4,8,0.03167814224432097,"[1, 1, 1, 0, 0, 1, 0, 0, 0, 0]"
4100,1,1,2,0.12816649726083562,"[0, 1, 0, 0, 0, 0, 0, 1, 1, 1]"
4101,1,1,2,0.3315102053275031,"[1, 0, 0, 0, 0, 1, 1, 0, 1, 1]"
4102,1,1,2,0.3922506745752029,"[1, 0, 0, 0, 1, 0, 1, 0, 0, 0]"
4103,3,3,6,0.4200307077161567,"[0, 0, 0, 0, 1, 1, 1, 0, 0, 0]"
4104,1,1,2,0.13003962179556394,"[1, 0, 0, 1, 0, 1, 1, 1, 0, 1]"
4105,1,1,2,0.3416186186875043,"[1, 0, 0, 1, 0, 0, 0, 1, 1, 1]"
4106,3,3,6,0.6403048241574114,"[1, 1, 0, 0, 1, 0, 1, 0, 0, 1]"
4107,1,1,2,0.20396968229950496,"[0, 0, 1, 1, 0, 1, 1, 0, 1, 1]"
4108,1,1,2,0.6005637230297689,"[0, 0, 1, 0, 0, 1, 1, 1, 1, 1]"
4109,1,1,2,0.22970410377297457,"[0, 1, 1, 1, 0, 1, 1, 1, 1, 1]"
4110,1,1,2,0.21189559022259508,"[0, 1, 1, 0, 0, 1, 0, 0, 1, 1]"
4111,1,1,2,0.9425159803973844,"[0, 0, 1, 1, 1, 0, 1, 1, 0, 1]"
4112,3,3,6,0.997078359944208,"[0, 0, 1, 0, 1, 0, 1, 1, 1, 1]"
4113,2,2,4,0.8280203910810349,"[0, 0, 1, 1, 1, 0, 0, 0, 1, 0]"
4114,2,2,4,0.4925102627973996,"[1, 0, 0, 1, 0, 1, 0, 1, 0, 0]"
4115,1,1,2,0.02156345092661449,"[1, 1, 1, 0, 0, 0, 1, 1, 0, 0]"
4116,3,3,6,0.32478246913247233,"[0, 0, 1, 1, 0, 1, 1, 0, 1, 1]"
4117,1,1,2,0.5741085839781832,"[0, 1, 0, 0, 0, 1, 0, 0, 1, 0]"
4118,1,1,2,0.25115529194999897,"[0, 0, 0, 0, 1, 0, 0, 1, 0, 1]"
4119,1,1,2,0.9829412188528474,"[0, 1, 1, 0, 1, 1, 0, 1, 0, 0]"
4120,1,1,2,0.3484546457481478,"[0, 0, 1, 1, 0, 0, 1, 0, 1, 0]"
4121,2,2,4,0.6959597957560888,"[0, 0, 0, 0, 0, 1, 1, 1, 0, 1]"
4122,3,3,6,0.36931495878148424,"[1, 0, 0, 1, 1, 0, 0, 0, 0, 0]"
4123,2,2,4,0.6524102868307307,"[0, 1, 1, 0, 0, 1, 1, 1, 1, 0]"
4124,1,1,2,0.6377331378127881,"[0, 0, 0, 1, 0, 1, 1, 0, 1, 1]"
4125,1,1,2,0.7414428141799465,"[1, 0, 1, 0, 0, 0, 0, 0, 0, 0]"
4126,1,1,2,0.6284446733283712,"[0, 1, 0, 1, 1, 0, 1, 1, 1, 0]"
4127,1,1,2,0.5146646174347408,"[0, 0, 1, 1, 1, 0, 0, 1, 1, 1]"
4128,1,1,2,0.10068034417210758,"[0, 1, 0, 0, 0, 1, 0, 0, 1, 0]"
4129,1,1,2,0.06778060845437994,"[1, 1, 1, 0, 0, 0, 0, 0, 0, 1]"
4130,3,3,6,0.7934960792188346,"[0, 1, 1, 1, 0, 0, 1, 1, 0, 1]"
4131,2,2,4,0.06512079719840003,"[1, 0, 1, 1, 0, 0, 0, 0, 1, 0]"
4132,1,1,2,0.9346416377023194,"[1, 1, 0, 0, 0, 0, 0, 1, 0, 0]"
4133,1,1,2,0.23222657116504286,"[0, 1, 0, 0, 1, 1, 0, 0, 1, 0]"
4134,2,2,4,0.2039743708332583,"[0, 0, 1, 1, 0, 0, 1, 1, 1, 1]"
4135,4,4,8,0.5854619278472475,"[1, 0, 0, 0, 1, 1, 0, 1, 1, 1]"
4136,1,1,2,0.8209017064633404,"[0, 0, 1, 0, 1, 0, 1, 0, 1, 0]"
4137,1,1,2,0.7156522716178215,"[1, 0, 0, 1, 0, 1, 0, 0, 0, 1]"
4138,3,3,6,0.1728376136331904,"[1, 0, 1, 0, 1, 1, 0, 0, 0, 0]"
4139,2,2,4,0.8745803818394517,"[1, 0, 1, 0, 0, 0, 0, 1, 1, 0]"
4140,4,4,8,0.2880083748818273,"[1, 1, 1, 1, 1, 1, 0, 0, 1, 1]"
4141,1,1,2,0.39365826089321254,"[0, 1, 0, 0, 1, 0, 0, 0, 1, 0]"
4142,1,1,2,0.7059404006497508,"[0, 0, 1, 0, 0, 1, 1, 0, 0, 0]"
4143,3,3,6,0.35650940060730474,"[1, 1, 1, 1, 0, 1, 1, 1, 0, 0]"
4144,3,3,6,0.8311116692718497,"[0, 1, 1, 1, 0, 0, 1, 1, 1, 1]"
4145,2,2,4,0.3182669855558422,"[0, 1, 1, 0, 0, 0, 1, 0, 0, 1]"
4146,1,1,2,0.22922002450728196,"[0, 1, 0, 0, 1, 1, 1, 1, 1, 1]"
4147,1,1,2,0.6328435123139621,"[0, 1, 0, 0, 0, 0, 1, 0, 0, 0]"
4148,1,1,2,0.25070375212904783,"[1, 1, 1, 1, 1, 0, 0, 1, 0, 0]"
4149,1,1,2,0.42470474660655055,"[0, 1, 1, 1, 0, 0, 1, 1, 1, 1]"
4150,1,1,2,0.34168044770947403,"[1, 1, 0, 1, 1, 0, 0, 0, 1, 1]"
4151,9,9,18,0.07337136828371826,"[0, 1, 1, 0, 1, 0, 1, 1, 0, 1]"
4152,3,3,6,0.08121846572640079,"[0, 1, 0, 1, 1, 0, 1, 1, 0, 1]"
4153,5,5,10,0.1807230229749477,"[1, 0, 1, 0, 1, 0, 1, 1, 0, 1]"
4154,3,3,6,0.2816462019115643,"[0, 0, 1, 0, 1, 1, 0, 0, 1, 1]"
4155,2,2,4,0.6442554668838256,"[0, 0, 0, 0, 1, 0, 1, 1, 1, 0]"
4156,1,1,2,0.590197466264275,"[1, 1, 1, 0, 1, 1, 0, 1, 1, 0]"
4157,1,1,2,0.20971783414252598,"[0, 1, 0, 0, 1, 0, 1, 0, 1, 0]"
4158,1,1,2,0.667781825485442,"[1, 0, 0, 0, 0, 0, 0, 0, 0, 0]"
4159,1,1,2,0.33940271857461346,"[0, 0, 0, 1, 0, 0, 0, 0, 0, 0]"
4160,1,1,2,0.9593383940039454,"[1, 1, 1, 1, 0, 0, 1, 1, 1, 0]"
4161,2,2,4,0.683684773871794,"[0, 0, 1, 0, 0, 0, 0, 1, 1, 0]"
4162,1,1,2,0.11591152488660961,"[0, 1, 1, 1, 1, 1, 1, 0, 0, 0]"
4163,3,3,6,0.46785575821401093,"[1, 1, 0, 1, 1, 0, 1, 0, 0, 0]"
4164,9,9,18,0.01580399381423303,"[1, 1, 0, 1, 1, 1, 0, 1, 0, 1]"
4165,1,1,2,0.20764576425242953,"[0, 0, 0, 1, 1, 0, 1, 1, 0, 1]"
4166,2,2,4,0.24697216543356826,"[0, 1, 0, 1, 0, 1, 1, 0, 0, 1]"
4167,3,3,6,0.5499627181323612,"[1, 1, 0, 1, 0, 1, 0, 1, 0, 0]"
4168,1,1,2,0.7783161031839366,"[0, 1, 1, 0, 0, 1, 1, 0, 0, 0]"
4169,2,2,4,0.4031603213490992,"[0, 0, 0, 1, 1, 1, 0, 1, 0, 1]"
4170,1,1,2,0.5087822938014488,"[1, 0, 1, 1, 1, 0, 1, 1, 0, 0]"
4171,1,1,2,0.5596402154861714,"[1, 0, 1, 0, 0, 1, 1, 0, 1, 1]"
4172,6,6,12,0.13634488321025917,"[0, 1, 1, 1, 0, 1, 0, 1, 1, 1]"
4173,3,3,6,0.33312489760822017,"[1, 1, 1, 0, 0, 1, 1, 1, 0, 1]"
4174,5,5,10,0.21104677062837052,"[1, 1, 0, 0, 0, 1, 1, 1, 0, 0]"
4175,2,2,4,0.8110667357666747,"[0, 0, 0, 1, 0, 0, 1, 0, 0, 1]"
4176,2,2,4,0.982822502538944,"[0, 1, 0, 0, 1, 1, 1, 0, 1, 1]"
4177,2,2,4,0.5496936936953737,"[0, 0, 0, 0, 0, 1, 0, 0, 0, 1]"
4178,1,1,2,0.7744976714229778,"[0, 1, 1, 0, 1, 0, 0, 0, 0, 1]"
4179,1,1,2,0.6035433782082543,"[0, 1, 0, 1, 1, 1, 1, 0, 1, 1]"
4180,1,1,2,0.7433624836492521,"[1, 0, 1, 1, 1, 1, 0, 0, 0, 0]"
4181,4,4,8,0.47021029635200284,"[1, 1, 1, 1, 0, 0, 1, 1, 1, 0]"
4182,1,1,2,0.43758633999850627,"[0, 0, 1, 0, 1, 1, 0, 0, 0, 0]"
4183,1,1,2,0.5172653287165863,"[1, 1, 1, 0, 0, 0, 1, 0, 1, 0]"
4184,2,2,4,0.9559202584310228,"[0, 0, 1, 0, 0, 1, 0, 1, 1, 0]"
4185,2,2,4,0.947367807613862,"[0, 1, 0, 0, 1, 1, 1, 1, 0, 1]"
4186,3,3,6,0.9304671509118434,"[1, 0, 1, 0, 0, 1, 1, 1, 0, 0]"
4187,2,2,4,0.7119044274804995,"[1, 1, 0, 0, 1, 1, 1, 0, 1, 1]"
4188,1,1,2,0.4248362539734927,"[0, 0, 1, 1, 1, 1, 1, 0, 0, 0]"
4189,1,1,2,0.5225834923500339,"[0, 1, 0, 0, 0, 0, 1, 1, 0, 1]"
4190,4,4,8,0.3833145683668113,"[1, 0, 0, 1, 0, 1, 0, 0, 0, 1]"
4191,14,14,28,0.3617202983343779,"[1, 1, 1, 1, 1, 1, 1, 0, 1, 0]"
4192,1,1,2,0.0035693803000375057,"[0, 1, 0, 1, 0, 1, 1, 0, 0, 0]"
4193,1,1,2,0.4931614749863399,"[1, 0, 0, 1, 0, 0, 0, 0, 0, 0]"
4194,1,1,2,0.7273938536541112,"[0, 0, 0, 1, 1, 0, 0, 0, 0, 1]"
4195,3,3,6,0.6338263824479342,"[1, 1, 0, 1, 0, 1, 0, 1, 0, 1]"
4196,1,1,2,0.289643606642373,"[0, 1, 1, 0, 1, 1, 1, 0, 0, 1]"
4197,3,3,6,0.19512050219921007,"[0, 1, 1, 1, 1, 0, 0, 0, 1, 1]"
4198,2,2,4,0.6006480512354194,"[0, 1, 1, 0, 0, 1, 0, 1, 1, 1]"
4199,1,1,2,0.32644774541686217,"[0, 1, 1, 1, 0, 0, 0, 1, 1, 0]"
4200,6,6,12,0.4644213275040442,"[0, 1, 1, 1, 0, 1, 1, 0, 1, 0]"
4201,4,4,8,0.5273851608333503,"[0, 0, 0, 1, 0, 1, 1, 1, 1, 1]"
4202,3,3,6,0.9120993969044308,"[0, 1, 0, 0, 1, 0, 1, 0, 0, 0]"
4203,1,1,2,0.027806918833329197,"[1, 1, 1, 1, 1, 1, 1, 1, 0, 0]"
4204,4,4,8,0.7392591663508447,"[1, 0, 1, 0, 0, 0, 0, 1, 0, 1]"
4205,3,3,6,0.6173089019803626,"[1, 1, 0, 1, 1, 1, 0, 1, 1, 1]"
4206,4,4,8,0.37748351720455653,"[1, 1, 0, 1, 0, 0, 0, 1, 1, 0]"
4207,1,1,2,0.318912275052623,"[1, 1, 1, 1, 1, 0, 0, 0, 0, 1]"
4208,1,1,2,0.40051322267656175,"[1, 1, 1, 0, 0, 1, 1, 0, 1, 0]"
4209,3,3,6,0.900272670008894,"[0, 0, 0, 1, 1, 1, 1, 1, 0, 1]"
4210,4,4,8,0.11150958615353279,"[0, 1, 0, 0, 0, 1, 1, 0, 0, 0]"
4211,1,1,2,0.4998949037690711,"[1, 1, 0, 0, 0, 1, 0, 0, 1, 1]"
4212,1,1,2,0.29364999230760114,"[1, 0, 1, 1, 0, 1, 1, 0, 1, 0]"
4213,1,1,2,0.11136154974170664,"[1, 1, 1, 0, 0, 0, 1, 0, 0, 0]"
4214,2,2,4,0.32126579544875034,"[1, 1, 0, 1, 0, 1, 0, 1, 0, 1]"
4215,1,1,2,0.8465947437802533,"[0, 1, 0, 1, 1, 1, 1, 0, 1, 0]"
4216,1,1,2,0.503115840983743,"[1, 1, 1, 0, 0, 0, 1, 0, 0, 0]"
4217,1,1,2,0.2598218840493518,"[0, 1, 0, 0, 0, 0, 1, 0, 0, 1]"
4218,3,3,6,0.30686001366631044,"[1, 1, 0, 1, 1, 1, 0, 1, 0, 0]"
4219,2,2,4,0.8912814318504025,"[0, 0, 1, 0, 1, 0, 0, 1, 1, 1]"
4220,2,2,4,0.7288037410059764,"[1, 0, 0, 0, 0, 1, 1, 0, 0, 0]"
4221,5,5,10,0.6507445867870298,"[0, 0, 0, 1, 1, 0, 1, 0, 0, 1]"
4222,1,1,2,0.502057112334298,"[1, 0, 0, 1, 0, 1, 1, 0, 0, 1]"
4223,2,2,4,0.40785142324112367,"[0, 0, 0, 1, 1, 1, 1, 1, 0, 0]"
4224,1,1,2,0.19570116345832567,"[0, 1, 1, 1, 0, 1, 0, 0, 0, 0]"
4225,1,1,2,0.32347030383918884,"[0, 0, 1, 1, 0, 0, 1, 0, 0, 1]"
4226,1,1,2,0.7275717105676534,"[0, 1, 1, 0, 1, 0, 0, 0, 1, 0]"
4227,3,3,6,0.2663099060540931,"[1, 0, 0, 1, 0, 1, 0, 0, 1, 1]"
4228,1,1,2,0.01771664612161028,"[1, 0, 0, 1, 0, 1, 1, 0, 1, 0]"
4229,1,1,2,0.8196410367927173,"[1, 1, 0, 0, 0, 0, 1, 0, 0, 0]"
4230,2,2,4,0.752529676046636,"[1, 1, 0, 0, 1, 0, 1, 1, 0, 0]"
4231,1,1,2,0.2109368870308126,"[0, 1, 1, 1, 1, 1, 1, 1, 1, 1]"
4232,1,1,2,0.8441178096709073,"[0, 1, 1, 1, 0, 0, 0, 0, 0, 1]"
4233,2,2,4,0.4933339022789026,"[1, 0, 0, 0, 1, 0, 1, 1, 1, 0]"
4234,1,1,2,0.9121852735646416,"[0, 1, 0, 0, 1, 1, 1, 1, 0, 1]"
4235,5,5,10,0.12555310590539925,"[0, 1, 0, 1, 1, 0, 1, 1, 1, 1]"
4236,1,1,2,0.2742013565017559,"[0, 0, 0, 1, 1, 0, 1, 1, 1, 1]"
4237,3,3,6,0.2232430306912201,"[1, 0, 0, 1, 1, 0, 1, 0, 0, 1]"
4238,1,1,2,0.6518336649651547,"[0, 1, 1, 1, 1, 1, 0, 0, 1, 1]"
4239,5,5,10,0.9458268422880441,"[1, 0, 0, 0, 0, 0, 1, 0, 1, 1]"
4240,2,2,4,0.12386120793429956,"[1, 1, 0, 1, 1, 0, 0, 1, 0, 0]"
4241,1,1,2,0.7523187078117524,"[1, 1, 0, 1, 0, 1, 1, 1, 0, 1]"
4242,1,1,2,0.9275769454182348,"[0, 0, 1, 1, 0, 0, 1, 0, 0, 0]"
4243,1,1,2,0.4776695323406769,"[0, 1, 1, 0, 1, 0, 1, 0, 0, 1]"
4244,1,1,2,0.20619786774617965,"[1, 0, 0, 0, 1, 1, 0, 0, 1, 1]"
4245,3,3,6,0.6540927123873173,"[0, 0, 1, 1, 1, 0, 1, 1, 1, 1]"
4246,1,1,2,0.9896133708239843,"[1, 0, 1, 0, 1, 1, 0, 0, 1, 0]"
4247,1,1,2,0.42439942513636775,"[1, 0, 0, 0, 1, 1, 1, 1, 1, 0]"
4248,1,1,2,0.3233037378944368,"[0, 0, 0, 1, 0, 0, 1, 1, 0, 0]"
4249,1,1,2,0.2717834930154043,"[0, 0, 1, 0, 1, 1, 1, 0, 0, 0]"
4250,2,2,4,0.26023127434253646,"[0, 0, 1, 0, 0, 0, 1, 1, 0, 0]"
4251,1,1,2,0.23676856429216908,"[1, 1, 0, 1, 1, 0, 1, 0, 1, 1]"
4252,1,1,2,0.19266729330831667,"[1, 1, 0, 1, 0, 0, 1, 1, 1, 1]"
4253,1,1,2,0.5011084607251461,"[1, 0, 0, 0, 0, 0, 1, 0, 0, 1]"
4254,1,1,2,0.8991070779769313,"[0, 0, 1, 0, 0, 1, 0, 0, 0, 0]"
4255,3,3,6,0.6334284835226138,"[0, 1, 0, 1, 1, 1, 1, 1, 0, 1]"
4256,4,4,8,0.6671791756042161,"[0, 1, 1, 0, 1, 1, 1, 1, 1, 0]"
4257,2,2,4,0.144298820719181,"[1, 1, 0, 0, 0, 1, 1, 0, 1, 0]"
4258,2,2,4,0.9206985857403474,"[0, 0, 0, 1, 0, 0, 0, 0, 0, 1]"
4259,3,3,6,0.6511069813020283,"[1, 1, 0, 0, 0, 0, 1, 1, 1, 1]"
4260,1,1,2,0.11873614536612276,"[0, 0, 1, 0, 1, 0, 0, 0, 0, 1]"
4261,1,1,2,0.42075543028131157,"[0, 0, 1, 0, 1, 0, 0, 0, 1, 0]"
4262,1,1,2,0.5082503541046507,"[1, 0, 0, 0, 0, 1, 0, 0, 1, 0]"
4263,1,1,2,0.5312689652856017,"[1, 0, 1, 1, 1, 1, 0, 0, 1, 1]"
4264,1,1,2,0.9262547802504546,"[1, 0, 0, 0, 1, 0, 1, 0, 1, 1]"
4265,5,5,10,0.8573625616352616,"[1, 0, 1, 1, 0, 1, 1, 1, 0, 0]"
4266,3,3,6,0.5565653907901137,"[1, 0, 0, 0, 0, 1, 1, 0, 1, 1]"
4267,5,5,10,0.9250090282976227,"[1, 0, 1, 1, 1, 1, 1, 1, 1, 1]"
4268,5,5,10,0.9440972515906119,"[0, 0, 1, 1, 0, 0, 0, 1, 1, 1]"
4269,1,1,2,0.9602494314969464,"[0, 0, 0, 0, 1, 0, 0, 0, 0, 1]"
4270,6,6,12,0.9592123560593362,"[0, 1, 1, 1, 1, 0, 1, 1, 1, 0]"
4271,3,3,6,0.1385192386583738,"[1, 0, 1, 0, 0, 0, 1, 0, 1, 0]"
4272,1,1,2,0.9071868258203653,"[1, 0, 1, 0, 0, 0, 1, 0, 0, 1]"
4273,1,1,2,0.023604327017992865,"[0, 0, 1, 0, 1, 0, 0, 0, 0, 1]"
4274,10,10,20,0.44255988598927143,"[1, 1, 0, 1, 0, 0, 0, 1, 1, 1]"
4275,3,3,6,0.7238274930593137,"[1, 0, 1, 0, 0, 1, 1, 1, 0, 1]"
4276,2,2,4,0.9162201672364203,"[0, 0, 0, 1, 1, 0, 0, 0, 1, 1]"
4277,2,2,4,0.5847135990562248,"[1, 0, 0, 0, 1, 0, 0, 1, 1, 0]"
4278,1,1,2,0.6601634618857501,"[0, 1, 0, 0, 1, 1, 0, 0, 1, 0]"
4279,2,2,4,0.6381090515159046,"[0, 1, 1, 1, 1, 0, 0, 0, 1, 1]"
4280,2,2,4,0.5212740045544083,"[0, 1, 0, 0, 0, 0, 0, 1, 0, 0]"
4281,2,2,4,0.28269304428925135,"[0, 0, 0, 1, 0, 1, 0, 1, 0, 0]"
4282,1,1,2,0.08181737052232219,"[0, 0, 0, 1, 1, 0, 0, 1, 1, 1]"
4283,2,2,4,0.24159831927922915,"[1, 0, 0, 1, 0, 0, 1, 0, 0, 0]"
4284,1,1,2,0.7608433325070524,"[1, 1, 1, 0, 0, 0, 1, 0, 1, 0]"
4285,7,7,14,0.36694787250402106,"[0, 0, 1, 1, 1, 1, 1, 1, 1, 1]"
4286,1,1,2,0.4457045551590568,"[0, 1, 0, 0, 0, 0, 1, 0, 0, 0]"
4287,1,1,2,0.18244125143251877,"[0, 0, 0, 0, 0, 0, 0, 1, 1, 0]"
4288,1,1,2,0.47186752691289036,"[0, 1, 0, 0, 0, 1, 0, 0, 0, 0]"
4289,2,2,4,0.8449055178968924,"[1, 1, 0, 0, 0, 1, 0, 0, 0, 1]"
4290,1,1,2,0.8451728039995848,"[0, 0, 1, 0, 0, 0, 0, 0, 0, 0]"
4291,1,1,2,0.37807675335138435,"[1, 0, 1, 0, 1, 0, 0, 0, 0, 0]"
4292,2,2,4,0.9480359191357373,"[0, 0, 0, 1, 1, 0, 0, 1, 1, 0]"
4293,3,3,6,0.9884700621107653,"[1, 0, 1, 1, 1, 0, 0, 1, 0, 0]"
4294,1,1,2,0.05126401603680886,"[0, 0, 0, 0, 0, 1, 1, 1, 1, 0]"
4295,1,1,2,0.21963126680785305,"[0, 0, 0, 0, 1, 1, 0, 1, 1, 1]"
4296,1,1,2,0.7125243395909149,"[0, 1, 1, 0, 1, 0, 0, 1, 0, 1]"
4297,2,2,4,0.6456597766319732,"[0, 0, 1, 1, 1, 0, 1, 1, 0, 0]"
4298,1,1,2,0.2484929265835344,"[1, 0, 1, 1, 0, 0, 0, 1, 0, 1]"
4299,1,1,2,0.15871300635033547,"[0, 1, 1, 0, 0, 0, 1, 0, 1, 1]"
4300,1,1,2,0.7075970787792594,"[0, 1, 1, 0, 1, 0, 0, 0, 0, 1]"
4301,1,1,2,0.16654750198669144,"[1, 0, 0, 0, 1, 0, 0, 0, 0, 0]"
4302,1,1,2,0.6987063564005361,"[0, 0, 1, 1, 0, 0, 1, 0, 0, 1]"
4303,1,1,2,0.4145000091372585,"[1, 1, 0, 1, 1, 0, 1, 0, 0, 1]"
4304,1,1,2,0.8253948748292378,"[0, 1, 1, 0, 0, 1, 0, 0, 0, 0]"
4305,1,1,2,0.39282268075604587,"[1, 0, 1, 0, 0, 0, 1, 1, 1, 1]"
4306,1,1,2,0.20825126447815778,"[0, 1, 0, 1, 1, 0, 0, 1, 1, 0]"
4307,1,1,2,0.5253614923605087,"[0, 1, 1, 0, 0, 0, 1, 0, 1, 0]"
4308,2,2,4,0.9389210475021125,"[0, 1, 1, 0, 0, 0, 1, 0, 0, 0]"
4309,3,3,6,0.569694770407227,"[1, 0, 1, 0, 0, 1, 1, 0, 1, 0]"
4310,3,3,6,0.3876819002798372,"[1, 1, 1, 1, 1, 1, 0, 1, 1, 1]"
4311,3,3,6,0.41083192305276317,"[0, 1, 1, 1, 1, 0, 0, 1, 1, 1]"
4312,2,2,4,0.6324008069408078,"[0, 0, 0, 0, 1, 0, 1, 0, 1, 1]"
4313,5,5,10,0.2875761947699904,"[1, 1, 1, 1, 0, 1, 0, 1, 1, 0]"
4314,4,4,8,0.7905898482063757,"[1, 1, 0, 1, 1, 1, 1, 0, 1, 1]"
4315,1,1,2,0.08413287877622844,"[1, 0, 1, 0, 1, 1, 1, 1, 0, 0]"
4316,1,1,2,0.23246781743598266,"[1, 1, 0, 1, 0, 0, 1, 1, 0, 0]"
4317,1,1,2,0.15882263251674122,"[0, 1, 0, 1, 1, 1, 1, 0, 0, 0]"
4318,1,1,2,0.26873416951414575,"[1, 0, 0, 1, 0, 0, 1, 0, 0, 1]"
4319,4,4,8,0.5349763455072437,"[1, 0, 1, 0, 0, 0, 0, 0, 0, 1]"
4320,1,1,2,0.32134538466707074,"[0, 0, 1, 0, 1, 0, 0, 0, 1, 0]"
4321,2,2,4,0.007373669874978783,"[0, 0, 0, 1, 1, 0, 0, 1, 1, 1]"
4322,1,1,2,0.6609152317261542,"[0, 0, 0, 0, 0, 0, 1, 0, 0, 1]"
4323,4,4,8,0.20870953279049675,"[1, 1, 1, 0, 0, 1, 0, 1, 0, 1]"
4324,2,2,4,0.4383476197235052,"[0, 0, 1, 0, 0, 1, 1, 0, 1, 1]"
4325,3,3,6,0.9438743311293641,"[0, 0, 0, 0, 1, 0, 0, 1, 0, 1]"
4326,1,1,2,0.867472106693659,"[1, 0, 1, 1, 0, 1, 0, 0, 0, 0]"
4327,1,1,2,0.007934969638078715,"[1, 1, 1, 0, 1, 0, 1, 0, 1, 1]"
4328,3,3,6,0.5997129436158949,"[1, 0, 1, 0, 0, 1, 0, 1, 1, 1]"
4329,2,2,4,0.2902208565232879,"[1, 0, 0, 1, 1, 0, 1, 1, 1, 1]"
4330,1,1,2,0.4042842584791142,"[0, 0, 0, 0, 0, 1, 0, 1, 1, 0]"
4331,3,3,6,0.826241272644283,"[1, 1, 1, 1, 1, 1, 1, 1, 0, 0]"
4332,5,5,10,0.012074141380654768,"[0, 1, 0, 1, 0, 1, 1, 1, 0, 1]"
4333,1,1,2,0.44917563458137844,"[0, 0, 1, 1, 1, 1, 0, 0, 1, 1]"
4334,3,3,6,0.48745429140882,"[1, 0, 0, 0, 0, 0, 1, 0, 0, 0]"
4335,2,2,4,0.2081373918220102,"[0, 0, 1, 1, 0, 0, 0, 1, 1, 0]"
4336,1,1,2,0.32982202152566564,"[1, 0, 1, 0, 1, 0, 0, 0, 1, 1]"
4337,1,1,2,0.6558595495862091,"[1, 0, 1, 0, 1, 0, 0, 1, 1, 1]"
4338,3,3,6,0.21063143238541826,"[0, 1, 0, 0, 1, 1, 1, 0, 1, 0]"
4339,2,2,4,0.5826108924555756,"[0, 0, 1, 1, 1, 0, 1, 0, 0, 1]"
4340,4,4,8,0.9155007329860999,"[1, 0, 0, 0, 1, 1, 1, 0, 1, 0]"
4341,2,2,4,0.4411454376269137,"[0, 1, 1, 1, 1, 0, 1, 1, 1, 1]"
4342,1,1,2,0.6038503346963917,"[0, 1, 1, 1, 0, 0, 0, 0, 0, 1]"
4343,2,2,4,0.6068943103019074,"[1, 0, 1, 0, 1, 0, 0, 1, 0, 1]"
4344,1,1,2,0.05456261692471742,"[0, 0, 1, 1, 1, 0, 0, 0, 0, 1]"
4345,2,2,4,0.43215193105526395,"[1, 0, 1, 0, 1, 1, 1, 1, 0, 1]"
4346,1,1,2,0.16846252617483914,"[1, 0, 1, 1, 0, 0, 1, 1, 1, 1]"
4347,1,1,2,0.7407626065799722,"[0, 1, 0, 0, 0, 1, 1, 1, 0, 0]"
4348,4,4,8,0.5857462092033615,"[0, 0, 0, 0, 1, 0, 1, 0, 1, 1]"
4349,9,9,18,0.13616128824590723,"[1, 1, 1, 1, 0, 1, 1, 1, 1, 1]"
4350,1,1,2,0.055856090025816485,"[0, 1, 1, 1, 0, 1, 1, 0, 0, 0]"
4351,5,5,10,0.6506930007291761,"[1, 1, 0, 0, 1, 0, 1, 0, 1, 1]"
4352,1,1,2,0.5814324465539886,"[1, 0, 1, 0, 1, 0, 0, 0, 1, 0]"
4353,1,1,2,0.43670722751347457,"[0, 0, 1, 1, 0, 0, 1, 0, 0, 1]"
4354,2,2,4,0.9634449983004936,"[1, 0, 1, 1, 0, 0, 1, 0, 0, 1]"
4355,3,3,6,0.8123852446092212,"[1, 1, 0, 1, 0, 1, 0, 1, 0, 0]"
4356,6,6,12,0.2289975925612443,"[1, 1, 1, 1, 1, 1, 0, 1, 0, 0]"
4357,1,1,2,0.5582305564508878,"[0, 0, 0, 0, 0, 0, 0, 0, 0, 1]"
4358,1,1,2,0.12813688278637314,"[0, 0, 1, 1, 0, 0, 0, 1, 0, 0]"
4359,1,1,2,0.5551778519831535,"[1, 1, 1, 0, 1, 1, 0, 1, 0, 0]"
4360,1,1,2,0.23289234797616742,"[1, 0, 0, 1, 0, 0, 0, 1, 0, 0]"
4361,5,5,10,0.7735362388870789,"[1, 0, 1, 1, 0, 1, 0, 0, 1, 1]"
4362,2,2,4,0.06189841073501856,"[1, 1, 0, 0, 1, 1, 0, 0, 0, 0]"
4363,1,1,2,0.9300638911152587,"[1, 0, 1, 0, 1, 0, 0, 1, 0, 0]"
4364,1,1,2,0.7558927296889987,"[0, 1, 0, 1, 0, 1, 0, 1, 0, 0]"
4365,1,1,2,0.09011963069472317,"[0, 1, 1, 1, 1, 0, 1, 1, 0, 1]"
4366,1,1,2,0.5990357431257364,"[1, 0, 1, 1, 1, 0, 0, 0, 0, 1]"
4367,3,3,6,0.03104133046403923,"[0, 0, 0, 0, 0, 0, 1, 0, 1, 0]"
4368,2,2,4,0.8778771559064003,"[1, 1, 1, 0, 0, 1, 1, 1, 1, 1]"
4369,1,1,2,0.9015318968964527,"[1, 1, 0, 1, 1, 0, 0, 1, 1, 1]"
4370,1,1,2,0.18490231262189527,"[1, 1, 1, 0, 0, 0, 0, 1, 0, 1]"
4371,1,1,2,0.985089866146254,"[0, 0, 0, 1, 0, 1, 1, 0, 1, 1]"
4372,1,1,2,0.9082536225075026,"[0, 0, 1, 0, 1, 1, 0, 1, 0, 1]"
4373,5,5,10,0.5111753085821058,"[0, 0, 1, 1, 0, 1, 0, 0, 0, 1]"
4374,1,1,2,0.3746515771882145,"[1, 0, 0, 0, 0, 0, 0, 1, 1, 0]"
4375,1,1,2,0.6408867348050937,"[0, 0, 0, 0, 1, 1, 0, 0, 1, 1]"
4376,2,2,4,0.41403503225015403,"[0, 1, 0, 1, 1, 1, 0, 0, 0, 0]"
4377,1,1,2,0.2502135430227911,"[0, 1, 1, 0, 0, 0, 1, 1, 1, 0]"
4378,5,5,10,0.28631291179693263,"[1, 1, 1, 1, 0, 1, 1, 1, 1, 1]"
4379,2,2,4,0.26327841388024853,"[1, 1, 0, 1, 1, 0, 1, 1, 0, 0]"
4380,1,1,2,0.16751298793579406,"[0, 1, 1, 1, 1, 0, 0, 0, 0, 1]"
4381,1,1,2,0.05889120351747612,"[0, 0, 1, 1, 1, 1, 1, 0, 0, 1]"
4382,2,2,4,0.14621128178807863,"[1, 1, 1, 0, 1, 1, 0, 1, 0, 0]"
4383,2,2,4,0.30616355374599136,"[0, 0, 1, 1, 0, 1, 0, 0, 1, 1]"
4384,1,1,2,0.840409297028999,"[0, 1, 0, 1, 0, 0, 1, 1, 1, 0]"
4385,1,1,2,0.1776453400371898,"[1, 1, 1, 1, 0, 0, 1, 1, 1, 0]"
4386,1,1,2,0.2183167898974735,"[1, 1, 1, 1, 0, 1, 1, 0, 0, 1]"
4387,1,1,2,0.659899391602518,"[1, 0, 1, 1, 0, 0, 1, 0, 1, 0]"
4388,1,1,2,0.18882345838009607,"[0, 1, 1, 0, 1, 1, 0, 0, 0, 1]"
4389,1,1,2,0.6223082838896258,"[0, 1, 0, 0, 0, 0, 0, 0, 1, 1]"
4390,2,2,4,0.7110240646891152,"[1, 1, 0, 1, 0, 1, 1, 0, 1, 1]"
4391,1,1,2,0.6965183974883978,"[0, 0, 1, 0, 0, 0, 1, 0, 1, 0]"
4392,1,1,2,0.5228440002188055,"[0, 1, 1, 0, 1, 0, 0, 0, 1, 1]"
4393,3,3,6,0.7514330501475152,"[1, 0, 0, 1, 0, 0, 1, 1, 1, 1]"
4394,1,1,2,0.2799744681308154,"[1, 0, 1, 0, 1, 0, 0, 1, 1, 1]"
4395,2,2,4,0.43303542901748104,"[0, 0, 1, 0, 1, 1, 0, 0, 0, 1]"
4396,8,8,16,0.45577700013563205,"[1, 1, 0, 1, 1, 1, 1, 0, 1, 1]"
4397,1,1,2,0.2545388164998452,"[0, 0, 0, 0, 1, 0, 1, 1, 0, 1]"
4398,1,1,2,0.4993875861409527,"[0, 0, 0, 0, 1, 1, 1, 1, 1, 1]"
4399,1,1,2,0.7889690246716822,"[0, 1, 1, 1, 0, 1, 0, 0, 0, 0]"
4400,1,1,2,0.5358604859496237,"[1, 1, 0, 0, 1, 0, 0, 0, 0, 0]"
4401,9,9,18,0.6280486429153198,"[1, 0, 1, 0, 0, 1, 0, 0, 1, 1]"
4402,2,2,4,0.1110689258583718,"[1, 1, 0, 0, 0, 1, 1, 0, 1, 0]"
4403,1,1,2,0.9123503465061212,"[0, 0, 0, 0, 1, 0, 0, 1, 0, 1]"
4404,1,1,2,0.9212286994843134,"[1, 1, 0, 0, 1, 1, 1, 0, 0, 0]"
4405,1,1,2,0.44422284888705865,"[0, 1, 0, 0, 0, 1, 1, 1, 0, 0]"
4406,2,2,4,0.8953160882619794,"[1, 1, 1, 0, 0, 1, 0, 1, 0, 1]"
4407,3,3,6,0.6141212540619038,"[1, 1, 1, 0, 1, 1, 1, 1, 0, 0]"
4408,2,2,4,0.788095831344842,"[1, 1, 1, 0, 1, 0, 0, 0, 1, 0]"
4409,1,1,2,0.002347846552843702,"[0, 1, 1, 0, 0, 1, 0, 0, 1, 1]"
4410,1,1,2,0.5198381447675704,"[1, 0, 0, 1, 0, 1, 0, 0, 0, 0]"
4411,2,2,4,0.11748825060142376,"[1, 1, 0, 0, 0, 0, 1, 0, 0, 0]"
4412,3,3,6,0.8420040745352161,"[1, 0, 0, 0, 0, 0, 0, 0, 1, 1]"
4413,1,1,2,0.28799599274173326,"[0, 0, 1, 0, 0, 0, 1, 1, 1, 0]"
4414,4,4,8,0.3406849671169313,"[1, 0, 1, 1, 1, 1, 1, 1, 0, 1]"
4415,1,1,2,0.2569138609553948,"[0, 1, 1, 1, 0, 0, 0, 1, 0, 0]"
4416,3,3,6,0.08476740568233398,"[1, 1, 0, 1, 1, 1, 1, 0, 1, 0]"
4417,4,4,8,0.9003888123113134,"[1, 1, 0, 0, 1, 0, 1, 0, 0, 1]"
4418,2,2,4,0.6318505257361281,"[0, 1, 0, 0, 0, 1, 0, 0, 0, 0]"
4419,5,5,10,0.4814968846797004,"[0, 1, 1, 0, 1, 0, 0, 0, 1, 0]"
4420,1,1,2,0.14101515133458487,"[1, 0, 0, 0, 1, 1, 0, 0, 1, 1]"
4421,3,3,6,0.7864542249360907,"[1, 0, 1, 0, 1, 1, 1, 1, 1, 0]"
4422,4,4,8,0.1341612600539659,"[1, 1, 0, 1, 0, 0, 1, 0, 1, 1]"
4423,1,1,2,0.4130910154703312,"[1, 1, 1, 1, 1, 1, 0, 0, 1, 1]"
4424,1,1,2,0.17326177924544894,"[0, 0, 0, 0, 1, 0, 0, 0, 0, 0]"
4425,5,5,10,0.7162786750240185,"[1, 1, 0, 1, 1, 1, 1, 0, 1, 0]"
4426,2,2,4,0.37825151919077327,"[1, 1, 0, 0, 0, 1, 1, 1, 1, 0]"
4427,2,2,4,0.5816670085590487,"[0, 0, 1, 0, 1, 1, 0, 0, 0, 1]"
4428,2,2,4,0.3798422212830386,"[1, 1, 0, 1, 0, 1, 0, 1, 1, 1]"
4429,1,1,2,0.41437815236566644,"[0, 0, 1, 0, 1, 1, 1, 0, 1, 0]"
4430,1,1,2,0.3440233701947901,"[1, 0, 1, 1, 0, 0, 1, 1, 0, 0]"
4431,3,3,6,0.7488883260445347,"[1, 1, 1, 0, 1, 0, 1, 1, 0, 1]"
4432,2,2,4,0.7343436905283499,"[1, 1, 1, 0, 0, 0, 0, 1, 1, 0]"
4433,1,1,2,0.3897260755910166,"[1, 1, 1, 0, 1, 0, 0, 1, 0, 0]"
4434,1,1,2,0.5189875266941996,"[0, 1, 0, 1, 1, 0, 1, 1, 0, 0]"
4435,2,2,4,0.2611550145315694,"[0, 0, 1, 0, 0, 1, 1, 1, 0, 0]"
4436,1,1,2,0.753886647774287,"[1, 1, 0, 1, 0, 0, 0, 0, 1, 1]"
4437,4,4,8,0.111865419822747,"[0, 1, 1, 0, 1, 0, 0, 1, 1, 1]"
4438,2,2,4,0.14177264452456972,"[0, 0, 0, 1, 1, 1, 1, 1, 1, 1]"
4439,3,3,6,0.5733965079515915,"[0, 0, 0, 1, 0, 0, 1, 0, 1, 1]"
4440,3,3,6,0.12281831286207334,"[1, 1, 1, 1, 0, 0, 0, 1, 0, 0]"
4441,2,2,4,0.9038730340897849,"[0, 0, 1, 1, 1, 0, 1, 0, 0, 1]"
4442,1,1,2,0.16427964561395536,"[0, 0, 1, 1, 0, 0, 1, 1, 0, 0]"
4443,2,2,4,0.5773515741193349,"[0, 1, 0, 0, 1, 0, 1, 1, 0, 1]"
4444,1,1,2,0.16978243121868075,"[0, 1, 1, 1, 0, 1, 1, 1, 0, 1]"
4445,2,2,4,0.2559942994767519,"[0, 1, 0, 0, 0, 1, 1, 1, 0, 1]"
4446,1,1,2,0.2941356648687041,"[0, 1, 0, 1, 0, 1, 1, 1, 0, 1]"
4447,1,1,2,0.1611281921124289,"[0, 0, 0, 0, 0, 1, 1, 1, 0, 1]"
4448,2,2,4,0.3248505838972874,"[1, 0, 0, 0, 0, 1, 0, 1, 0, 0]"
4449,1,1,2,0.49128220655269805,"[1, 0, 0, 1, 0, 0, 0, 1, 0, 0]"
4450,9,9,18,0.8251020286154798,"[1, 1, 1, 1, 1, 0, 0, 0, 0, 0]"
4451,1,1,2,0.11333494563096791,"[0, 0, 1, 1, 0, 1, 0, 0, 0, 1]"
4452,1,1,2,0.7818200556084234,"[0, 0, 0, 1, 1, 1, 1, 0, 0, 0]"
4453,1,1,2,0.3498040699994587,"[1, 1, 1, 1, 1, 0, 1, 1, 1, 0]"
4454,1,1,2,0.3109317806345827,"[0, 0, 0, 1, 0, 0, 1, 1, 1, 0]"
4455,4,4,8,0.4998653195764672,"[0, 1, 1, 1, 0, 0, 0, 1, 0, 1]"
4456,1,1,2,0.047215310483831985,"[1, 1, 1, 1, 1, 0, 1, 1, 0, 1]"
4457,3,3,6,0.025833431934307316,"[1, 0, 0, 0, 0, 1, 0, 1, 0, 0]"
4458,2,2,4,0.12519830972524637,"[1, 0, 1, 1, 0, 1, 1, 1, 1, 0]"
4459,3,3,6,0.6137150037031566,"[1, 0, 1, 1, 0, 1, 1, 1, 0, 1]"
4460,1,1,2,0.6079788720727485,"[0, 1, 1, 0, 1, 0, 0, 0, 0, 0]"
4461,2,2,4,0.9046835082652918,"[1, 0, 0, 0, 0, 1, 0, 0, 1, 0]"
4462,2,2,4,0.9433943177294817,"[1, 0, 1, 1, 1, 1, 0, 1, 1, 0]"
4463,2,2,4,0.718955578635065,"[1, 1, 1, 0, 0, 0, 1, 0, 1, 0]"
4464,3,3,6,0.028085550407669913,"[0, 1, 1, 0, 1, 0, 1, 0, 1, 0]"
4465,1,1,2,0.951304449418744,"[0, 0, 1, 0, 0, 1, 1, 0, 1, 0]"
4466,1,1,2,0.7608072804893798,"[0, 1, 0, 0, 1, 1, 0, 1, 0, 1]"
4467,2,2,4,0.5221897002162253,"[0, 1, 1, 1, 0, 1, 1, 0, 0, 1]"
4468,2,2,4,0.7742554157058944,"[0, 1, 1, 1, 1, 1, 1, 0, 1, 1]"
4469,1,1,2,0.9439370282024867,"[0, 1, 0, 0, 0, 1, 1, 0, 1, 0]"
4470,1,1,2,0.03000238296577762,"[0, 1, 0, 0, 0, 1, 0, 1, 1, 1]"
4471,1,1,2,0.6125145325163126,"[1, 1, 1, 0, 0, 1, 0, 1, 0, 1]"
4472,2,2,4,0.3923641838623777,"[1, 1, 0, 1, 1, 1, 0, 1, 0, 0]"
4473,1,1,2,0.8326882400950127,"[1, 0, 1, 1, 0, 1, 1, 0, 0, 0]"
4474,2,2,4,0.5725367158356417,"[1, 0, 0, 1, 1, 0, 0, 0, 1, 0]"
4475,2,2,4,0.7126633177343104,"[1, 1, 1, 0, 1, 1, 0, 0, 0, 0]"
4476,1,1,2,0.04515942621161373,"[0, 1, 1, 1, 0, 0, 1, 1, 1, 0]"
4477,1,1,2,0.8420135323785874,"[0, 1, 0, 1, 0, 1, 0, 0, 1, 1]"
4478,1,1,2,0.13786680482631064,"[0, 1, 0, 0, 0, 0, 1, 1, 1, 1]"
4479,2,2,4,0.8680908872528423,"[1, 1, 1, 1, 1, 0, 1, 0, 0, 1]"
4480,1,1,2,0.5577773510400377,"[0, 1, 0, 1, 1, 0, 1, 0, 1, 1]"
4481,1,1,2,0.13802386067297712,"[1, 1, 0, 0, 1, 1, 0, 0, 0, 0]"
4482,1,1,2,0.21309015938982967,"[0, 0, 0, 0, 1, 0, 0, 0, 0, 0]"
4483,2,2,4,0.9766909146580679,"[0, 1, 0, 1, 1, 1, 0, 1, 0, 0]"
4484,1,1,2,0.9584990470061756,"[0, 0, 1, 1, 0, 1, 0, 1, 0, 0]"
4485,2,2,4,0.002650189185117946,"[0, 0, 1, 1, 0, 0, 1, 0, 1, 1]"
4486,1,1,2,0.5262535896871654,"[1, 1, 0, 1, 0, 1, 1, 0, 0, 1]"
4487,3,3,6,0.7188084755049233,"[1, 0, 0, 1, 0, 1, 1, 1, 0, 0]"
4488,1,1,2,0.10173533054727213,"[1, 1, 0, 1, 0, 0, 0, 1, 0, 1]"
4489,4,4,8,0.7950296707177107,"[0, 1, 0, 0, 1, 0, 0, 0, 1, 1]"
4490,5,5,10,0.5206690448569758,"[1, 0, 0, 1, 1, 0, 0, 0, 1, 1]"
4491,2,2,4,0.6169945120622059,"[1, 1, 0, 1, 1, 1, 1, 1, 1, 0]"
4492,2,2,4,0.03304940193688222,"[1, 1, 0, 1, 1, 1, 1, 0, 1, 0]"
4493,1,1,2,0.19233831436574722,"[1, 1, 0, 1, 1, 1, 1, 1, 0, 1]"
4494,1,1,2,0.6015292387498457,"[0, 0, 0, 1, 1, 1, 0, 1, 1, 0]"
4495,1,1,2,0.1550029731188135,"[0, 0, 1, 0, 1, 1, 0, 0, 0, 1]"
4496,3,3,6,0.8420731285693328,"[0, 0, 0, 1, 1, 1, 0, 0, 0, 1]"
4497,1,1,2,0.08280844575003743,"[0, 1, 0, 0, 0, 1, 0, 0, 1, 0]"
4498,1,1,2,0.49432446009622744,"[1, 1, 1, 0, 0, 1, 0, 0, 1, 0]"
4499,4,4,8,0.3956071664936617,"[0, 1, 1, 0, 0, 0, 0, 1, 0, 1]"
4500,2,2,4,0.7582487662904056,"[1, 0, 1, 0, 0, 1, 0, 0, 1, 0]"
4501,2,2,4,0.23222848133954688,"[1, 0, 1, 0, 0, 1, 1, 0, 0, 1]"
4502,1,1,2,0.37527723001387847,"[0, 0, 0, 0, 0, 0, 0, 1, 1, 0]"
4503,1,1,2,0.6420992906440217,"[0, 1, 0, 0, 1, 1, 1, 0, 0, 1]"
4504,1,1,2,0.8129512367287679,"[0, 0, 0, 0, 0, 0, 0, 1, 0, 1]"
4505,1,1,2,0.5702135940133458,"[0, 0, 0, 0, 1, 1, 0, 0, 0, 0]"
4506,2,2,4,0.4998882350402598,"[0, 1, 1, 0, 1, 1, 1, 0, 0, 0]"
4507,3,3,6,0.9922120176661237,"[1, 1, 1, 1, 0, 0, 0, 0, 1, 1]"
4508,1,1,2,0.48395669422748677,"[1, 1, 1, 0, 0, 0, 0, 0, 1, 0]"
4509,3,3,6,0.5513451679276538,"[1, 1, 0, 1, 1, 1, 0, 1, 0, 0]"
4510,1,1,2,0.7810477225691371,"[0, 0, 0, 1, 0, 0, 0, 0, 0, 1]"
4511,1,1,2,0.10199251782437746,"[1, 0, 0, 1, 0, 0, 1, 0, 1, 0]"
4512,1,1,2,0.5327464673560109,"[0, 1, 0, 1, 1, 1, 0, 0, 1, 0]"
4513,1,1,2,0.4931714040268744,"[0, 0, 1, 0, 1, 0, 0, 1, 0, 0]"
4514,1,1,2,0.054923581383154674,"[0, 0, 1, 1, 0, 1, 1, 0, 1, 0]"
4515,1,1,2,0.5125759731144511,"[1, 0, 1, 0, 0, 1, 1, 1, 1, 1]"
4516,2,2,4,0.5941608072765655,"[1, 1, 1, 0, 1, 1, 0, 0, 1, 1]"
4517,2,2,4,0.543405132743145,"[0, 1, 1, 0, 1, 1, 0, 0, 1, 0]"
4518,1,1,2,0.002765653156523107,"[1, 1, 1, 0, 1, 0, 0, 1, 0, 0]"
4519,3,3,6,0.3333521718068956,"[1, 1, 1, 1, 1, 0, 1, 0, 1, 0]"
4520,1,1,2,0.8028227205054215,"[0, 0, 1, 0, 0, 0, 0, 1, 1, 1]"
4521,1,1,2,0.685010588803794,"[0, 0, 0, 1, 0, 1, 0, 0, 1, 1]"
4522,1,1,2,0.9923348960260628,"[0, 1, 0, 1, 0, 1, 1, 1, 0, 0]"
4523,4,4,8,0.01626204966144873,"[1, 0, 0, 0, 0, 0, 0, 1, 0, 1]"
4524,2,2,4,0.4039836472490548,"[1, 0, 1, 1, 0, 0, 0, 1, 0, 1]"
4525,1,1,2,0.41031059776840584,"[1, 1, 0, 1, 0, 0, 0, 1, 0, 0]"
4526,3,3,6,0.9767547433166249,"[1, 1, 1, 1, 0, 0, 1, 0, 0, 1]"
4527,1,1,2,0.4827871100725756,"[1, 1, 1, 1, 1, 0, 0, 0, 1, 0]"
4528,1,1,2,0.22823680197970375,"[0, 1, 1, 1, 0, 0, 1, 0, 0, 0]"
4529,5,5,10,0.6168388626134078,"[0, 1, 1, 0, 1, 1, 0, 0, 0, 1]"
4530,1,1,2,0.1466053143544107,"[0, 0, 1, 0, 0, 0, 1, 0, 0, 0]"
4531,3,3,6,0.8054409088586464,"[0, 1, 1, 1, 0, 0, 0, 0, 1, 1]"
4532,4,4,8,0.8608620332715992,"[1, 0, 0, 0, 0, 1, 1, 1, 0, 0]"
4533,4,4,8,0.5587517496383538,"[0, 1, 1, 0, 0, 0, 1, 1, 1, 1]"
4534,1,1,2,0.508891430550057,"[0, 0, 1, 0, 0, 1, 0, 1, 1, 1]"
4535,2,2,4,0.19138115806687628,"[1, 0, 1, 0, 1, 1, 0, 1, 0, 0]"
4536,9,9,18,0.8308008828194252,"[0, 1, 0, 0, 0, 1, 1, 1, 0, 0]"
4537,5,5,10,0.18514214002098972,"[0, 1, 0, 0, 1, 1, 1, 1, 0, 0]"
4538,5,5,10,0.4918346440724718,"[0, 1, 1, 0, 0, 1, 1, 0, 1, 1]"
4539,4,4,8,0.27440178930690995,"[1, 1, 0, 0, 0, 0, 0, 0, 1, 1]"
4540,1,1,2,0.3052245992293655,"[1, 1, 0, 0, 0, 0, 0, 0, 1, 1]"
4541,3,3,6,0.34239417824036766,"[0, 1, 0, 0, 0, 0, 1, 1, 1, 1]"
4542,3,3,6,0.2751673876933055,"[0, 1, 1, 0, 0, 1, 1, 1, 1, 0]"
4543,2,2,4,0.9875454015054069,"[0, 0, 1, 0, 0, 1, 0, 0, 0, 0]"
4544,1,1,2,0.23905046100410599,"[0, 1, 0, 1, 1, 1, 0, 0, 0, 0]"
4545,4,4,8,0.31846668989159077,"[0, 1, 1, 1, 0, 0, 0, 1, 0, 1]"
4546,1,1,2,0.40459744231489914,"[0, 0, 0, 0, 0, 0, 1, 0, 1, 1]"
4547,1,1,2,0.3134246308635481,"[0, 1, 0, 1, 1, 0, 0, 0, 0, 0]"
4548,1,1,2,0.5423783384692784,"[0, 0, 0, 1, 0, 0, 0, 0, 0, 1]"
4549,1,1,2,0.03443620513226264,"[0, 1, 1, 0, 0, 0, 1, 0, 0, 0]"
4550,2,2,4,0.3695102146557905,"[1, 1, 1, 1, 0, 1, 0, 0, 0, 0]"
4551,12,12,24,0.17035089875441956,"[1, 1, 1, 0, 1, 0, 1, 0, 1, 0]"
4552,1,1,2,0.19738916393209793,"[0, 1, 0, 0, 1, 0, 1, 1, 1, 1]"
4553,1,1,2,0.6325603007108858,"[0, 1, 0, 1, 1, 0, 0, 0, 1, 0]"
4554,1,1,2,0.12904517015156647,"[1, 1, 1, 0, 0, 1, 0, 1, 0, 1]"
4555,1,1,2,0.9115555226881059,"[1, 0, 1, 0, 1, 0, 0, 0, 1, 0]"
4556,1,1,2,0.16051176687989888,"[1, 1, 1, 1, 1, 1, 0, 0, 0, 0]"
4557,1,1,2,0.44432809552345554,"[0, 1, 0, 1, 0, 1, 0, 0, 1, 0]"
4558,4,4,8,0.13073762491110497,"[0, 0, 0, 1, 1, 1, 1, 1, 1, 1]"
4559,2,2,4,0.7026491815128083,"[1, 0, 0, 1, 0, 0, 0, 1, 0, 1]"
4560,2,2,4,0.37014413755432396,"[1, 1, 0, 1, 0, 0, 0, 0, 1, 0]"
4561,1,1,2,0.12262662047433281,"[0, 1, 0, 0, 0, 0, 1, 1, 0, 1]"
4562,2,2,4,0.4492854292530245,"[1, 0, 0, 0, 0, 0, 0, 1, 0, 1]"
4563,1,1,2,0.4150557695704077,"[0, 0, 0, 1, 0, 1, 1, 0, 0, 1]"
4564,4,4,8,0.010598287155214714,"[0, 1, 1, 1, 0, 1, 0, 0, 1, 0]"
4565,1,1,2,0.6283519488273437,"[0, 1, 0, 0, 1, 0, 0, 1, 0, 1]"
4566,1,1,2,0.7495016240190836,"[1, 0, 0, 0, 1, 0, 0, 1, 1, 0]"
4567,2,2,4,0.19313619148118677,"[0, 1, 0, 1, 1, 1, 1, 1, 1, 0]"
4568,1,1,2,0.9978956353453957,"[1, 0, 0, 0, 0, 0, 1, 0, 0, 0]"
4569,1,1,2,0.3014391157429799,"[1, 0, 1, 0, 1, 0, 0, 0, 1, 1]"
4570,1,1,2,0.5175940870202281,"[1, 1, 1, 1, 1, 1, 1, 1, 1, 0]"
4571,3,3,6,0.7741878617311568,"[0, 1, 0, 1, 0, 1, 1, 0, 0, 1]"
4572,2,2,4,0.9823308929512662,"[1, 1, 0, 1, 0, 1, 1, 1, 1, 1]"
4573,5,5,10,0.6069593040887974,"[0, 0, 1, 1, 0, 1, 1, 1, 0, 0]"
4574,2,2,4,0.22731812713625643,"[1, 1, 1, 1, 1, 1, 0, 1, 1, 1]"
4575,2,2,4,0.868496126845155,"[1, 0, 1, 1, 1, 0, 1, 1, 1, 1]"
4576,2,2,4,0.4611711629944265,"[0, 0, 1, 1, 1, 1, 1, 1, 0, 1]"
4577,1,1,2,0.7724885186004354,"[0, 1, 1, 1, 0, 1, 1, 1, 0, 0]"
4578,7,7,14,0.03871771354090303,"[0, 1, 0, 0, 1, 1, 1, 0, 1, 1]"
4579,1,1,2,0.057960483636713134,"[0, 1, 0, 0, 1, 1, 1, 1, 0, 0]"
4580,2,2,4,0.03549318815952496,"[0, 1, 0, 0, 0, 0, 1, 0, 0, 1]"
4581,3,3,6,0.04918947992892142,"[0, 0, 1, 0, 0, 1, 0, 1, 0, 1]"
4582,2,2,4,0.29328660945607565,"[1, 0, 0, 0, 1, 1, 1, 0, 1, 0]"
4583,3,3,6,0.2560729094909314,"[1, 1, 0, 0, 1, 0, 1, 1, 0, 1]"
4584,1,1,2,0.7007861202529084,"[0, 0, 0, 0, 1, 1, 1, 1, 1, 1]"
4585,1,1,2,0.4084397811606103,"[1, 0, 0, 0, 1, 0, 0, 0, 0, 0]"
4586,1,1,2,0.29836680448078134,"[0, 0, 1, 1, 1, 0, 1, 0, 1, 1]"
4587,1,1,2,0.559971229906631,"[0, 1, 1, 1, 1, 0, 0, 1, 0, 0]"
4588,1,1,2,0.6203131435110368,"[1, 1, 0, 0, 0, 0, 1, 1, 0, 0]"
4589,3,3,6,0.19677250923987522,"[1, 0, 1, 0, 1, 0, 1, 0, 1, 1]"
4590,2,2,4,0.914318421947312,"[0, 0, 0, 1, 1, 0, 0, 0, 1, 1]"
4591,1,1,2,0.40869791511208264,"[1, 1, 0, 1, 0, 0, 1, 1, 1, 0]"
4592,1,1,2,0.28649091943212746,"[1, 0, 1, 1, 0, 1, 0, 1, 1, 0]"
4593,3,3,6,0.6212605588661533,"[1, 1, 0, 1, 1, 1, 0, 1, 0, 0]"
4594,2,2,4,0.2882756409254832,"[1, 1, 0, 1, 1, 1, 0, 1, 0, 1]"
4595,1,1,2,0.5806382039874993,"[0, 0, 0, 1, 1, 0, 1, 0, 0, 1]"
4596,5,5,10,0.046871827612857686,"[1, 0, 0, 1, 0, 1, 1, 0, 1, 1]"
4597,2,2,4,0.13047123738449495,"[1, 0, 0, 0, 1, 1, 1, 0, 0, 0]"
4598,2,2,4,0.23658530815840473,"[1, 0, 0, 0, 0, 0, 0, 0, 0, 0]"
4599,5,5,10,0.20300553495930285,"[1, 1, 0, 0, 1, 0, 0, 0, 1, 1]"
4600,2,2,4,0.6524191264141385,"[0, 0, 0, 0, 1, 0, 0, 1, 0, 1]"
4601,2,2,4,0.6116018350793848,"[1, 0, 1, 1, 0, 1, 0, 0, 1, 1]"
4602,3,3,6,0.5586921850030736,"[1, 1, 1, 1, 1, 0, 1, 1, 0, 1]"
4603,1,1,2,0.21383196888498446,"[1, 1, 0, 1, 0, 1, 0, 1, 0, 0]"
4604,1,1,2,0.3550352131525131,"[1, 0, 0, 1, 0, 1, 0, 0, 1, 0]"
4605,1,1,2,0.39987744058681707,"[0, 0, 0, 1, 1, 0, 1, 1, 1, 1]"
4606,2,2,4,0.05268637585792246,"[1, 0, 1, 1, 0, 1, 0, 0, 1, 1]"
4607,3,3,6,0.12872154041198058,"[0, 1, 1, 1, 1, 1, 1, 0, 1, 1]"
4608,1,1,2,0.9307865378343678,"[1, 0, 0, 0, 0, 1, 1, 1, 1, 1]"
4609,5,5,10,0.5348938890712212,"[1, 1, 1, 1, 1, 0, 0, 1, 0, 1]"
4610,2,2,4,0.8605156871123356,"[1, 1, 0, 0, 0, 0, 0, 1, 0, 0]"
4611,1,1,2,0.5854613821159114,"[0, 0, 0, 0, 0, 1, 0, 0, 0, 1]"
4612,4,4,8,0.49507712854962316,"[1, 1, 1, 1, 1, 1, 1, 1, 1, 0]"
4613,1,1,2,0.6478329152173514,"[1, 0, 0, 0, 1, 0, 0, 1, 0, 1]"
4614,2,2,4,0.8816287912628216,"[1, 1, 0, 1, 1, 0, 1, 1, 1, 0]"
4615,1,1,2,0.047303904722499124,"[0, 0, 1, 1, 1, 0, 1, 0, 1, 0]"
4616,1,1,2,0.2603504375193485,"[0, 1, 0, 1, 0, 0, 0, 0, 0, 0]"
4617,3,3,6,0.3228686305175066,"[0, 1, 0, 1, 0, 1, 0, 0, 1, 0]"
4618,1,1,2,0.0180300728832824,"[1, 0, 0, 0, 1, 1, 0, 1, 0, 1]"
4619,1,1,2,0.04386717470206525,"[0, 0, 1, 0, 0, 1, 1, 1, 1, 1]"
4620,1,1,2,0.7026526260508674,"[1, 1, 0, 1, 1, 0, 0, 1, 0, 0]"
4621,2,2,4,0.9624776637655075,"[0, 0, 0, 0, 0, 0, 1, 0, 1, 1]"
4622,4,4,8,0.1664473767417025,"[1, 1, 0, 0, 0, 1, 1, 0, 0, 1]"
4623,1,1,2,0.5475123639926496,"[1, 0, 0, 0, 1, 0, 0, 1, 0, 0]"
4624,1,1,2,0.3520570106116885,"[0, 1, 0, 0, 1, 0, 1, 1, 0, 0]"
4625,2,2,4,0.7659978008846581,"[0, 0, 0, 0, 0, 0, 1, 1, 1, 0]"
4626,4,4,8,0.9415752488315781,"[1, 0, 0, 1, 1, 0, 1, 1, 1, 1]"
4627,1,1,2,0.5728654537548414,"[1, 1, 0, 1, 0, 0, 1, 1, 1, 0]"
4628,3,3,6,0.7639392797155217,"[0, 0, 0, 1, 0, 1, 1, 1, 1, 1]"
4629,3,3,6,0.7943358304722734,"[1, 1, 1, 1, 1, 0, 0, 0, 1, 0]"
4630,1,1,2,0.8724128808326242,"[0, 0, 0, 1, 1, 0, 0, 0, 1, 0]"
4631,2,2,4,0.04936902407153132,"[0, 0, 1, 1, 0, 0, 0, 1, 1, 1]"
4632,1,1,2,0.6108471932098039,"[0, 0, 0, 1, 0, 1, 0, 0, 0, 0]"
4633,1,1,2,0.8404700376383745,"[1, 1, 0, 1, 0, 1, 0, 0, 0, 1]"
4634,4,4,8,0.714080555273055,"[1, 1, 0, 1, 1, 1, 0, 0, 0, 0]"
4635,4,4,8,0.07325700647549016,"[1, 0, 1, 1, 0, 0, 1, 1, 0, 1]"
4636,1,1,2,0.06273432655196454,"[1, 0, 1, 0, 0, 0, 1, 1, 0, 1]"
4637,1,1,2,0.10431519133419054,"[1, 1, 0, 1, 0, 0, 0, 0, 0, 0]"
4638,1,1,2,0.4204708532375536,"[0, 1, 0, 1, 1, 1, 0, 0, 1, 0]"
4639,1,1,2,0.19271190899860458,"[1, 1, 0, 0, 0, 1, 0, 0, 0, 0]"
4640,1,1,2,0.698392416198927,"[1, 1, 0, 0, 0, 0, 1, 1, 0, 1]"
4641,2,2,4,0.2509735441458302,"[0, 1, 0, 1, 0, 0, 1, 0, 1, 0]"
4642,1,1,2,0.3136175108809659,"[1, 1, 0, 1, 0, 1, 1, 0, 1, 1]"
4643,3,3,6,0.7266441180017619,"[0, 0, 0, 0, 0, 1, 1, 1, 0, 1]"
4644,1,1,2,0.6669974140355855,"[1, 1, 1, 0, 0, 0, 1, 1, 0, 0]"
4645,2,2,4,0.8233984873066882,"[1, 0, 1, 0, 1, 1, 1, 0, 1, 0]"
4646,1,1,2,0.5506943838700399,"[0, 0, 0, 1, 1, 1, 0, 1, 0, 0]"
4647,1,1,2,0.662753015580727,"[0, 1, 0, 1, 0, 0, 1, 1, 1, 1]"
4648,1,1,2,0.7235910576198701,"[0, 1, 0, 0, 0, 0, 0, 1, 1, 0]"
4649,1,1,2,0.5829250765434093,"[0, 0, 1, 1, 1, 0, 1, 0, 1, 1]"
4650,1,1,2,0.05029914994531215,"[0, 1, 0, 0, 0, 0, 1, 0, 1, 1]"
4651,1,1,2,0.3222913414307895,"[1, 1, 1, 0, 0, 1, 1, 1, 1, 1]"
4652,1,1,2,0.24752622738893737,"[1, 1, 1, 0, 0, 1, 1, 0, 0, 1]"
4653,1,1,2,0.12039227484633974,"[0, 0, 0, 1, 0, 1, 1, 1, 0, 0]"
4654,3,3,6,0.4570497868243678,"[0, 1, 1, 1, 0, 1, 1, 0, 0, 0]"
4655,2,2,4,0.013156282447517764,"[0, 0, 1, 0, 0, 0, 0, 0, 1, 1]"
4656,6,6,12,0.9302503068661371,"[0, 1, 1, 1, 1, 1, 1, 0, 1, 1]"
4657,2,2,4,0.5432212143287569,"[0, 0, 0, 0, 1, 1, 1, 0, 1, 1]"
4658,1,1,2,0.44819884818524924,"[1, 0, 0, 1, 1, 1, 0, 0, 0, 0]"
4659,3,3,6,0.6437513741937861,"[0, 1, 1, 0, 1, 1, 0, 1, 0, 0]"
4660,2,2,4,0.1377243251730973,"[0, 1, 1, 1, 1, 0, 0, 1, 0, 0]"
4661,1,1,2,0.5460055869790825,"[1, 0, 1, 1, 0, 1, 1, 1, 1, 1]"
4662,1,1,2,0.0340896724868216,"[1, 0, 1, 1, 0, 1, 0, 1, 0, 1]"
4663,1,1,2,0.5557436767116474,"[0, 0, 0, 0, 0, 0, 0, 0, 0, 0]"
4664,4,4,8,0.15242102773422328,"[0, 0, 1, 1, 1, 0, 1, 1, 0, 0]"
4665,2,2,4,0.5626242997042358,"[0, 0, 0, 1, 1, 1, 0, 1, 1, 1]"
4666,3,3,6,0.11043356118564851,"[0, 1, 1, 0, 1, 1, 0, 0, 0, 1]"
4667,3,3,6,0.16307172699189587,"[1, 1, 0, 0, 1, 0, 0, 1, 0, 0]"
4668,3,3,6,0.601616757222811,"[1, 0, 0, 1, 1, 0, 1, 1, 1, 1]"
4669,2,2,4,0.040800924015615414,"[0, 1, 1, 1, 0, 0, 0, 1, 0, 0]"
4670,1,1,2,0.822480668395562,"[1, 1, 1, 1, 0, 1, 0, 0, 1, 1]"
4671,1,1,2,0.30731154807091166,"[0, 1, 1, 0, 0, 0, 1, 0, 1, 0]"
4672,2,2,4,0.8415260691343297,"[0, 1, 0, 1, 0, 1, 1, 1, 0, 1]"
4673,2,2,4,0.08504542390432623,"[0, 1, 1, 1, 0, 0, 1, 1, 1, 1]"
4674,3,3,6,0.13312582399205164,"[1, 0, 1, 0, 1, 1, 0, 1, 1, 1]"
4675,1,1,2,0.41780866026116503,"[1, 1, 1, 1, 0, 1, 1, 0, 0, 1]"
4676,5,5,10,0.24780488660996092,"[1, 0, 1, 1, 0, 0, 1, 1, 1, 1]"
4677,1,1,2,0.6326243655224301,"[1, 1, 0, 1, 1, 1, 1, 1, 0, 0]"
4678,1,1,2,0.8234926935004045,"[1, 0, 1, 0, 1, 0, 1, 0, 0, 0]"
4679,2,2,4,0.5634812824653034,"[1, 0, 1, 1, 0, 0, 1, 0, 1, 1]"
4680,2,2,4,0.9166315285632743,"[0, 1, 0, 0, 0, 1, 1, 0, 0, 0]"
4681,2,2,4,0.8080995293558251,"[1, 1, 1, 1, 0, 0, 1, 0, 0, 0]"
4682,1,1,2,0.14503100857393658,"[1, 0, 1, 0, 1, 0, 0, 0, 0, 0]"
4683,1,1,2,0.8357496931623194,"[0, 0, 0, 0, 1, 1, 0, 1, 1, 1]"
4684,2,2,4,0.08644325581774637,"[0, 1, 0, 0, 1, 1, 0, 0, 1, 1]"
4685,2,2,4,0.409285774749673,"[0, 0, 0, 1, 1, 1, 1, 1, 0, 0]"
4686,1,1,2,0.09125175208967962,"[1, 0, 1, 1, 1, 0, 1, 0, 0, 0]"
4687,6,6,12,0.5485853730489361,"[0, 1, 0, 1, 0, 0, 1, 0, 0, 1]"
4688,5,5,10,0.20812687530501117,"[0, 0, 0, 0, 1, 1, 0, 1, 1, 1]"
4689,2,2,4,0.776924967354823,"[0, 0, 0, 0, 0, 1, 1, 0, 0, 1]"
4690,2,2,4,0.9516701710637042,"[1, 1, 1, 0, 1, 0, 1, 0, 0, 0]"
4691,1,1,2,0.7346231529189359,"[1, 1, 0, 1, 0, 0, 0, 1, 1, 1]"
4692,2,2,4,0.4965100783223142,"[0, 0, 0, 1, 1, 0, 1, 1, 1, 0]"
4693,2,2,4,0.14353898939895593,"[1, 0, 1, 0, 1, 0, 0, 1, 0, 0]"
4694,4,4,8,0.5040083986786514,"[0, 1, 0, 1, 1, 0, 1, 0, 0, 0]"
4695,4,4,8,0.8198711340446679,"[0, 1, 1, 1, 0, 0, 1, 0, 0, 0]"
4696,1,1,2,0.6531315525579158,"[0, 1, 0, 1, 0, 1, 1, 1, 0, 0]"
4697,3,3,6,0.3495180820829019,"[1, 1, 1, 1, 0, 0, 0, 1, 1, 0]"
4698,4,4,8,0.3131433602445788,"[1, 0, 1, 0, 1, 1, 0, 0, 1, 1]"
4699,4,4,8,0.3597395400895945,"[1, 1, 0, 0, 1, 1, 0, 0, 1, 1]"
4700,1,1,2,0.893325442254189,"[1, 0, 1, 0, 0, 0, 1, 1, 1, 1]"
4701,2,2,4,0.6646274090824469,"[0, 1, 1, 0, 1, 0, 0, 0, 1, 0]"
4702,1,1,2,0.4182555651893487,"[0, 0, 0, 0, 0, 1, 1, 0, 0, 0]"
4703,1,1,2,0.7475657053079355,"[0, 1, 0, 0, 0, 1, 0, 1, 0, 1]"
4704,1,1,2,0.3575528161172634,"[1, 1, 0, 1, 0, 1, 1, 1, 1, 0]"
4705,2,2,4,0.05167573411981918,"[1, 1, 1, 0, 1, 1, 1, 0, 1, 1]"
4706,1,1,2,0.335749208732009,"[0, 1, 0, 1, 0, 1, 1, 1, 0, 1]"
4707,1,1,2,0.9096484474796048,"[1, 1, 1, 1, 0, 0, 0, 0, 1, 1]"
4708,1,1,2,0.07126666280740668,"[0, 1, 1, 0, 0, 1, 0, 0, 1, 0]"
4709,2,2,4,0.6093208022529517,"[1, 0, 0, 1, 1, 0, 0, 1, 0, 0]"
4710,4,4,8,0.2242796255973637,"[0, 1, 1, 1, 1, 1, 1, 0, 0, 0]"
4711,1,1,2,0.2371285913992791,"[1, 1, 0, 1, 0, 1, 0, 0, 0, 1]"
4712,1,1,2,0.6122994322848737,"[1, 1, 0, 1, 0, 1, 0, 0, 0, 0]"
4713,3,3,6,0.492487851270497,"[1, 0, 1, 1, 0, 1, 1, 0, 0, 1]"
4714,2,2,4,0.1797984388353724,"[1, 1, 0, 1, 0, 0, 0, 1, 1, 1]"
4715,1,1,2,0.2240596074930118,"[1, 1, 0, 1, 0, 0, 0, 1, 0, 1]"
4716,2,2,4,0.678983837161171,"[0, 0, 0, 1, 1, 1, 1, 0, 1, 0]"
4717,1,1,2,0.6216635511700545,"[0, 1, 0, 0, 1, 0, 0, 0, 0, 1]"
4718,1,1,2,0.8883546502108282,"[0, 1, 0, 1, 1, 1, 0, 0, 0, 0]"
4719,2,2,4,0.5178846214063296,"[1, 1, 1, 1, 0, 0, 1, 1, 0, 1]"
4720,1,1,2,0.38296142098696906,"[0, 1, 1, 0, 1, 0, 1, 1, 1, 0]"
4721,5,5,10,0.09991754312583911,"[0, 1, 0, 0, 1, 1, 1, 1, 0, 1]"
4722,1,1,2,0.6066070145041783,"[0, 0, 1, 1, 1, 1, 0, 0, 0, 1]"
4723,5,5,10,0.17485499617480105,"[1, 0, 0, 0, 1, 1, 1, 1, 0, 1]"
4724,2,2,4,0.4876061566478682,"[1, 1, 1, 0, 1, 0, 1, 0, 1, 1]"
4725,4,4,8,0.33642451550669494,"[0, 1, 1, 0, 1, 1, 1, 0, 0, 1]"
4726,1,1,2,0.46806123017009005,"[0, 0, 0, 0, 0, 1, 1, 1, 1, 0]"
4727,4,4,8,0.1336796732881581,"[0, 0, 1, 0, 1, 1, 1, 1, 1, 1]"
4728,2,2,4,0.43190167813893154,"[1, 1, 1, 1, 1, 0, 0, 1, 1, 1]"
4729,1,1,2,0.1566467408235036,"[0, 1, 1, 0, 1, 0, 1, 0, 1, 1]"
4730,2,2,4,0.722388013582232,"[1, 1, 0, 0, 1, 0, 1, 0, 1, 1]"
4731,1,1,2,0.5612828397573476,"[0, 1, 0, 1, 0, 1, 1, 0, 0, 0]"
4732,2,2,4,0.7372064192835237,"[0, 1, 1, 1, 1, 1, 0, 0, 0, 0]"
4733,1,1,2,0.3447536160691017,"[1, 1, 1, 1, 0, 0, 1, 1, 0, 1]"
4734,2,2,4,0.4008248413516373,"[1, 0, 0, 0, 1, 1, 1, 0, 1, 1]"
4735,1,1,2,0.8391348499567548,"[1, 1, 1, 0, 0, 0, 1, 1, 1, 0]"
4736,2,2,4,0.7375874278101772,"[1, 0, 0, 1, 0, 0, 1, 0, 0, 1]"
4737,1,1,2,0.6579857338176339,"[0, 1, 1, 0, 0, 0, 1, 0, 0, 1]"
4738,1,1,2,0.43814911672662715,"[0, 0, 1, 0, 1, 0, 0, 1, 0, 1]"
4739,2,2,4,0.41365915096935557,"[1, 0, 1, 0, 0, 1, 1, 0, 0, 1]"
4740,1,1,2,0.4070460347197776,"[1, 1, 1, 0, 0, 1, 0, 0, 0, 0]"
4741,2,2,4,0.5637929191465951,"[0, 1, 0, 0, 0, 1, 0, 0, 0, 1]"
4742,1,1,2,0.4902628400171043,"[0, 0, 1, 1, 0, 1, 0, 1, 1, 1]"
4743,1,1,2,0.012331132231230946,"[1, 0, 0, 0, 0, 1, 1, 1, 0, 0]"
4744,1,1,2,0.1681947574974555,"[1, 1, 0, 1, 1, 1, 0, 0, 1, 1]"
4745,1,1,2,0.943641432809338,"[1, 0, 0, 1, 0, 0, 1, 1, 0, 1]"
4746,1,1,2,0.8566441599155264,"[0, 1, 1, 0, 0, 1, 1, 0, 1, 0]"
4747,1,1,2,0.7479651318652204,"[0, 0, 0, 0, 1, 0, 1, 1, 1, 0]"
4748,1,1,2,0.4629087245029694,"[0, 0, 0, 1, 1, 1, 1, 0, 0, 1]"
4749,1,1,2,0.37639347192410555,"[0, 0, 0, 0, 1, 1, 0, 1, 0, 1]"
4750,2,2,4,0.20515408923752143,"[1, 0, 0, 0, 1, 1, 0, 0, 0, 1]"
4751,1,1,2,0.5792936207941073,"[0, 1, 1, 0, 0, 1, 1, 1, 1, 0]"
4752,5,5,10,0.24243534205482997,"[0, 0, 1, 1, 0, 1, 1, 1, 1, 0]"
4753,2,2,4,0.9008930396944411,"[0, 0, 1, 1, 0, 1, 1, 0, 0, 1]"
4754,2,2,4,0.05364247329467264,"[0, 1, 0, 1, 0, 1, 0, 0, 0, 1]"
4755,1,1,2,0.1554044156771337,"[0, 1, 0, 1, 0, 1, 1, 0, 1, 1]"
4756,1,1,2,0.7694034680316264,"[1, 0, 0, 0, 0, 0, 0, 0, 0, 0]"
4757,3,3,6,0.22019154157336585,"[1, 1, 1, 1, 1, 1, 0, 1, 1, 0]"
4758,3,3,6,0.603518484510794,"[1, 1, 1, 1, 1, 1, 1, 1, 1, 0]"
4759,1,1,2,0.42342235775002723,"[0, 0, 1, 0, 0, 1, 0, 1, 0, 0]"
4760,1,1,2,0.7483926440408998,"[0, 0, 0, 1, 1, 1, 0, 0, 0, 0]"
4761,1,1,2,0.2913574169400558,"[1, 0, 0, 0, 1, 0, 1, 0, 1, 1]"
4762,1,1,2,0.7881983476755362,"[1, 0, 0, 0, 0, 0, 1, 1, 0, 1]"
4763,2,2,4,0.15344311848197434,"[1, 0, 0, 1, 0, 1, 0, 0, 0, 1]"
4764,8,8,16,0.7880938232765478,"[1, 1, 0, 1, 0, 1, 0, 1, 1, 0]"
4765,1,1,2,0.021961886128951003,"[0, 1, 0, 1, 0, 1, 1, 0, 1, 0]"
4766,1,1,2,0.795311718129417,"[0, 1, 0, 0, 0, 0, 1, 1, 1, 0]"
4767,4,4,8,0.7998660070815672,"[0, 1, 0, 1, 1, 0, 1, 1, 0, 0]"
4768,1,1,2,0.9722927811106947,"[1, 1, 0, 0, 0, 0, 1, 1, 0, 0]"
4769,3,3,6,0.8084369756862504,"[0, 0, 1, 1, 1, 1, 1, 0, 0, 1]"
4770,1,1,2,0.447697003301991,"[1, 1, 0, 0, 0, 0, 1, 1, 1, 1]"
4771,1,1,2,0.5371741663572647,"[0, 0, 0, 0, 1, 0, 0, 0, 1, 0]"
4772,1,1,2,0.2740640016346543,"[0, 1, 1, 0, 1, 1, 1, 1, 0, 1]"
4773,4,4,8,0.7308646541464011,"[0, 0, 0, 0, 0, 1, 0, 1, 1, 0]"
4774,5,5,10,0.1634934030585099,"[1, 0, 1, 1, 1, 1, 0, 0, 1, 0]"
4775,1,1,2,0.036166701487651554,"[0, 0, 0, 0, 1, 0, 1, 0, 1, 1]"
4776,1,1,2,0.17441966994344915,"[1, 1, 1, 1, 0, 0, 1, 1, 0, 0]"
4777,1,1,2,0.9445127514509222,"[1, 1, 1, 0, 0, 0, 0, 1, 0, 0]"
4778,5,5,10,0.8148803226397693,"[1, 1, 0, 1, 1, 0, 0, 0, 1, 0]"
4779,1,1,2,0.6642014785232867,"[0, 0, 0, 1, 0, 1, 1, 1, 1, 0]"
4780,1,1,2,0.02003043799947901,"[1, 0, 0, 0, 1, 1, 0, 1, 1, 1]"
4781,4,4,8,0.5432018317380257,"[1, 0, 0, 1, 0, 1, 0, 1, 0, 1]"
4782,1,1,2,0.7674553690685263,"[0, 0, 0, 1, 0, 0, 1, 1, 1, 0]"
4783,1,1,2,0.05934866558437224,"[0, 0, 0, 0, 0, 0, 1, 0, 1, 1]"
4784,2,2,4,0.8071251990203401,"[0, 1, 1, 0, 0, 1, 0, 0, 0, 0]"
4785,1,1,2,0.568297024923917,"[0, 0, 0, 0, 0, 1, 0, 1, 1, 1]"
4786,4,4,8,0.4598675009196095,"[0, 0, 1, 1, 1, 0, 1, 0, 1, 1]"
4787,1,1,2,0.2385796553894659,"[0, 1, 1, 0, 1, 0, 0, 0, 1, 0]"
4788,1,1,2,0.7923872289578672,"[0, 0, 0, 1, 0, 1, 1, 1, 1, 1]"
4789,2,2,4,0.1725434886428452,"[1, 0, 1, 1, 0, 0, 1, 0, 0, 0]"
4790,1,1,2,0.5600737008014972,"[0, 0, 0, 0, 1, 1, 1, 1, 0, 1]"
4791,1,1,2,0.5985755636279639,"[0, 1, 0, 1, 1, 1, 0, 1, 0, 1]"
4792,1,1,2,0.5158387880839269,"[0, 0, 0, 1, 0, 1, 1, 1, 0, 0]"
4793,1,1,2,0.9664438315324247,"[1, 1, 1, 0, 0, 0, 1, 1, 0, 1]"
4794,1,1,2,0.4872336126759086,"[0, 1, 0, 1, 1, 1, 1, 1, 1, 1]"
4795,2,2,4,0.44322872030431104,"[1, 0, 1, 0, 0, 0, 0, 1, 0, 0]"
4796,3,3,6,0.16736471024429633,"[0, 1, 0, 0, 1, 1, 1, 0, 0, 1]"
4797,5,5,10,0.5810643224807431,"[1, 0, 1, 1, 1, 0, 0, 0, 1, 1]"
4798,2,2,4,0.8449264511541997,"[1, 0, 1, 1, 0, 1, 1, 0, 0, 1]"
4799,1,1,2,0.14927968212699794,"[0, 0, 1, 0, 1, 1, 1, 0, 1, 0]"
4800,1,1,2,0.26282515614313684,"[1, 1, 0, 1, 0, 0, 0, 0, 1, 1]"
4801,1,1,2,0.2681906948253049,"[0, 1, 0, 0, 1, 0, 1, 1, 1, 0]"
4802,1,1,2,0.6508461611778792,"[0, 1, 1, 0, 1, 0, 0, 0, 0, 1]"
4803,1,1,2,0.7390349179225335,"[1, 0, 1, 0, 1, 1, 0, 1, 1, 1]"
4804,1,1,2,0.2687298700681944,"[1, 0, 1, 0, 0, 0, 0, 0, 0, 0]"
4805,1,1,2,0.2965932237207114,"[1, 0, 1, 1, 0, 0, 1, 0, 0, 0]"
4806,1,1,2,0.5834605086015907,"[1, 0, 0, 0, 1, 0, 1, 0, 0, 0]"
4807,1,1,2,0.38066027588120877,"[1, 0, 1, 1, 1, 1, 1, 1, 0, 1]"
4808,6,6,12,0.4889701895845012,"[0, 0, 0, 0, 1, 0, 1, 1, 1, 1]"
4809,2,2,4,0.7456902246915139,"[0, 1, 0, 1, 0, 0, 1, 1, 0, 1]"
4810,3,3,6,0.8034808172538279,"[0, 1, 0, 1, 1, 1, 0, 0, 1, 1]"
4811,2,2,4,0.5559447368436936,"[1, 1, 1, 0, 0, 1, 1, 0, 0, 0]"
4812,4,4,8,0.7452640380960492,"[1, 0, 0, 1, 0, 1, 1, 1, 0, 1]"
4813,1,1,2,0.07965714163081972,"[0, 0, 0, 0, 1, 0, 0, 1, 0, 0]"
4814,4,4,8,0.132328673253437,"[0, 1, 1, 1, 1, 1, 0, 1, 1, 1]"
4815,1,1,2,0.11558351415930224,"[0, 0, 1, 0, 1, 0, 1, 0, 0, 0]"
4816,1,1,2,0.69356081177701,"[1, 0, 1, 0, 0, 1, 1, 1, 1, 1]"
4817,1,1,2,0.42798787724313114,"[0, 0, 1, 1, 1, 0, 1, 0, 1, 0]"
4818,1,1,2,0.3756175966721309,"[1, 0, 0, 0, 0, 1, 1, 0, 0, 0]"
4819,1,1,2,0.5941043838916737,"[1, 0, 0, 0, 1, 1, 1, 1, 0, 1]"
4820,6,6,12,0.33664836540682086,"[0, 1, 1, 0, 1, 1, 1, 1, 0, 1]"
4821,4,4,8,0.034454470040574114,"[0, 1, 1, 1, 0, 1, 0, 1, 1, 1]"
4822,2,2,4,0.9344446333925276,"[0, 1, 0, 0, 1, 1, 0, 1, 0, 0]"
4823,1,1,2,0.6140695956595593,"[0, 1, 0, 0, 1, 1, 0, 0, 0, 0]"
4824,1,1,2,0.27299478828896284,"[1, 0, 1, 0, 0, 1, 1, 1, 1, 1]"
4825,8,8,16,0.49504423637896344,"[1, 1, 0, 0, 1, 1, 0, 1, 1, 0]"
4826,1,1,2,0.28287805980748704,"[1, 1, 1, 0, 0, 0, 1, 0, 0, 1]"
4827,1,1,2,0.33824680982884736,"[1, 0, 1, 0, 1, 0, 1, 1, 1, 0]"
4828,2,2,4,0.5417165315467608,"[1, 1, 1, 0, 0, 0, 1, 0, 0, 1]"
4829,1,1,2,0.6090892724120205,"[1, 0, 0, 0, 0, 1, 0, 0, 1, 0]"
4830,1,1,2,0.19003161907617205,"[1, 1, 1, 1, 1, 1, 1, 1, 0, 0]"
4831,1,1,2,0.013132980126000171,"[1, 1, 0, 1, 0, 0, 1, 0, 1, 0]"
4832,2,2,4,0.7424945684404595,"[0, 1, 0, 1, 0, 0, 1, 1, 0, 1]"
4833,1,1,2,0.18876268673435814,"[0, 1, 0, 1, 0, 0, 1, 0, 0, 1]"
4834,1,1,2,0.06324203823327268,"[0, 0, 0, 1, 1, 1, 0, 0, 0, 0]"
4835,2,2,4,0.1790546297736848,"[0, 1, 0, 1, 1, 0, 1, 1, 0, 0]"
4836,2,2,4,0.8874304603803339,"[1, 1, 0, 1, 1, 1, 0, 0, 1, 1]"
4837,1,1,2,0.9160973627315244,"[0, 1, 1, 1, 1, 1, 1, 1, 0, 0]"
4838,9,9,18,0.8450350145608955,"[1, 1, 1, 0, 1, 1, 1, 0, 1, 0]"
4839,2,2,4,0.6037878922414337,"[1, 0, 1, 1, 0, 0, 0, 0, 1, 0]"
4840,1,1,2,0.023158301991660246,"[1, 1, 1, 0, 0, 0, 1, 0, 1, 0]"
4841,1,1,2,0.23156637503802058,"[1, 0, 0, 0, 1, 1, 1, 0, 1, 0]"
4842,1,1,2,0.9281739750738743,"[0, 1, 0, 1, 1, 1, 0, 1, 1, 0]"
4843,3,3,6,0.6285750920407347,"[1, 0, 0, 1, 0, 1, 0, 1, 1, 1]"
4844,4,4,8,0.5078659446159544,"[0, 1, 1, 1, 0, 1, 0, 0, 1, 1]"
4845,1,1,2,0.857363938798638,"[1, 1, 1, 1, 0, 0, 0, 0, 0, 1]"
4846,1,1,2,0.9157285621370633,"[1, 0, 1, 0, 0, 0, 1, 0, 1, 0]"
4847,1,1,2,0.1453559174374044,"[1, 0, 0, 1, 1, 0, 1, 0, 1, 1]"
4848,3,3,6,0.480170590032704,"[1, 1, 1, 0, 1, 0, 1, 0, 0, 1]"
4849,1,1,2,0.1746130036028497,"[1, 1, 1, 1, 1, 1, 0, 0, 0, 1]"
4850,1,1,2,0.29950579670620003,"[0, 1, 0, 1, 0, 1, 0, 1, 1, 1]"
4851,2,2,4,0.8289860122499983,"[1, 0, 1, 1, 0, 0, 1, 0, 0, 1]"
4852,2,2,4,0.532303806507024,"[0, 1, 1, 0, 0, 0, 0, 0, 0, 1]"
4853,1,1,2,0.40598952469334604,"[1, 0, 0, 1, 0, 1, 1, 1, 1, 0]"
4854,1,1,2,0.7040740873248363,"[1, 1, 0, 0, 1, 1, 0, 1, 0, 0]"
4855,1,1,2,0.6008309048570586,"[1, 0, 0, 0, 1, 0, 0, 0, 0, 0]"
4856,1,1,2,0.47712227944730035,"[1, 1, 0, 0, 0, 0, 0, 1, 0, 0]"
4857,2,2,4,0.21660113610948162,"[1, 1, 0, 0, 0, 0, 1, 0, 1, 1]"
4858,1,1,2,0.004027776477620648,"[1, 0, 1, 0, 0, 0, 0, 1, 0, 0]"
4859,1,1,2,0.23421600328342307,"[0, 0, 1, 0, 0, 1, 0, 0, 0, 0]"
4860,3,3,6,0.10994924952760698,"[0, 1, 1, 1, 0, 0, 1, 1, 0, 1]"
4861,1,1,2,0.14500093539902825,"[1, 0, 1, 0, 0, 1, 0, 0, 0, 0]"
4862,2,2,4,0.7871228822464224,"[0, 0, 0, 0, 0, 1, 0, 1, 0, 0]"
4863,3,3,6,0.44147701078589563,"[0, 1, 1, 0, 0, 1, 1, 1, 1, 1]"
4864,3,3,6,0.9915191610173867,"[0, 0, 1, 1, 1, 0, 0, 0, 0, 1]"
4865,2,2,4,0.0995978689591207,"[1, 1, 1, 0, 0, 1, 0, 1, 0, 0]"
4866,2,2,4,0.6996491556311063,"[0, 0, 0, 0, 1, 1, 1, 1, 1, 1]"
4867,4,4,8,0.3780232267381368,"[1, 1, 0, 1, 1, 1, 1, 0, 0, 0]"
4868,2,2,4,0.6319725742140676,"[0, 1, 0, 1, 0, 1, 0, 1, 1, 1]"
4869,2,2,4,0.5944478266056524,"[0, 1, 1, 1, 1, 0, 1, 0, 0, 1]"
4870,1,1,2,0.6085583038851606,"[0, 1, 0, 1, 1, 0, 1, 1, 0, 1]"
4871,1,1,2,0.3272997478669313,"[0, 0, 1, 0, 0, 1, 0, 1, 0, 0]"
4872,1,1,2,0.9128195726894196,"[0, 1, 1, 0, 0, 0, 0, 0, 1, 1]"
4873,1,1,2,0.32762465766151483,"[0, 1, 1, 1, 1, 1, 1, 1, 0, 1]"
4874,4,4,8,0.11575810040895773,"[0, 1, 0, 1, 0, 0, 0, 0, 1, 0]"
4875,2,2,4,0.8130737596351721,"[0, 1, 0, 1, 1, 0, 1, 1, 1, 0]"
4876,2,2,4,0.6115311275354088,"[0, 0, 1, 0, 0, 1, 1, 1, 1, 1]"
4877,1,1,2,0.961990488710292,"[0, 1, 0, 1, 1, 0, 1, 0, 0, 1]"
4878,1,1,2,0.5928847900115849,"[0, 0, 0, 0, 1, 0, 1, 0, 0, 1]"
4879,1,1,2,0.9951585671706277,"[0, 1, 0, 1, 1, 0, 0, 1, 0, 0]"
4880,1,1,2,0.7264843128451207,"[0, 1, 1, 0, 0, 1, 1, 0, 1, 0]"
4881,1,1,2,0.9608468531139177,"[1, 1, 0, 0, 0, 0, 0, 1, 1, 1]"
4882,1,1,2,0.8087688953778437,"[1, 0, 1, 0, 0, 1, 1, 1, 0, 0]"
4883,1,1,2,0.998300637664586,"[1, 1, 0, 0, 1, 0, 1, 1, 1, 1]"
4884,1,1,2,0.46779175934983086,"[1, 0, 1, 1, 1, 0, 0, 0, 1, 0]"
4885,1,1,2,0.48664081166092155,"[0, 0, 1, 0, 0, 0, 1, 0, 1, 1]"
4886,1,1,2,0.8310817076805319,"[1, 0, 0, 0, 0, 0, 0, 1, 0, 0]"
4887,5,5,10,0.7609374481752961,"[1, 1, 1, 1, 0, 0, 1, 0, 1, 1]"
4888,3,3,6,0.4134000429077468,"[1, 1, 1, 1, 0, 1, 1, 0, 0, 1]"
4889,1,1,2,0.3120697282152127,"[1, 0, 1, 0, 0, 1, 0, 0, 1, 0]"
4890,2,2,4,0.8325367411879914,"[0, 0, 1, 0, 0, 0, 1, 1, 1, 0]"
4891,4,4,8,0.7226405408242548,"[1, 0, 0, 1, 1, 1, 0, 1, 1, 0]"
4892,3,3,6,0.4672121853350175,"[1, 0, 0, 0, 1, 1, 0, 0, 1, 1]"
4893,2,2,4,0.7037831521640098,"[0, 1, 0, 1, 1, 1, 0, 0, 1, 1]"
4894,1,1,2,0.693159035727244,"[1, 1, 0, 0, 0, 1, 0, 0, 1, 0]"
4895,4,4,8,0.19425802164739392,"[1, 1, 0, 1, 1, 0, 0, 1, 1, 1]"
4896,1,1,2,0.23905937321743553,"[1, 1, 1, 1, 0, 0, 1, 0, 0, 1]"
4897,1,1,2,0.15507102821988128,"[1, 0, 1, 1, 1, 1, 1, 1, 1, 0]"
4898,2,2,4,0.05677731114713913,"[0, 1, 0, 0, 0, 1, 1, 1, 1, 0]"
4899,2,2,4,0.05934950678919837,"[1, 1, 0, 1, 0, 1, 0, 0, 0, 1]"
4900,1,1,2,0.890986940911355,"[1, 0, 1, 1, 0, 1, 0, 0, 0, 0]"
4901,1,1,2,0.3075235084026495,"[1, 1, 1, 0, 0, 0, 1, 0, 1, 0]"
4902,1,1,2,0.31604040862277083,"[0, 1, 1, 0, 0, 1, 0, 1, 1, 0]"
4903,1,1,2,0.4276392174231016,"[1, 0, 1, 1, 0, 0, 0, 1, 1, 0]"
4904,2,2,4,0.523422497811592,"[1, 0, 1, 0, 1, 0, 0, 1, 1, 1]"
4905,3,3,6,0.553400551240946,"[1, 0, 0, 1, 1, 1, 1, 1, 1, 1]"
4906,4,4,8,0.5374443829908192,"[1, 0, 1, 1, 0, 1, 0, 0, 1, 1]"
4907,2,2,4,0.46110468173994834,"[0, 1, 1, 0, 1, 1, 0, 1, 0, 0]"
4908,2,2,4,0.7077063122438556,"[0, 1, 1, 0, 0, 0, 0, 1, 0, 0]"
4909,1,1,2,0.2817617154893465,"[1, 0, 0, 0, 0, 0, 1, 0, 1, 0]"
4910,1,1,2,0.8359416217644062,"[0, 1, 1, 0, 0, 1, 0, 1, 1, 0]"
4911,2,2,4,0.4144459443255829,"[0, 1, 1, 1, 0, 1, 0, 1, 1, 1]"
4912,1,1,2,0.2549874050718812,"[1, 0, 0, 0, 0, 0, 0, 1, 0, 0]"
4913,1,1,2,0.4586337212983935,"[1, 1, 0, 0, 0, 0, 1, 1, 1, 0]"
4914,2,2,4,0.06557061913556583,"[1, 0, 0, 0, 1, 0, 0, 1, 0, 0]"
4915,2,2,4,0.8833690969111073,"[0, 0, 0, 0, 1, 1, 0, 0, 0, 0]"
4916,1,1,2,0.8852062306338129,"[0, 1, 1, 0, 0, 1, 0, 0, 0, 1]"
4917,1,1,2,0.814651338325351,"[0, 0, 0, 0, 0, 0, 1, 1, 1, 1]"
4918,1,1,2,0.278654391174867,"[0, 1, 0, 0, 0, 0, 0, 0, 0, 0]"
4919,2,2,4,0.33795685284492194,"[0, 1, 1, 0, 1, 1, 0, 1, 1, 0]"
4920,1,1,2,0.6958880304413553,"[1, 0, 0, 1, 1, 1, 1, 1, 0, 1]"
4921,2,2,4,0.5179265959852193,"[1, 0, 1, 0, 1, 1, 0, 1, 0, 1]"
4922,4,4,8,0.5408050235211685,"[1, 0, 0, 1, 1, 1, 1, 1, 0, 0]"
4923,1,1,2,0.9049472354660306,"[0, 0, 1, 1, 1, 1, 1, 1, 1, 0]"
4924,1,1,2,0.8840622789643625,"[1, 1, 0, 1, 1, 0, 1, 1, 0, 1]"
4925,2,2,4,0.7955763977057356,"[0, 0, 1, 0, 0, 0, 1, 1, 0, 0]"
4926,1,1,2,0.16014973508291208,"[0, 1, 1, 0, 0, 0, 1, 1, 0, 1]"
4927,3,3,6,0.3834490465854755,"[0, 1, 0, 0, 0, 0, 0, 1, 1, 1]"
4928,1,1,2,0.3303770468433834,"[0, 1, 0, 1, 1, 0, 0, 0, 1, 1]"
4929,2,2,4,0.7336090811365737,"[0, 0, 1, 1, 1, 1, 0, 1, 1, 1]"
4930,1,1,2,0.773936718534468,"[0, 1, 0, 1, 0, 0, 0, 0, 1, 0]"
4931,1,1,2,0.23232820220970107,"[1, 1, 0, 0, 1, 1, 1, 1, 1, 0]"
4932,2,2,4,0.6787958941668711,"[1, 1, 0, 1, 0, 0, 0, 0, 0, 1]"
4933,3,3,6,0.06770993063668218,"[1, 0, 1, 1, 0, 1, 0, 0, 0, 0]"
4934,1,1,2,0.8306671664125933,"[0, 0, 0, 0, 0, 0, 1, 1, 0, 0]"
4935,1,1,2,0.7041115783493178,"[0, 0, 1, 0, 1, 0, 1, 1, 0, 0]"
4936,2,2,4,0.7497049071247985,"[1, 0, 0, 1, 0, 0, 1, 0, 1, 1]"
4937,1,1,2,0.258943205318796,"[1, 1, 0, 0, 1, 1, 0, 0, 0, 0]"
4938,1,1,2,0.5600162427028984,"[0, 1, 1, 1, 0, 1, 0, 1, 1, 0]"
4939,4,4,8,0.9782829934091519,"[1, 1, 0, 0, 1, 0, 1, 0, 1, 0]"
4940,1,1,2,0.40074238857073574,"[1, 1, 1, 0, 0, 1, 1, 0, 0, 0]"
4941,1,1,2,0.5018701132247392,"[0, 1, 0, 0, 0, 1, 1, 0, 0, 1]"
4942,5,5,10,0.23988127417475524,"[0, 0, 1, 0, 1, 1, 1, 1, 1, 0]"
4943,2,2,4,0.5185837916425947,"[0, 1, 1, 0, 0, 0, 0, 1, 1, 1]"
4944,2,2,4,0.7300122819450848,"[0, 1, 1, 0, 0, 1, 1, 1, 1, 1]"
4945,1,1,2,0.1936817557351358,"[1, 1, 0, 0, 1, 1, 0, 1, 1, 0]"
4946,2,2,4,0.6027927882311415,"[1, 1, 1, 0, 1, 1, 0, 1, 1, 0]"
4947,5,5,10,0.7821661366278875,"[1, 1, 1, 1, 1, 1, 0, 0, 0, 0]"
4948,1,1,2,0.6396795708550075,"[1, 1, 0, 0, 1, 1, 0, 1, 0, 0]"
4949,1,1,2,0.9284601436829333,"[1, 1, 0, 1, 1, 1, 1, 0, 0, 0]"
4950,2,2,4,0.7260916749002428,"[0, 1, 1, 0, 1, 0, 0, 1, 1, 1]"
4951,2,2,4,0.17443587882645628,"[1, 1, 0, 1, 0, 0, 1, 0, 0, 1]"
4952,1,1,2,0.6108051872892054,"[1, 0, 1, 0, 1, 0, 1, 1, 1, 1]"
4953,1,1,2,0.6009301243725376,"[1, 0, 0, 1, 1, 1, 1, 1, 1, 0]"
4954,3,3,6,0.1704511887689788,"[0, 1, 0, 1, 0, 0, 0, 1, 0, 0]"
4955,1,1,2,0.04727547746824112,"[1, 1, 0, 1, 0, 1, 1, 1, 0, 1]"
4956,1,1,2,0.12900277494751344,"[0, 1, 0, 0, 1, 1, 0, 0, 1, 1]"
4957,2,2,4,0.8466204906295116,"[0, 0, 1, 1, 0, 1, 0, 0, 1, 0]"
4958,1,1,2,0.17497860918073127,"[1, 0, 0, 0, 0, 0, 0, 0, 0, 1]"
4959,3,3,6,0.5262752045678865,"[0, 0, 0, 0, 0, 0, 0, 0, 1, 1]"
4960,2,2,4,0.4328657179415465,"[1, 0, 0, 1, 0, 0, 1, 1, 0, 1]"
4961,2,2,4,0.9697346338200529,"[0, 0, 1, 1, 1, 1, 0, 0, 1, 0]"
4962,2,2,4,0.10298275256724387,"[1, 1, 0, 1, 0, 1, 0, 0, 1, 1]"
4963,1,1,2,0.6000987712514951,"[1, 0, 0, 1, 0, 1, 0, 1, 1, 1]"
4964,1,1,2,0.41165013539449713,"[1, 1, 1, 1, 1, 1, 1, 1, 1, 0]"
4965,5,5,10,0.9995379348343011,"[1, 0, 0, 1, 1, 1, 1, 0, 0, 0]"
4966,2,2,4,0.8086126842748534,"[0, 1, 0, 0, 1, 1, 1, 0, 0, 0]"
4967,1,1,2,0.3935589420392983,"[0, 0, 1, 1, 0, 0, 1, 1, 0, 0]"
4968,1,1,2,0.114060845474799,"[0, 1, 0, 0, 1, 1, 0, 0, 1, 1]"
4969,1,1,2,0.4861276265263308,"[0, 0, 1, 0, 0, 0, 0, 0, 0, 0]"
4970,3,3,6,0.7218942387925976,"[1, 1, 1, 0, 1, 1, 1, 1, 0, 0]"
4971,4,4,8,0.3065759259017994,"[1, 1, 0, 0, 1, 0, 1, 0, 1, 0]"
4972,2,2,4,0.8711065194384968,"[0, 1, 1, 1, 0, 1, 1, 1, 1, 0]"
4973,2,2,4,0.4097637802677573,"[0, 1, 0, 1, 0, 1, 1, 0, 1, 0]"
4974,2,2,4,0.209617268140335,"[0, 0, 1, 1, 0, 1, 0, 0, 0, 1]"
4975,1,1,2,0.029015008382011653,"[1, 0, 1, 0, 1, 0, 0, 0, 1, 0]"
4976,1,1,2,0.5903084212184254,"[0, 0, 0, 0, 1, 0, 1, 0, 0, 1]"
4977,1,1,2,0.23156412604019627,"[1, 1, 1, 1, 1, 0, 1, 0, 0, 0]"
4978,2,2,4,0.315779486722917,"[0, 1, 1, 0, 0, 1, 1, 0, 0, 1]"
4979,1,1,2,0.47899520991165745,"[0, 0, 0, 0, 1, 1, 0, 1, 1, 1]"
4980,2,2,4,0.19294614843602076,"[1, 0, 1, 1, 1, 0, 0, 1, 0, 1]"
4981,2,2,4,0.49119279049039755,"[1, 1, 0, 1, 0, 1, 1, 0, 0, 1]"
4982,3,3,6,0.9930500537325115,"[1, 1, 0, 1, 1, 1, 1, 0, 1, 1]"
4983,1,1,2,0.29728061690070395,"[0, 0, 0, 0, 0, 0, 1, 0, 0, 0]"
4984,1,1,2,0.635744511588989,"[1, 0, 1, 0, 1, 1, 0, 1, 1, 1]"
4985,1,1,2,0.37293922985275496,"[0, 0, 0, 1, 0, 0, 0, 0, 0, 0]"
4986,2,2,4,0.8428921437450186,"[1, 0, 1, 1, 0, 1, 0, 0, 1, 1]"
4987,1,1,2,0.315217635316135,"[0, 0, 0, 1, 1, 0, 0, 0, 1, 0]"
4988,1,1,2,0.3544294142057678,"[0, 0, 1, 1, 1, 1, 0, 0, 0, 1]"
4989,2,2,4,0.09131706251830041,"[0, 0, 1, 1, 0, 0, 0, 1, 1, 1]"
4990,2,2,4,0.7878967907630585,"[1, 1, 0, 1, 1, 1, 0, 1, 0, 0]"
4991,1,1,2,0.5116497188367244,"[0, 0, 1, 0, 0, 1, 1, 0, 1, 1]"
4992,1,1,2,0.1737188713491754,"[1, 0, 1, 0, 0, 1, 0, 1, 0, 0]"
4993,1,1,2,0.82164066525669,"[0, 0, 1, 0, 1, 1, 1, 0, 1, 0]"
4994,5,5,10,0.4888273463505276,"[1, 0, 1, 0, 1, 1, 1, 1, 0, 1]"
4995,1,1,2,0.13679100494401486,"[1, 1, 0, 0, 0, 0, 0, 1, 1, 1]"
4996,2,2,4,0.7503808857033388,"[0, 0, 1, 0, 0, 1, 0, 0, 0, 1]"
4997,2,2,4,0.6063835249810878,"[1, 0, 0, 0, 0, 0, 0, 0, 1, 1]"
4998,2,2,4,0.48733061815494505,"[1, 0, 1, 0, 1, 0, 0, 1, 1, 1]"
4999,1,1,2,0.8170585929270957,"[1, 0, 1, 0, 1, 1, 0, 1, 1, 1]"
5000,1,1,2,0.961611706190903,"[0, 1, 1, 1, 1, 1, 0, 1, 0, 0]"
5001,1,1,2,0.5772481635914856,"[0, 1, 0, 0, 0, 1, 1, 0, 0, 0]"
5002,1,1,2,0.2868714304549793,"[1, 0, 1, 0, 0, 1, 0, 1, 0, 0]"
5003,1,1,2,0.0369850876682013,"[1, 1, 1, 1, 0, 1, 0, 0, 0, 1]"
5004,1,1,2,0.17755042325515957,"[0, 1, 0, 1, 0, 0, 1, 0, 1, 0]"
5005,1,1,2,0.7336572746474165,"[1, 0, 1, 0, 0, 0, 0, 1, 1, 1]"
5006,1,1,2,0.5188415914514481,"[0, 0, 1, 0, 1, 0, 1, 1, 0, 1]"
5007,1,1,2,0.8888411948628505,"[1, 1, 1, 1, 0, 0, 0, 1, 0, 0]"
5008,3,3,6,0.91472195821709,"[0, 1, 1, 1, 0, 0, 1, 0, 1, 1]"
5009,1,1,2,0.604218328964132,"[0, 1, 1, 1, 0, 1, 0, 1, 1, 1]"
5010,4,4,8,0.6020189990562462,"[0, 0, 0, 1, 1, 1, 0, 1, 1, 1]"
5011,1,1,2,0.7143952774676041,"[0, 0, 1, 0, 1, 1, 0, 0, 0, 1]"
5012,2,2,4,0.14535202906853684,"[0, 1, 1, 1, 0, 0, 1, 0, 1, 1]"
5013,4,4,8,0.5932524462752439,"[1, 0, 0, 1, 1, 1, 0, 0, 1, 1]"
5014,2,2,4,0.13527479916316953,"[0, 1, 0, 1, 1, 0, 0, 1, 1, 0]"
5015,3,3,6,0.6355769566901197,"[0, 0, 0, 1, 1, 0, 0, 0, 0, 1]"
5016,1,1,2,0.646150254424662,"[1, 1, 1, 1, 0, 0, 0, 0, 0, 0]"
5017,1,1,2,0.4902149760436939,"[1, 0, 0, 1, 0, 1, 1, 1, 1, 0]"
5018,3,3,6,0.17388081735778527,"[1, 1, 0, 0, 0, 1, 1, 0, 1, 1]"
5019,1,1,2,0.978812456388364,"[1, 1, 0, 0, 0, 0, 0, 1, 0, 0]"
5020,3,3,6,0.014887734156525001,"[1, 0, 1, 0, 1, 0, 0, 1, 0, 1]"
5021,1,1,2,0.9595431453413196,"[0, 1, 0, 1, 1, 0, 0, 0, 1, 0]"
5022,1,1,2,0.7083352486175708,"[1, 0, 1, 0, 0, 0, 0, 1, 1, 1]"
5023,1,1,2,0.9922135365124469,"[1, 1, 1, 0, 1, 1, 1, 1, 0, 1]"
5024,2,2,4,0.4524638079856863,"[0, 1, 0, 1, 0, 0, 1, 0, 0, 1]"
5025,3,3,6,0.7690041686513986,"[1, 0, 0, 0, 1, 1, 1, 1, 0, 1]"
5026,4,4,8,0.8594468313050128,"[1, 0, 0, 1, 0, 0, 0, 1, 1, 1]"
5027,4,4,8,0.23759605234792025,"[1, 0, 0, 1, 1, 1, 0, 0, 0, 1]"
5028,1,1,2,0.9641264121809441,"[0, 1, 0, 1, 1, 1, 0, 0, 0, 1]"
5029,3,3,6,0.6364681273088081,"[1, 0, 1, 1, 0, 0, 1, 1, 0, 0]"
5030,2,2,4,0.7239263613102094,"[0, 0, 0, 1, 1, 1, 1, 0, 1, 1]"
5031,1,1,2,0.7765426184066453,"[0, 1, 0, 1, 0, 1, 0, 1, 0, 0]"
5032,1,1,2,0.20793346476545305,"[0, 1, 0, 1, 0, 0, 1, 0, 0, 0]"
5033,1,1,2,0.7316618648955939,"[1, 0, 1, 0, 1, 0, 0, 1, 1, 0]"
5034,1,1,2,0.09648317811515872,"[1, 0, 0, 0, 1, 0, 1, 0, 0, 0]"
5035,1,1,2,0.7248057323469754,"[0, 1, 1, 0, 0, 0, 0, 1, 1, 0]"
5036,1,1,2,0.25773068043632175,"[1, 1, 0, 0, 1, 0, 1, 0, 1, 0]"
5037,1,1,2,0.2285437017169114,"[0, 0, 0, 0, 1, 1, 1, 1, 1, 1]"
5038,1,1,2,0.6092329872741511,"[0, 1, 0, 0, 1, 1, 0, 1, 0, 1]"
5039,1,1,2,0.037416353190178664,"[0, 0, 0, 0, 0, 1, 0, 0, 0, 0]"
5040,2,2,4,0.31479103660739294,"[1, 1, 1, 1, 1, 1, 1, 1, 0, 0]"
5041,1,1,2,0.6146563726364763,"[1, 1, 0, 0, 1, 1, 1, 1, 0, 0]"
5042,1,1,2,0.6370172510900511,"[0, 1, 0, 0, 0, 0, 0, 1, 1, 0]"
5043,4,4,8,0.47235346135995293,"[1, 0, 1, 1, 1, 0, 0, 1, 1, 1]"
5044,1,1,2,0.1809372022500445,"[0, 1, 1, 1, 1, 0, 0, 1, 0, 1]"
5045,1,1,2,0.42382060905998786,"[1, 0, 0, 1, 0, 0, 1, 1, 1, 1]"
5046,1,1,2,0.03566996306772385,"[1, 1, 0, 0, 1, 1, 0, 1, 1, 1]"
5047,1,1,2,0.9666475845653302,"[0, 1, 1, 1, 0, 1, 0, 0, 1, 0]"
5048,2,2,4,0.8903036113090512,"[0, 0, 1, 0, 0, 1, 0, 1, 0, 1]"
5049,1,1,2,0.5756453601352343,"[1, 0, 1, 1, 1, 0, 0, 1, 0, 0]"
5050,1,1,2,0.018550536230384496,"[1, 0, 1, 0, 1, 1, 1, 0, 1, 0]"
5051,1,1,2,0.703489602493927,"[1, 1, 0, 1, 1, 0, 1, 0, 0, 0]"
5052,1,1,2,0.2630363012362077,"[1, 0, 1, 1, 0, 1, 1, 1, 0, 0]"
5053,2,2,4,0.8792430691986245,"[1, 1, 0, 0, 1, 1, 0, 1, 1, 0]"
5054,3,3,6,0.6108381411188382,"[0, 1, 1, 1, 0, 0, 0, 1, 1, 1]"
5055,3,3,6,0.35640059194769946,"[0, 1, 1, 0, 0, 0, 0, 1, 1, 1]"
5056,1,1,2,0.45208775255473665,"[1, 0, 0, 1, 1, 0, 0, 0, 1, 1]"
5057,1,1,2,0.8820904145710613,"[0, 0, 0, 0, 0, 1, 1, 0, 0, 1]"
5058,1,1,2,0.975837696198053,"[1, 0, 0, 0, 0, 0, 1, 1, 0, 1]"
5059,3,3,6,0.1339982703229169,"[0, 1, 1, 0, 1, 1, 1, 1, 0, 1]"
5060,6,6,12,0.8259903060805114,"[0, 1, 0, 0, 1, 1, 1, 0, 1, 1]"
5061,1,1,2,0.5494534548840001,"[0, 0, 0, 1, 1, 0, 1, 1, 0, 0]"
5062,3,3,6,0.2926224036274583,"[1, 1, 1, 0, 1, 1, 0, 1, 0, 1]"
5063,2,2,4,0.68245331091646,"[0, 1, 0, 1, 1, 1, 0, 0, 0, 1]"
5064,1,1,2,0.6397069490994961,"[0, 1, 1, 0, 0, 1, 0, 0, 0, 0]"
5065,1,1,2,0.5245312760792229,"[0, 0, 0, 0, 1, 0, 0, 0, 0, 1]"
5066,1,1,2,0.3131825167360426,"[1, 1, 0, 0, 1, 0, 1, 0, 0, 0]"
5067,1,1,2,0.6948951983711711,"[0, 0, 1, 0, 1, 1, 1, 1, 0, 0]"
5068,4,4,8,0.6769642987220932,"[0, 1, 0, 0, 1, 0, 1, 0, 0, 0]"
5069,1,1,2,0.5152950823176234,"[0, 1, 0, 0, 1, 1, 0, 0, 1, 1]"
5070,3,3,6,0.8997346987506823,"[1, 0, 0, 1, 1, 0, 0, 1, 0, 0]"
5071,1,1,2,0.06254465816559762,"[0, 0, 0, 0, 0, 1, 1, 1, 1, 1]"
5072,3,3,6,0.38620046392196106,"[0, 0, 1, 0, 0, 0, 1, 0, 1, 1]"
5073,3,3,6,0.7097584764431276,"[1, 1, 0, 1, 1, 1, 0, 0, 0, 1]"
5074,1,1,2,0.7972209007311317,"[0, 0, 1, 1, 0, 1, 0, 1, 0, 0]"
5075,1,1,2,0.34223706545653887,"[0, 1, 1, 1, 1, 1, 0, 1, 0, 1]"
5076,2,2,4,0.6234211364136316,"[0, 1, 1, 1, 0, 0, 0, 1, 1, 0]"
5077,1,1,2,0.9251597992827769,"[1, 1, 1, 0, 1, 0, 1, 0, 0, 1]"
5078,1,1,2,0.7693482579176026,"[1, 1, 0, 1, 0, 1, 1, 0, 1, 0]"
5079,1,1,2,0.9874432126224713,"[1, 1, 0, 0, 1, 0, 0, 0, 0, 1]"
5080,1,1,2,0.9834601705055565,"[1, 0, 1, 1, 1, 0, 0, 1, 1, 0]"
5081,1,1,2,0.45833976231728013,"[1, 0, 0, 1, 0, 0, 0, 0, 1, 0]"
5082,2,2,4,0.6062332763940569,"[0, 1, 0, 1, 0, 1, 0, 0, 1, 0]"
5083,2,2,4,0.29648054284114256,"[0, 0, 1, 1, 1, 1, 0, 1, 0, 0]"
5084,3,3,6,0.9679907642355462,"[1, 1, 0, 1, 1, 0, 1, 1, 0, 1]"
5085,1,1,2,0.8526809201873496,"[1, 0, 1, 1, 1, 1, 1, 1, 0, 0]"
5086,1,1,2,0.9472459475879831,"[0, 1, 0, 0, 1, 1, 0, 0, 1, 0]"
5087,1,1,2,0.28613456062228704,"[0, 1, 0, 1, 1, 1, 1, 0, 0, 0]"
5088,2,2,4,0.5807736975412353,"[0, 1, 0, 0, 1, 0, 0, 0, 0, 1]"
5089,1,1,2,0.4401716038406046,"[1, 0, 1, 1, 0, 1, 0, 0, 1, 0]"
5090,3,3,6,0.16203297926882254,"[1, 0, 1, 0, 1, 1, 0, 1, 0, 1]"
5091,2,2,4,0.13411712899461947,"[0, 1, 0, 1, 1, 0, 1, 0, 1, 0]"
5092,2,2,4,0.23424966191066543,"[0, 0, 1, 0, 1, 0, 1, 1, 0, 0]"
5093,1,1,2,0.46167745861373555,"[0, 0, 0, 0, 0, 0, 0, 0, 1, 0]"
5094,2,2,4,0.4461904157567802,"[0, 0, 0, 0, 0, 0, 1, 0, 1, 0]"
5095,1,1,2,0.331184684095853,"[1, 1, 1, 1, 1, 0, 0, 1, 0, 1]"
5096,1,1,2,0.9290897108942605,"[1, 1, 1, 0, 0, 1, 1, 1, 1, 1]"
5097,1,1,2,0.3752626993875666,"[0, 1, 1, 0, 0, 0, 0, 1, 1, 1]"
5098,1,1,2,0.1759737392193046,"[0, 0, 0, 0, 0, 1, 0, 1, 1, 1]"
5099,2,2,4,0.3463247333081474,"[1, 1, 0, 0, 0, 1, 1, 1, 0, 1]"
5100,1,1,2,0.5527307675673383,"[0, 0, 0, 0, 1, 0, 0, 1, 0, 1]"
5101,3,3,6,0.8473906290115931,"[1, 1, 0, 0, 1, 0, 1, 0, 1, 1]"
5102,2,2,4,0.40972319026075876,"[1, 0, 0, 1, 1, 0, 1, 1, 0, 1]"
5103,1,1,2,0.04937351980297866,"[1, 0, 0, 0, 1, 0, 0, 1, 0, 0]"
5104,2,2,4,0.24719119206398188,"[0, 1, 0, 0, 1, 0, 1, 0, 1, 1]"
5105,2,2,4,0.15474773196678848,"[0, 0, 0, 0, 1, 1, 0, 1, 0, 0]"
5106,1,1,2,0.23020027441803448,"[1, 0, 0, 0, 0, 1, 1, 1, 0, 1]"
5107,1,1,2,0.5925144015080742,"[1, 1, 0, 1, 1, 1, 1, 0, 0, 0]"
5108,2,2,4,0.40721911942649014,"[0, 1, 1, 0, 1, 0, 1, 0, 1, 0]"
5109,5,5,10,0.567557818714912,"[0, 1, 1, 0, 1, 1, 0, 1, 0, 1]"
5110,1,1,2,0.20153836607356423,"[0, 0, 0, 0, 1, 1, 0, 1, 0, 0]"
5111,4,4,8,0.3037760902612453,"[1, 0, 1, 1, 0, 1, 0, 1, 1, 1]"
5112,4,4,8,0.20995972628691284,"[1, 1, 1, 0, 0, 1, 1, 1, 1, 1]"
5113,1,1,2,0.49135626148287015,"[0, 1, 1, 1, 0, 0, 0, 0, 0, 0]"
5114,2,2,4,0.6543847010206281,"[0, 1, 1, 1, 1, 1, 0, 0, 0, 0]"
5115,3,3,6,0.5063914858483635,"[1, 1, 0, 1, 0, 1, 1, 1, 0, 0]"
5116,5,5,10,0.6062592272276768,"[1, 1, 1, 0, 1, 0, 0, 0, 0, 1]"
5117,1,1,2,0.40863707017651774,"[1, 0, 0, 1, 0, 1, 0, 0, 0, 0]"
5118,4,4,8,0.40145135311445856,"[1, 0, 0, 1, 1, 1, 1, 0, 1, 1]"
5119,1,1,2,0.27457880579639804,"[0, 1, 0, 0, 0, 1, 1, 1, 0, 1]"
5120,1,1,2,0.3478480628889965,"[1, 1, 1, 1, 1, 0, 0, 1, 0, 0]"
5121,1,1,2,0.5020200989247412,"[0, 1, 0, 1, 0, 1, 0, 0, 0, 0]"
5122,1,1,2,0.06031607034068909,"[0, 0, 1, 1, 0, 1, 0, 0, 1, 1]"
5123,1,1,2,0.9389475819206801,"[0, 1, 1, 1, 1, 0, 0, 0, 1, 0]"
5124,1,1,2,0.25152012752393227,"[1, 1, 1, 1, 0, 0, 0, 0, 1, 1]"
5125,2,2,4,0.00900705686696035,"[0, 1, 1, 1, 1, 1, 0, 0, 0, 1]"
5126,5,5,10,0.37763986046612597,"[1, 0, 1, 0, 1, 0, 1, 1, 0, 1]"
5127,2,2,4,0.6308180129136368,"[1, 0, 0, 1, 1, 0, 1, 1, 0, 0]"
5128,5,5,10,0.11281368468646524,"[0, 1, 1, 0, 0, 1, 1, 0, 0, 1]"
5129,2,2,4,0.48406191748222616,"[1, 1, 0, 0, 0, 1, 0, 1, 1, 1]"
5130,1,1,2,0.9177565602244246,"[1, 0, 0, 0, 1, 0, 0, 0, 0, 0]"
5131,3,3,6,0.16649964957798313,"[0, 1, 0, 1, 1, 1, 0, 1, 1, 1]"
5132,2,2,4,0.37674076496288456,"[0, 0, 1, 0, 0, 1, 0, 1, 1, 1]"
5133,2,2,4,0.4848376413602279,"[0, 1, 0, 0, 0, 1, 1, 0, 0, 0]"
5134,4,4,8,0.9732831140668694,"[1, 1, 0, 1, 0, 0, 1, 1, 0, 1]"
5135,1,1,2,0.09504497316944138,"[0, 1, 0, 0, 1, 1, 0, 1, 0, 0]"
5136,3,3,6,0.11117935600918283,"[1, 0, 0, 1, 1, 0, 1, 0, 0, 0]"
5137,6,6,12,0.9777448359128027,"[1, 1, 0, 0, 0, 1, 1, 1, 0, 0]"
5138,1,1,2,0.5099664566637783,"[0, 1, 1, 1, 1, 0, 1, 0, 1, 0]"
5139,3,3,6,0.6338931340293277,"[0, 0, 1, 1, 0, 1, 0, 1, 0, 0]"
5140,1,1,2,0.6236969400750386,"[1, 1, 0, 1, 0, 1, 0, 1, 0, 0]"
5141,1,1,2,0.7342146895527988,"[1, 0, 0, 1, 1, 1, 0, 1, 0, 1]"
5142,1,1,2,0.8773720004805907,"[0, 0, 1, 0, 0, 1, 0, 0, 0, 0]"
5143,1,1,2,0.5687551429044948,"[0, 1, 1, 1, 1, 1, 0, 1, 0, 1]"
5144,1,1,2,0.37726813748042254,"[1, 0, 1, 0, 0, 0, 1, 1, 1, 0]"
5145,1,1,2,0.6207568766248854,"[1, 1, 1, 1, 0, 1, 0, 1, 0, 0]"
5146,1,1,2,0.6729386007992326,"[0, 1, 1, 0, 0, 0, 1, 0, 1, 0]"
5147,1,1,2,0.022649682233013113,"[1, 0, 0, 1, 0, 0, 0, 1, 1, 0]"
5148,1,1,2,0.38865735967870574,"[1, 0, 0, 1, 0, 1, 1, 1, 1, 0]"
5149,1,1,2,0.47652011746144285,"[1, 0, 1, 0, 1, 0, 0, 1, 1, 1]"
5150,2,2,4,0.03775082543068009,"[1, 1, 0, 0, 0, 1, 0, 1, 0, 0]"
5151,3,3,6,0.9080223639892916,"[1, 1, 0, 0, 1, 1, 1, 0, 0, 1]"
5152,1,1,2,0.29757772105855995,"[1, 0, 0, 0, 1, 0, 1, 1, 1, 1]"
5153,1,1,2,0.4315027090608119,"[0, 0, 1, 1, 0, 1, 0, 1, 0, 1]"
5154,1,1,2,0.6180081644729059,"[1, 1, 0, 1, 0, 1, 0, 0, 1, 0]"
5155,2,2,4,0.5649485006122928,"[0, 0, 0, 1, 0, 0, 1, 1, 1, 1]"
5156,1,1,2,0.6144146995411148,"[1, 1, 0, 1, 1, 1, 1, 0, 1, 1]"
5157,1,1,2,0.6234484316128128,"[1, 0, 0, 0, 1, 1, 0, 0, 1, 0]"
5158,7,7,14,0.793989115857019,"[1, 1, 0, 0, 1, 1, 1, 0, 1, 0]"
5159,1,1,2,0.0016288379253989183,"[0, 0, 1, 1, 0, 1, 0, 1, 0, 0]"
5160,3,3,6,0.8012553687453344,"[1, 1, 1, 1, 0, 0, 1, 1, 1, 0]"
5161,1,1,2,0.9481146335818819,"[1, 0, 1, 0, 0, 0, 0, 1, 0, 1]"
5162,1,1,2,0.1314202463891514,"[0, 1, 1, 1, 0, 0, 1, 1, 0, 1]"
5163,2,2,4,0.9477538152775425,"[1, 1, 1, 1, 1, 1, 1, 1, 1, 1]"
5164,1,1,2,0.18741261717025015,"[1, 0, 1, 1, 1, 0, 0, 0, 0, 1]"
5165,6,6,12,0.46889279770145176,"[1, 1, 0, 0, 0, 1, 1, 1, 1, 1]"
5166,1,1,2,0.29389908374317497,"[0, 0, 1, 1, 0, 0, 1, 0, 1, 0]"
5167,1,1,2,0.35268817935714714,"[0, 1, 0, 1, 1, 1, 1, 0, 0, 1]"
5168,8,8,16,0.7571670395521816,"[0, 1, 1, 1, 1, 0, 1, 1, 0, 1]"
5169,1,1,2,0.6670374736375415,"[1, 0, 1, 0, 0, 1, 0, 0, 1, 0]"
5170,2,2,4,0.9829457403302858,"[0, 0, 1, 1, 0, 1, 0, 1, 0, 1]"
5171,1,1,2,0.39612661175350716,"[1, 0, 1, 0, 1, 0, 1, 1, 1, 0]"
5172,1,1,2,0.3966802086650243,"[1, 1, 1, 0, 0, 0, 0, 1, 0, 1]"
5173,1,1,2,0.6340032014518263,"[0, 0, 1, 1, 0, 1, 1, 0, 1, 1]"
5174,3,3,6,0.5632391876292241,"[1, 1, 1, 1, 1, 0, 1, 1, 1, 1]"
5175,1,1,2,0.31195647433523377,"[1, 1, 0, 0, 1, 1, 1, 0, 1, 1]"
5176,1,1,2,0.6519724798972574,"[0, 1, 0, 1, 0, 1, 1, 1, 0, 1]"
5177,3,3,6,0.6178936324615686,"[0, 0, 1, 1, 1, 1, 1, 0, 1, 1]"
5178,1,1,2,0.48230264685828694,"[0, 1, 1, 0, 1, 1, 1, 1, 0, 1]"
5179,2,2,4,0.7133598350201216,"[1, 0, 0, 1, 1, 1, 1, 1, 0, 0]"
5180,1,1,2,0.47827717047164076,"[1, 0, 1, 1, 0, 0, 1, 0, 0, 1]"
5181,2,2,4,0.502448717987329,"[1, 0, 0, 0, 0, 0, 1, 1, 1, 0]"
5182,1,1,2,0.3471041068953511,"[1, 0, 0, 0, 1, 0, 1, 1, 0, 1]"
5183,7,7,14,0.19541225016103525,"[1, 1, 0, 1, 0, 0, 1, 1, 1, 0]"
5184,1,1,2,0.28962040080848006,"[1, 0, 0, 0, 1, 0, 1, 1, 1, 1]"
5185,2,2,4,0.2572607197207859,"[1, 0, 0, 1, 1, 0, 0, 1, 0, 1]"
5186,2,2,4,0.4051229903290373,"[0, 0, 1, 1, 0, 0, 0, 0, 1, 1]"
5187,1,1,2,0.26125940465004416,"[1, 0, 1, 0, 1, 0, 0, 1, 0, 0]"
5188,4,4,8,0.9159466337159092,"[0, 0, 0, 1, 0, 0, 1, 0, 1, 0]"
5189,1,1,2,0.8565601226457026,"[1, 0, 1, 1, 1, 0, 1, 1, 0, 1]"
5190,3,3,6,0.7639436498734326,"[1, 0, 0, 0, 1, 1, 0, 1, 1, 1]"
5191,1,1,2,0.32952477316333184,"[1, 0, 1, 1, 1, 1, 1, 0, 0, 1]"
5192,2,2,4,0.9577316953912653,"[0, 1, 1, 0, 1, 0, 1, 1, 1, 0]"
5193,1,1,2,0.4105913871866088,"[0, 0, 1, 1, 0, 1, 1, 0, 1, 1]"
5194,1,1,2,0.2585013626456386,"[0, 0, 1, 0, 0, 1, 0, 1, 1, 0]"
5195,2,2,4,0.3133261087187461,"[0, 0, 0, 0, 1, 1, 1, 0, 1, 1]"
5196,1,1,2,0.39989771784670336,"[0, 1, 0, 0, 0, 0, 0, 1, 0, 0]"
5197,1,1,2,0.6844614619613519,"[0, 0, 1, 1, 0, 1, 1, 0, 0, 1]"
5198,1,1,2,0.03829599929059868,"[0, 1, 0, 0, 1, 1, 0, 0, 1, 1]"
5199,1,1,2,0.31857312790683445,"[0, 1, 1, 0, 0, 0, 0, 0, 0, 0]"
5200,1,1,2,0.8914971127957899,"[0, 1, 0, 1, 0, 0, 0, 1, 1, 0]"
5201,2,2,4,0.21219554988148748,"[0, 1, 1, 1, 1, 1, 1, 0, 0, 1]"
5202,2,2,4,0.006475920986812267,"[1, 1, 1, 0, 0, 1, 0, 0, 1, 1]"
5203,5,5,10,0.08373415992865008,"[0, 1, 1, 0, 0, 1, 1, 0, 1, 1]"
5204,2,2,4,0.6918849597069908,"[1, 0, 1, 1, 1, 0, 1, 1, 1, 0]"
5205,3,3,6,0.81966519048038,"[0, 1, 1, 1, 1, 1, 0, 1, 0, 1]"
5206,1,1,2,0.3165843080748897,"[0, 0, 0, 0, 0, 0, 1, 0, 0, 0]"
5207,2,2,4,0.4696818515391781,"[0, 1, 1, 1, 0, 1, 1, 0, 0, 0]"
5208,2,2,4,0.6437788687127864,"[1, 0, 0, 1, 0, 1, 0, 1, 1, 0]"
5209,2,2,4,0.8036790470923365,"[0, 0, 1, 0, 1, 1, 1, 1, 1, 0]"
5210,2,2,4,0.03274253361593149,"[0, 0, 1, 0, 0, 1, 1, 0, 0, 1]"
5211,1,1,2,0.2792355889986131,"[0, 1, 1, 0, 0, 0, 0, 1, 1, 0]"
5212,2,2,4,0.19087884500556918,"[0, 1, 1, 0, 1, 1, 0, 0, 0, 0]"
5213,1,1,2,0.19891761962795407,"[1, 0, 0, 1, 1, 0, 1, 1, 0, 1]"
5214,1,1,2,0.19484512282045208,"[1, 0, 1, 0, 0, 1, 1, 0, 1, 0]"
5215,4,4,8,0.18248036527181144,"[1, 1, 0, 0, 1, 1, 1, 0, 0, 0]"
5216,2,2,4,0.8693880783859621,"[1, 0, 1, 0, 1, 0, 0, 1, 1, 1]"
5217,1,1,2,0.3121763208518843,"[0, 0, 0, 1, 0, 1, 1, 0, 0, 1]"
5218,4,4,8,0.34616250696852624,"[1, 0, 0, 0, 1, 0, 1, 0, 1, 1]"
5219,1,1,2,0.12405162857017715,"[1, 1, 1, 0, 0, 1, 0, 1, 1, 1]"
5220,2,2,4,0.44784620421430243,"[1, 1, 1, 1, 0, 1, 1, 0, 1, 1]"
5221,3,3,6,0.5758860610365119,"[0, 1, 0, 1, 0, 1, 1, 1, 0, 1]"
5222,6,6,12,0.20224218563661422,"[1, 0, 1, 1, 0, 1, 1, 0, 1, 1]"
5223,1,1,2,0.10347334537913166,"[1, 0, 1, 0, 1, 0, 0, 0, 0, 0]"
5224,9,9,18,0.9880640689504292,"[1, 0, 1, 1, 0, 0, 1, 0, 1, 1]"
5225,4,4,8,0.12712780089531572,"[1, 0, 1, 1, 1, 1, 0, 0, 0, 1]"
5226,1,1,2,0.9775231572053314,"[0, 0, 1, 0, 1, 0, 1, 0, 0, 0]"
5227,2,2,4,0.842950752584405,"[1, 1, 0, 0, 1, 0, 0, 0, 0, 0]"
5228,1,1,2,0.21158655011870875,"[0, 1, 1, 0, 0, 0, 0, 0, 0, 0]"
5229,3,3,6,0.2763730104748868,"[0, 0, 1, 1, 0, 1, 1, 0, 0, 1]"
5230,3,3,6,0.7441038261587617,"[1, 0, 0, 0, 0, 1, 1, 1, 0, 0]"
5231,3,3,6,0.882865596082147,"[0, 1, 0, 1, 1, 0, 0, 1, 0, 1]"
5232,1,1,2,0.9002734844156831,"[0, 1, 0, 1, 1, 0, 0, 1, 1, 0]"
5233,1,1,2,0.7455029350938809,"[0, 0, 0, 1, 0, 0, 0, 1, 0, 0]"
5234,4,4,8,0.6038142020838689,"[1, 1, 1, 0, 1, 1, 0, 1, 1, 0]"
5235,3,3,6,0.040522741893331604,"[0, 0, 1, 0, 1, 1, 0, 0, 0, 1]"
5236,1,1,2,0.3742623936242089,"[1, 0, 1, 0, 1, 0, 0, 0, 0, 0]"
5237,1,1,2,0.06091209422242183,"[0, 0, 0, 0, 1, 0, 0, 1, 0, 0]"
5238,1,1,2,0.5352789524457477,"[1, 1, 0, 1, 1, 0, 1, 0, 1, 1]"
5239,1,1,2,0.02774806134744734,"[1, 0, 0, 0, 1, 1, 1, 1, 0, 0]"
5240,1,1,2,0.41715674116657087,"[0, 0, 1, 0, 1, 0, 0, 0, 1, 1]"
5241,2,2,4,0.9566202414208081,"[1, 1, 1, 0, 0, 1, 1, 0, 0, 1]"
5242,5,5,10,0.5586321952539312,"[0, 0, 0, 1, 1, 1, 0, 1, 1, 1]"
5243,1,1,2,0.90096177450526,"[1, 1, 1, 1, 1, 1, 0, 0, 1, 1]"
5244,1,1,2,0.7295269152453733,"[1, 0, 1, 0, 1, 1, 1, 0, 1, 1]"
5245,2,2,4,0.435112189384115,"[1, 1, 0, 0, 0, 1, 1, 1, 0, 0]"
5246,1,1,2,0.26387045258984465,"[1, 1, 0, 0, 1, 1, 0, 1, 0, 0]"
5247,6,6,12,0.9806172423394638,"[0, 0, 1, 0, 1, 0, 0, 0, 0, 1]"
5248,4,4,8,0.9059345181158408,"[0, 0, 0, 0, 1, 1, 1, 0, 0, 1]"
5249,3,3,6,0.1904346507156096,"[1, 1, 1, 0, 0, 0, 1, 1, 1, 0]"
5250,3,3,6,0.7378484706223153,"[1, 0, 0, 0, 1, 1, 1, 0, 1, 1]"
5251,4,4,8,0.9013250183593937,"[0, 1, 1, 0, 1, 0, 0, 0, 1, 1]"
5252,1,1,2,0.17178860154391884,"[0, 1, 0, 1, 0, 0, 1, 1, 0, 1]"
5253,2,2,4,0.9823209613562944,"[0, 1, 0, 0, 1, 1, 0, 1, 0, 1]"
5254,2,2,4,0.10181516963017956,"[1, 0, 1, 0, 0, 1, 1, 0, 1, 1]"
5255,1,1,2,0.8728507737236965,"[1, 0, 0, 1, 0, 1, 1, 1, 0, 1]"
5256,3,3,6,0.17583172844997297,"[0, 1, 0, 1, 0, 1, 0, 1, 0, 0]"
5257,2,2,4,0.8225986707173918,"[1, 1, 1, 1, 0, 0, 1, 0, 0, 1]"
5258,1,1,2,0.6819366036830208,"[0, 1, 1, 0, 0, 0, 0, 1, 1, 0]"
5259,6,6,12,0.05727389762450885,"[0, 1, 1, 0, 1, 1, 0, 1, 1, 1]"
5260,2,2,4,0.7322980154155108,"[1, 1, 1, 0, 0, 0, 0, 0, 1, 0]"
5261,2,2,4,0.3946886336816521,"[0, 0, 0, 0, 1, 1, 1, 1, 1, 0]"
5262,4,4,8,0.5238163875666841,"[0, 0, 0, 1, 1, 1, 0, 0, 1, 1]"
5263,1,1,2,0.9824486548460272,"[0, 1, 1, 1, 0, 0, 1, 1, 0, 0]"
5264,2,2,4,0.26470133326006673,"[1, 1, 1, 1, 1, 1, 0, 1, 1, 0]"
5265,1,1,2,0.43429707036920906,"[1, 0, 0, 0, 1, 0, 0, 0, 0, 1]"
5266,3,3,6,0.32646564494894936,"[0, 1, 0, 0, 1, 0, 0, 0, 1, 0]"
5267,2,2,4,0.30288934856264393,"[1, 1, 1, 1, 0, 1, 0, 0, 1, 1]"
5268,10,10,20,0.45778432927967927,"[0, 1, 1, 0, 0, 1, 1, 1, 1, 0]"
5269,1,1,2,0.47671828072516664,"[0, 0, 0, 0, 1, 1, 0, 0, 1, 1]"
5270,1,1,2,0.06177429733752482,"[0, 1, 1, 0, 0, 1, 0, 1, 1, 0]"
5271,2,2,4,0.035277413573740146,"[0, 0, 1, 0, 1, 0, 1, 0, 1, 1]"
5272,1,1,2,0.9005276347361488,"[0, 0, 1, 1, 1, 0, 1, 1, 1, 0]"
5273,1,1,2,0.7626342429350025,"[1, 1, 0, 1, 1, 0, 1, 0, 1, 1]"
5274,1,1,2,0.9904783764936742,"[1, 1, 0, 0, 1, 0, 1, 1, 0, 1]"
5275,2,2,4,0.09329315145387518,"[1, 1, 0, 0, 0, 0, 0, 1, 0, 1]"
5276,1,1,2,0.2838182621207892,"[0, 0, 0, 0, 1, 1, 0, 1, 0, 1]"
5277,1,1,2,0.31089574826501265,"[0, 1, 1, 0, 1, 1, 0, 0, 0, 1]"
5278,2,2,4,0.99920347542083,"[1, 0, 1, 0, 0, 1, 0, 1, 1, 1]"
5279,3,3,6,0.9298974740917081,"[0, 1, 1, 1, 1, 1, 1, 1, 0, 1]"
5280,4,4,8,0.42775798164380163,"[1, 0, 0, 1, 1, 1, 1, 1, 1, 1]"
5281,1,1,2,0.5552168953642141,"[1, 0, 0, 0, 0, 0, 1, 0, 1, 0]"
5282,1,1,2,0.94865662728384,"[1, 0, 1, 0, 1, 1, 1, 0, 1, 0]"
5283,1,1,2,0.7220992138206646,"[1, 0, 1, 1, 1, 0, 0, 1, 1, 0]"
5284,4,4,8,0.028634016407089513,"[1, 0, 0, 0, 1, 0, 1, 1, 1, 0]"
5285,1,1,2,0.0003757466975122803,"[0, 1, 1, 0, 1, 0, 1, 0, 0, 0]"
5286,1,1,2,0.005526891189982064,"[1, 1, 0, 0, 1, 0, 0, 1, 1, 0]"
5287,3,3,6,0.03477036327963279,"[1, 1, 0, 1, 1, 1, 1, 0, 0, 0]"
5288,3,3,6,0.5379457901176973,"[1, 1, 1, 1, 0, 1, 1, 1, 1, 1]"
5289,1,1,2,0.29590410212053386,"[1, 1, 0, 1, 0, 1, 0, 1, 1, 0]"
5290,1,1,2,0.5400673349168535,"[1, 0, 1, 1, 1, 1, 0, 0, 1, 0]"
5291,1,1,2,0.9470351506104837,"[0, 1, 0, 1, 1, 1, 1, 1, 0, 1]"
5292,3,3,6,0.08741185212198421,"[1, 1, 0, 1, 0, 0, 1, 1, 1, 0]"
5293,2,2,4,0.8489932100745144,"[0, 0, 0, 0, 1, 0, 1, 1, 1, 1]"
5294,3,3,6,0.3327940144401659,"[1, 0, 1, 0, 0, 1, 0, 1, 1, 0]"
5295,1,1,2,0.8488830432584098,"[0, 1, 0, 0, 0, 1, 1, 1, 0, 1]"
5296,1,1,2,0.3949350978194591,"[0, 0, 0, 1, 0, 0, 1, 1, 1, 0]"
5297,2,2,4,0.6272465505114173,"[0, 0, 0, 0, 0, 1, 1, 1, 1, 1]"
5298,2,2,4,0.5696623555189565,"[0, 1, 0, 1, 1, 0, 1, 1, 0, 0]"
5299,1,1,2,0.521182160160275,"[1, 1, 1, 1, 1, 1, 0, 0, 1, 0]"
5300,1,1,2,0.26216055907934244,"[0, 1, 1, 1, 0, 1, 1, 0, 1, 0]"
5301,2,2,4,0.3517179787307748,"[0, 0, 0, 0, 0, 0, 0, 0, 1, 0]"
5302,5,5,10,0.9270086945066711,"[1, 1, 0, 1, 1, 0, 1, 0, 0, 0]"
5303,1,1,2,0.7472115137813642,"[0, 0, 1, 0, 1, 0, 1, 1, 0, 0]"
5304,1,1,2,0.4227119449555379,"[1, 0, 0, 0, 0, 1, 0, 1, 0, 0]"
5305,4,4,8,0.21220359796045185,"[0, 1, 0, 0, 0, 1, 0, 0, 1, 1]"
5306,1,1,2,0.7509684288474789,"[1, 1, 0, 1, 0, 0, 1, 1, 1, 0]"
5307,2,2,4,0.4879995736270565,"[0, 0, 0, 1, 0, 0, 1, 1, 1, 0]"
5308,1,1,2,0.43732292262329364,"[1, 0, 0, 1, 0, 0, 1, 0, 1, 0]"
5309,4,4,8,0.2387498378175743,"[1, 1, 1, 0, 0, 1, 1, 1, 1, 1]"
5310,2,2,4,0.8615797248351659,"[0, 1, 0, 0, 1, 1, 1, 1, 1, 1]"
5311,1,1,2,0.8092571890746221,"[1, 0, 0, 1, 1, 0, 1, 1, 0, 1]"
5312,3,3,6,0.3924493298108581,"[1, 0, 1, 0, 1, 1, 0, 1, 1, 0]"
5313,1,1,2,0.7096971180370905,"[1, 0, 0, 1, 0, 0, 1, 1, 0, 1]"
5314,1,1,2,0.5003005155535588,"[0, 1, 0, 0, 1, 0, 1, 0, 0, 1]"
5315,1,1,2,0.8253197871974964,"[1, 1, 0, 1, 0, 1, 1, 1, 1, 1]"
5316,5,5,10,0.8532151512129375,"[0, 0, 1, 0, 1, 1, 0, 1, 1, 1]"
5317,1,1,2,0.31895006402236303,"[0, 1, 0, 1, 1, 1, 0, 0, 0, 1]"
5318,6,6,12,0.6949341849376862,"[0, 0, 1, 1, 1, 0, 1, 1, 1, 0]"
5319,2,2,4,0.5581378843244991,"[1, 1, 1, 1, 1, 1, 0, 1, 0, 0]"
5320,1,1,2,0.9323663586006316,"[0, 1, 0, 1, 1, 1, 1, 0, 0, 1]"
5321,8,8,16,0.4354246462965621,"[1, 0, 1, 0, 0, 0, 1, 1, 1, 1]"
5322,1,1,2,0.12422928928600308,"[0, 0, 1, 0, 0, 0, 0, 0, 0, 1]"
5323,2,2,4,0.20375335520035676,"[1, 1, 0, 0, 0, 0, 0, 1, 1, 1]"
5324,1,1,2,0.8224663715666262,"[1, 0, 1, 1, 1, 1, 1, 0, 0, 0]"
5325,1,1,2,0.09392499145400035,"[0, 1, 1, 0, 1, 0, 0, 1, 0, 0]"
5326,1,1,2,0.35026939240796195,"[1, 0, 1, 0, 0, 0, 1, 0, 1, 0]"
5327,2,2,4,0.9033045163620759,"[0, 1, 0, 0, 1, 1, 0, 1, 0, 1]"
5328,1,1,2,0.7989812846174935,"[1, 1, 1, 0, 0, 1, 0, 1, 1, 0]"
5329,1,1,2,0.7250726647219481,"[0, 1, 0, 1, 0, 0, 1, 0, 0, 1]"
5330,2,2,4,0.21255451980543116,"[1, 0, 0, 1, 0, 1, 0, 0, 0, 1]"
5331,1,1,2,0.2672135139841266,"[1, 1, 0, 1, 0, 0, 0, 0, 0, 1]"
5332,1,1,2,0.5736561865434902,"[0, 0, 0, 1, 1, 0, 0, 0, 0, 1]"
5333,2,2,4,0.038133885810219814,"[0, 1, 0, 1, 1, 0, 0, 1, 0, 1]"
5334,1,1,2,0.250714466488819,"[0, 0, 0, 0, 0, 0, 0, 0, 1, 1]"
5335,1,1,2,0.16353750598436367,"[1, 0, 1, 0, 1, 1, 0, 1, 1, 0]"
5336,1,1,2,0.6157558207093132,"[0, 0, 0, 0, 1, 0, 0, 0, 1, 0]"
5337,1,1,2,0.3352148113986678,"[0, 0, 0, 1, 1, 0, 0, 0, 1, 0]"
5338,3,3,6,0.8743458321352569,"[1, 1, 1, 1, 1, 1, 0, 0, 1, 1]"
5339,1,1,2,0.883524616807182,"[0, 1, 1, 0, 1, 0, 0, 1, 0, 1]"
5340,2,2,4,0.8979527187449641,"[1, 0, 1, 1, 1, 1, 1, 1, 1, 0]"
5341,1,1,2,0.46889310822194186,"[0, 0, 1, 0, 1, 0, 0, 1, 1, 1]"
5342,5,5,10,0.19561358537959161,"[1, 1, 0, 0, 1, 0, 1, 1, 0, 1]"
5343,1,1,2,0.8329425399125464,"[0, 1, 1, 0, 0, 1, 1, 0, 0, 0]"
5344,2,2,4,0.05551323918755324,"[0, 1, 1, 1, 0, 1, 0, 1, 1, 1]"
5345,8,8,16,0.4201752688810615,"[1, 0, 0, 1, 1, 1, 0, 1, 1, 1]"
5346,1,1,2,0.0775462467603314,"[1, 1, 1, 0, 1, 0, 1, 0, 1, 0]"
5347,4,4,8,0.314416395614177,"[0, 1, 1, 0, 0, 0, 1, 1, 1, 1]"
5348,1,1,2,0.9712797876319695,"[0, 0, 0, 1, 1, 0, 0, 0, 0, 1]"
5349,1,1,2,0.18458591401199376,"[0, 1, 0, 1, 1, 1, 0, 1, 0, 0]"
5350,12,12,24,0.06860153428531235,"[1, 1, 0, 1, 0, 1, 1, 0, 1, 1]"
5351,2,2,4,0.5367685588570617,"[0, 0, 0, 0, 1, 1, 1, 1, 0, 0]"
5352,1,1,2,0.054349402123362034,"[1, 1, 1, 0, 0, 1, 0, 0, 0, 0]"
5353,1,1,2,0.752536330334593,"[1, 1, 0, 1, 0, 1, 0, 0, 0, 1]"
5354,1,1,2,0.11859794969356563,"[0, 0, 0, 1, 0, 1, 0, 1, 1, 1]"
5355,1,1,2,0.2124416162294016,"[1, 0, 1, 0, 1, 0, 0, 1, 1, 0]"
5356,2,2,4,0.7061360527332752,"[1, 0, 1, 1, 1, 0, 0, 1, 0, 0]"
5357,1,1,2,0.196433782018402,"[1, 0, 0, 1, 0, 0, 0, 1, 1, 0]"
5358,2,2,4,0.0944695262562103,"[0, 0, 1, 1, 1, 1, 1, 0, 1, 1]"
5359,2,2,4,0.22800121490480474,"[0, 1, 0, 0, 0, 0, 0, 1, 0, 1]"
5360,3,3,6,0.21286598262623313,"[1, 0, 0, 1, 0, 1, 1, 1, 0, 1]"
5361,1,1,2,0.7033802769167329,"[0, 0, 0, 1, 1, 0, 1, 0, 1, 1]"
5362,1,1,2,0.6535880015565223,"[0, 1, 0, 1, 0, 0, 1, 1, 0, 1]"
5363,1,1,2,0.3502256214657342,"[1, 1, 0, 0, 0, 1, 0, 0, 0, 1]"
5364,2,2,4,0.23330008875707153,"[0, 1, 0, 0, 1, 0, 1, 1, 1, 0]"
5365,1,1,2,0.7846283281801847,"[0, 1, 0, 1, 0, 1, 1, 1, 0, 1]"
5366,1,1,2,0.9360842559395822,"[0, 0, 0, 1, 1, 0, 1, 1, 1, 1]"
5367,3,3,6,0.06325801377944817,"[1, 1, 1, 1, 1, 0, 1, 1, 0, 0]"
5368,1,1,2,0.5804618761538513,"[1, 0, 1, 0, 0, 1, 1, 0, 0, 1]"
5369,1,1,2,0.9294775477440858,"[0, 1, 1, 1, 0, 0, 1, 0, 0, 0]"
5370,1,1,2,0.160300178007586,"[0, 1, 0, 1, 1, 1, 1, 1, 0, 1]"
5371,1,1,2,0.7118024351031311,"[1, 0, 1, 1, 0, 1, 1, 1, 1, 1]"
5372,2,2,4,0.9872964746625325,"[1, 0, 0, 1, 1, 1, 0, 1, 0, 0]"
5373,1,1,2,0.3710336712458513,"[0, 0, 0, 1, 0, 0, 1, 0, 1, 0]"
5374,1,1,2,0.4561825251892978,"[0, 1, 1, 1, 0, 0, 1, 1, 0, 1]"
5375,1,1,2,0.34922924175079884,"[1, 1, 0, 0, 0, 0, 0, 1, 0, 0]"
5376,3,3,6,0.41403243915454035,"[1, 1, 1, 0, 0, 1, 1, 0, 1, 0]"
5377,2,2,4,0.27798061717375633,"[1, 0, 0, 0, 0, 0, 0, 1, 1, 0]"
5378,1,1,2,0.930052794364432,"[1, 1, 0, 0, 0, 1, 1, 1, 0, 1]"
5379,1,1,2,0.8192239655445285,"[1, 1, 0, 0, 1, 1, 0, 0, 1, 1]"
5380,3,3,6,0.07930244199569103,"[0, 1, 0, 1, 0, 0, 1, 1, 0, 1]"
5381,1,1,2,0.40389094506541057,"[0, 1, 0, 1, 0, 1, 1, 1, 0, 1]"
5382,1,1,2,0.19486449377073956,"[1, 0, 0, 0, 1, 0, 1, 0, 1, 0]"
5383,1,1,2,0.8001278082787654,"[1, 1, 0, 1, 0, 0, 1, 1, 1, 1]"
5384,3,3,6,0.7963302603836477,"[0, 1, 0, 0, 1, 0, 1, 1, 1, 0]"
5385,1,1,2,0.5257406377260907,"[1, 0, 0, 1, 1, 1, 1, 1, 0, 0]"
5386,2,2,4,0.8132650584354445,"[1, 0, 1, 0, 1, 0, 1, 1, 1, 1]"
5387,1,1,2,0.3941671124408812,"[1, 0, 1, 1, 1, 0, 1, 0, 0, 1]"
5388,1,1,2,0.6759948932556018,"[0, 0, 0, 1, 0, 0, 0, 1, 0, 0]"
5389,8,8,16,0.4108543767723246,"[1, 0, 1, 1, 0, 1, 1, 0, 0, 0]"
5390,3,3,6,0.4764580359767553,"[1, 0, 1, 1, 0, 0, 1, 0, 0, 1]"
5391,2,2,4,0.08493857559884221,"[0, 0, 0, 0, 1, 1, 0, 1, 1, 0]"
5392,1,1,2,0.0668415202161311,"[0, 0, 0, 1, 1, 0, 1, 0, 1, 1]"
5393,4,4,8,0.312561255611996,"[1, 1, 0, 0, 1, 1, 1, 1, 1, 1]"
5394,2,2,4,0.5263437085865617,"[1, 1, 0, 0, 0, 1, 1, 1, 0, 1]"
5395,1,1,2,0.28122474089668403,"[1, 0, 0, 1, 0, 1, 1, 0, 1, 1]"
5396,1,1,2,0.31685137854492085,"[1, 1, 1, 1, 1, 1, 1, 1, 1, 0]"
5397,1,1,2,0.6810434652271975,"[1, 0, 0, 1, 0, 0, 0, 1, 1, 1]"
5398,1,1,2,0.05073681421519449,"[0, 0, 1, 1, 0, 0, 1, 0, 0, 0]"
5399,1,1,2,0.6756623139545878,"[0, 1, 1, 1, 1, 0, 1, 0, 0, 0]"
5400,3,3,6,0.4354281250163974,"[0, 0, 1, 1, 0, 1, 0, 1, 1, 1]"
5401,2,2,4,0.5362561402534283,"[0, 1, 0, 0, 0, 0, 1, 0, 0, 1]"
5402,1,1,2,0.023226863064796488,"[1, 1, 0, 0, 1, 1, 1, 0, 0, 0]"
5403,1,1,2,0.5758653218510609,"[1, 0, 0, 1, 0, 0, 0, 1, 1, 1]"
5404,1,1,2,0.9687724245164923,"[0, 1, 1, 1, 1, 1, 1, 1, 0, 1]"
5405,3,3,6,0.4992400477983929,"[0, 0, 1, 1, 0, 0, 0, 0, 0, 1]"
5406,2,2,4,0.8657347868612718,"[0, 0, 0, 1, 1, 1, 1, 0, 0, 0]"
5407,3,3,6,0.7144210739538188,"[0, 0, 1, 1, 1, 0, 0, 0, 0, 1]"
5408,4,4,8,0.6651570834336379,"[1, 1, 1, 1, 0, 0, 1, 0, 1, 0]"
5409,1,1,2,0.11228531389140739,"[1, 0, 0, 1, 1, 1, 1, 0, 1, 0]"
5410,2,2,4,0.4346898825205906,"[0, 0, 1, 0, 0, 0, 1, 1, 0, 1]"
5411,1,1,2,0.148261233564297,"[0, 0, 0, 0, 1, 1, 0, 1, 0, 1]"
5412,3,3,6,0.5099797906971485,"[0, 1, 0, 0, 0, 1, 1, 0, 0, 1]"
5413,1,1,2,0.9056829954213689,"[0, 1, 0, 0, 1, 1, 0, 0, 0, 1]"
5414,1,1,2,0.28962126980868286,"[0, 1, 0, 1, 0, 0, 1, 1, 1, 0]"
5415,2,2,4,0.4786603017897405,"[0, 1, 1, 0, 1, 1, 1, 1, 0, 0]"
5416,1,1,2,0.7671655303600458,"[0, 0, 1, 0, 1, 0, 1, 0, 0, 0]"
5417,3,3,6,0.9838887418010254,"[1, 0, 1, 0, 0, 1, 0, 0, 1, 0]"
5418,1,1,2,0.8446172182838403,"[0, 0, 0, 0, 0, 1, 0, 1, 1, 0]"
5419,1,1,2,0.4025707020321926,"[0, 1, 0, 1, 0, 0, 0, 1, 1, 1]"
5420,1,1,2,0.4273798426655433,"[1, 1, 1, 0, 1, 0, 1, 1, 1, 0]"
5421,1,1,2,0.811854696655681,"[0, 0, 0, 0, 0, 0, 1, 0, 1, 1]"
5422,5,5,10,0.13799051019162667,"[0, 0, 0, 1, 1, 1, 1, 1, 1, 1]"
5423,1,1,2,0.8577121778383715,"[0, 0, 0, 1, 0, 1, 1, 0, 1, 0]"
5424,1,1,2,0.9681898556770551,"[1, 0, 1, 1, 1, 0, 0, 0, 0, 0]"
5425,1,1,2,0.981318514785104,"[0, 0, 0, 1, 0, 1, 1, 0, 0, 0]"
5426,1,1,2,0.14811625746285084,"[1, 0, 0, 1, 1, 1, 0, 1, 1, 0]"
5427,1,1,2,0.07401015339737893,"[0, 0, 0, 0, 1, 1, 0, 0, 1, 1]"
5428,1,1,2,0.06251031620829794,"[0, 0, 0, 1, 1, 0, 0, 0, 1, 0]"
5429,5,5,10,0.43866654915621195,"[1, 1, 1, 1, 0, 0, 0, 1, 0, 1]"
5430,1,1,2,0.5181210820714368,"[0, 1, 0, 1, 1, 0, 1, 0, 0, 1]"
5431,1,1,2,0.25890413046994876,"[1, 1, 0, 1, 1, 1, 0, 0, 0, 0]"
5432,1,1,2,0.46370605599521975,"[1, 0, 0, 0, 1, 0, 0, 0, 0, 0]"
5433,1,1,2,0.19542829100438464,"[1, 1, 0, 0, 1, 1, 1, 0, 0, 0]"
5434,3,3,6,0.21068293628069967,"[0, 1, 1, 0, 1, 1, 0, 1, 1, 0]"
5435,3,3,6,0.47486905738731067,"[0, 0, 0, 0, 0, 0, 1, 0, 1, 1]"
5436,1,1,2,0.42480567605167885,"[1, 0, 1, 0, 1, 0, 1, 1, 0, 0]"
5437,1,1,2,0.8452852380806489,"[0, 1, 1, 0, 0, 0, 0, 0, 0, 1]"
5438,4,4,8,0.042326408483119415,"[1, 1, 0, 1, 1, 1, 0, 1, 1, 0]"
5439,1,1,2,0.6604804390551473,"[0, 1, 1, 0, 1, 0, 0, 0, 1, 1]"
5440,2,2,4,0.6254108821202345,"[0, 0, 1, 0, 0, 1, 0, 1, 1, 1]"
5441,1,1,2,0.3891833054656184,"[1, 1, 0, 1, 0, 1, 0, 1, 1, 1]"
5442,1,1,2,0.27008354050490635,"[1, 1, 0, 0, 1, 0, 0, 0, 1, 1]"
5443,1,1,2,0.12456115151620129,"[1, 1, 1, 0, 0, 0, 0, 0, 0, 0]"
5444,2,2,4,0.7387479746046517,"[1, 0, 1, 1, 1, 1, 0, 1, 0, 0]"
5445,2,2,4,0.27298102907376265,"[0, 1, 1, 1, 0, 1, 1, 1, 0, 0]"
5446,1,1,2,0.03661483035251034,"[0, 0, 0, 1, 1, 0, 0, 0, 0, 1]"
5447,2,2,4,0.7582332649172475,"[0, 1, 0, 1, 1, 0, 1, 1, 0, 0]"
5448,5,5,10,0.5929154199501132,"[0, 1, 0, 0, 0, 1, 1, 0, 1, 1]"
5449,1,1,2,0.9703775369557601,"[0, 1, 0, 1, 0, 0, 0, 0, 1, 1]"
5450,1,1,2,0.9876118369080528,"[1, 0, 1, 0, 1, 0, 1, 1, 0, 0]"
5451,1,1,2,0.8984823298844846,"[0, 0, 1, 1, 0, 0, 0, 0, 0, 0]"
5452,1,1,2,0.03735034536748949,"[1, 0, 0, 0, 0, 0, 0, 0, 1, 0]"
5453,1,1,2,0.9708603300435283,"[1, 0, 0, 1, 0, 0, 1, 1, 0, 0]"
5454,2,2,4,0.6044314282541767,"[1, 0, 0, 1, 1, 1, 0, 0, 1, 1]"
5455,1,1,2,0.1178835839707727,"[1, 1, 0, 1, 0, 0, 1, 1, 1, 0]"
5456,4,4,8,0.12285145504393258,"[1, 1, 1, 1, 1, 1, 1, 1, 1, 0]"
5457,7,7,14,0.7417510514461416,"[0, 0, 0, 1, 1, 0, 1, 1, 1, 0]"
5458,1,1,2,0.04912457210008958,"[1, 0, 0, 0, 0, 1, 1, 1, 1, 0]"
5459,1,1,2,0.7166567945377242,"[0, 1, 0, 0, 0, 0, 1, 1, 1, 0]"
5460,1,1,2,0.9903865429134111,"[1, 0, 0, 0, 0, 0, 0, 1, 1, 1]"
5461,1,1,2,0.8114663996892676,"[1, 1, 0, 1, 1, 0, 1, 1, 1, 1]"
5462,3,3,6,0.356519992546812,"[1, 1, 1, 0, 1, 1, 1, 0, 1, 1]"
5463,1,1,2,0.04205002858500684,"[0, 1, 0, 0, 1, 0, 0, 1, 1, 0]"
5464,1,1,2,0.9280934351648584,"[0, 0, 0, 1, 1, 0, 0, 0, 1, 1]"
5465,1,1,2,0.9513252508598322,"[0, 0, 1, 0, 1, 1, 1, 1, 1, 1]"
5466,2,2,4,0.022607250250393562,"[0, 0, 1, 0, 1, 0, 0, 0, 0, 0]"
5467,4,4,8,0.29302990533684303,"[1, 1, 0, 1, 1, 0, 1, 0, 0, 1]"
5468,1,1,2,0.7768573944947036,"[1, 0, 1, 0, 1, 0, 0, 0, 1, 0]"
5469,3,3,6,0.6950438578567473,"[1, 1, 0, 0, 0, 0, 1, 0, 1, 1]"
5470,2,2,4,0.11365606050959531,"[1, 1, 1, 0, 0, 1, 0, 1, 0, 0]"
5471,1,1,2,0.1769301023303621,"[0, 0, 0, 1, 0, 1, 1, 0, 0, 0]"
5472,1,1,2,0.30368734474343995,"[0, 0, 0, 1, 1, 1, 0, 0, 1, 0]"
5473,2,2,4,0.8367258584229793,"[1, 0, 0, 1, 0, 1, 0, 0, 0, 1]"
5474,1,1,2,0.42369508908186304,"[1, 1, 1, 0, 0, 1, 1, 0, 0, 0]"
5475,1,1,2,0.3932111037602667,"[1, 0, 0, 0, 0, 0, 0, 1, 1, 1]"
5476,2,2,4,0.20809080816553438,"[0, 0, 0, 1, 1, 1, 0, 1, 0, 1]"
5477,2,2,4,0.6170065018718383,"[1, 0, 1, 1, 0, 1, 0, 0, 0, 0]"
5478,1,1,2,0.9730532975437105,"[0, 1, 1, 0, 1, 1, 1, 0, 0, 1]"
5479,2,2,4,0.03370535851990597,"[0, 1, 0, 1, 0, 0, 0, 1, 1, 0]"
5480,1,1,2,0.8200345322294355,"[1, 0, 1, 0, 0, 1, 1, 0, 0, 0]"
5481,1,1,2,0.5597527740858153,"[0, 1, 0, 0, 1, 0, 1, 1, 1, 1]"
5482,1,1,2,0.36024935294628824,"[1, 0, 0, 1, 0, 0, 1, 0, 0, 0]"
5483,1,1,2,0.290166858265011,"[0, 0, 1, 1, 0, 1, 0, 1, 0, 1]"
5484,1,1,2,0.27003068270605024,"[1, 1, 0, 0, 0, 0, 1, 0, 0, 1]"
5485,1,1,2,0.08715035482813882,"[1, 0, 1, 1, 1, 1, 1, 0, 0, 0]"
5486,4,4,8,0.5378131524890299,"[0, 0, 1, 0, 0, 1, 1, 0, 1, 1]"
5487,1,1,2,0.5146173737099362,"[1, 1, 1, 1, 0, 0, 1, 0, 0, 1]"
5488,1,1,2,0.09090612797055986,"[1, 0, 0, 0, 0, 1, 1, 1, 0, 1]"
5489,1,1,2,0.6167336563791791,"[0, 1, 0, 0, 0, 1, 1, 1, 1, 0]"
5490,3,3,6,0.6447444839625618,"[1, 1, 1, 0, 1, 1, 0, 1, 0, 1]"
5491,1,1,2,0.6157021546168825,"[0, 1, 1, 0, 0, 1, 1, 1, 1, 0]"
5492,2,2,4,0.7391884615026723,"[1, 1, 1, 1, 0, 0, 0, 1, 1, 1]"
5493,2,2,4,0.8923268233531256,"[1, 1, 1, 1, 1, 0, 1, 0, 0, 0]"
5494,2,2,4,0.8067862543846009,"[1, 1, 0, 1, 1, 1, 1, 0, 0, 1]"
5495,9,9,18,0.26190351388598654,"[0, 0, 1, 1, 0, 1, 1, 1, 0, 1]"
5496,1,1,2,0.585038639836709,"[1, 1, 1, 1, 0, 0, 0, 0, 0, 0]"
5497,1,1,2,0.4181855419239975,"[1, 1, 0, 1, 1, 1, 0, 1, 1, 1]"
5498,2,2,4,0.838972795209746,"[1, 0, 1, 1, 1, 0, 1, 0, 0, 1]"
5499,2,2,4,0.11935869060640225,"[0, 0, 0, 1, 0, 1, 0, 1, 1, 1]"
5500,1,1,2,0.743571334687274,"[1, 1, 0, 0, 0, 1, 0, 0, 1, 1]"
5501,3,3,6,0.14672843223753174,"[0, 1, 0, 0, 0, 1, 0, 1, 1, 1]"
5502,5,5,10,0.7505036570989544,"[1, 0, 1, 1, 0, 1, 1, 0, 1, 0]"
5503,6,6,12,0.23686619192353142,"[0, 0, 0, 0, 0, 0, 1, 0, 1, 1]"
5504,1,1,2,0.9387306672444196,"[1, 0, 1, 1, 1, 0, 0, 1, 1, 1]"
5505,2,2,4,0.7589699854699159,"[1, 1, 1, 0, 0, 0, 1, 0, 0, 1]"
5506,3,3,6,0.808763806470357,"[1, 0, 1, 1, 0, 1, 1, 0, 0, 1]"
5507,1,1,2,0.8262576058408261,"[0, 0, 0, 0, 0, 1, 1, 1, 1, 0]"
5508,1,1,2,0.04408352710246932,"[0, 1, 1, 1, 0, 0, 0, 1, 0, 1]"
5509,5,5,10,0.5280817713058427,"[1, 0, 1, 0, 1, 0, 1, 1, 1, 1]"
5510,2,2,4,0.6346733468338316,"[0, 1, 0, 0, 0, 1, 1, 1, 1, 1]"
5511,1,1,2,0.6544126239707647,"[0, 1, 0, 1, 0, 0, 1, 0, 1, 1]"
5512,2,2,4,0.4926780615412861,"[0, 0, 0, 1, 0, 0, 1, 0, 1, 1]"
5513,1,1,2,0.6613533596994379,"[0, 0, 0, 0, 1, 1, 1, 1, 1, 0]"
5514,1,1,2,0.5660560401568548,"[0, 1, 1, 0, 0, 1, 1, 0, 1, 1]"
5515,1,1,2,0.06114770410791881,"[0, 1, 0, 0, 1, 1, 1, 1, 1, 0]"
5516,1,1,2,0.625974788136955,"[0, 1, 1, 0, 0, 1, 1, 0, 1, 0]"
5517,1,1,2,0.9103158418637081,"[0, 0, 0, 0, 0, 0, 1, 1, 0, 1]"
5518,3,3,6,0.027841166731791156,"[0, 0, 1, 1, 1, 1, 1, 0, 1, 0]"
5519,3,3,6,0.9150062142748695,"[1, 1, 0, 0, 1, 0, 0, 0, 1, 0]"
5520,2,2,4,0.2684359136914507,"[1, 0, 0, 0, 1, 0, 1, 1, 0, 1]"
5521,3,3,6,0.5328037672986128,"[1, 0, 0, 0, 0, 1, 1, 0, 1, 0]"
5522,3,3,6,0.11339282127331096,"[0, 1, 0, 0, 1, 0, 1, 1, 1, 1]"
5523,2,2,4,0.3812142100937972,"[0, 1, 1, 0, 1, 1, 0, 0, 0, 0]"
5524,6,6,12,0.5774035717178723,"[0, 1, 0, 0, 1, 1, 0, 0, 1, 0]"
5525,1,1,2,0.6488787521301536,"[1, 1, 1, 0, 1, 0, 1, 0, 1, 0]"
5526,2,2,4,0.946735256083129,"[0, 0, 1, 1, 1, 0, 1, 1, 1, 1]"
5527,1,1,2,0.7832507495882403,"[0, 0, 0, 0, 1, 0, 0, 0, 0, 0]"
5528,1,1,2,0.45708393179171825,"[0, 1, 1, 1, 1, 1, 0, 0, 0, 0]"
5529,1,1,2,0.7610598439274975,"[0, 1, 0, 0, 1, 0, 0, 1, 1, 1]"
5530,1,1,2,0.7099363507246238,"[0, 1, 0, 1, 1, 0, 0, 1, 1, 1]"
5531,1,1,2,0.2075428920682303,"[0, 0, 0, 0, 1, 0, 0, 1, 0, 1]"
5532,1,1,2,0.02700504252699465,"[0, 1, 1, 1, 0, 0, 1, 1, 0, 0]"
5533,1,1,2,0.788072117530751,"[1, 0, 1, 0, 0, 0, 0, 0, 1, 0]"
5534,1,1,2,0.7755826153951051,"[1, 1, 0, 0, 1, 1, 1, 1, 0, 0]"
5535,1,1,2,0.2925063836103985,"[0, 1, 0, 0, 0, 0, 1, 0, 0, 0]"
5536,1,1,2,0.8836938553525753,"[1, 1, 0, 1, 1, 0, 0, 1, 0, 1]"
5537,1,1,2,0.5097094060490502,"[0, 1, 1, 0, 0, 1, 1, 1, 0, 0]"
5538,1,1,2,0.05885804686570684,"[1, 1, 1, 0, 0, 0, 0, 1, 1, 0]"
5539,5,5,10,0.5592507508309541,"[1, 1, 1, 0, 1, 0, 1, 1, 0, 0]"
5540,4,4,8,0.8289047037159675,"[1, 0, 1, 0, 1, 0, 1, 1, 0, 1]"
5541,2,2,4,0.022923649862097717,"[1, 1, 0, 0, 0, 0, 0, 0, 1, 0]"
5542,1,1,2,0.3428814552405548,"[1, 1, 0, 0, 0, 1, 0, 1, 1, 1]"
5543,2,2,4,0.9545316125642315,"[0, 0, 1, 0, 0, 0, 1, 1, 0, 1]"
5544,1,1,2,0.013012777434107337,"[1, 0, 1, 0, 1, 0, 1, 0, 0, 1]"
5545,6,6,12,0.38759637292958016,"[1, 0, 1, 0, 1, 1, 0, 1, 1, 0]"
5546,1,1,2,0.8282058707811294,"[1, 0, 1, 1, 0, 0, 1, 0, 0, 1]"
5547,1,1,2,0.15066538725355572,"[1, 0, 0, 1, 0, 0, 0, 1, 1, 1]"
5548,1,1,2,0.09195769243240293,"[0, 1, 1, 0, 1, 0, 1, 1, 0, 0]"
5549,2,2,4,0.7786114192716361,"[0, 1, 1, 0, 1, 0, 0, 0, 1, 0]"
5550,1,1,2,0.03275573653044472,"[0, 1, 0, 1, 0, 0, 0, 1, 1, 1]"
5551,3,3,6,0.7510473836530869,"[0, 1, 0, 0, 0, 1, 0, 0, 1, 0]"
5552,1,1,2,0.24168902368487932,"[1, 1, 1, 1, 0, 1, 1, 0, 0, 1]"
5553,1,1,2,0.556239116699752,"[1, 0, 0, 0, 1, 0, 1, 0, 1, 0]"
5554,1,1,2,0.696293039003706,"[0, 0, 1, 0, 1, 1, 1, 1, 0, 0]"
5555,1,1,2,0.7434618868373362,"[0, 0, 1, 0, 0, 0, 0, 0, 0, 0]"
5556,3,3,6,0.12440388861962204,"[0, 0, 0, 1, 0, 1, 1, 0, 1, 1]"
5557,9,9,18,0.02130597216876573,"[0, 0, 1, 1, 0, 0, 0, 1, 1, 1]"
5558,2,2,4,0.11439474932524563,"[1, 1, 1, 0, 1, 1, 0, 1, 0, 1]"
5559,1,1,2,0.04147436066281851,"[1, 0, 0, 1, 0, 0, 1, 0, 0, 0]"
5560,3,3,6,0.7535254168491761,"[0, 0, 1, 1, 1, 1, 0, 0, 1, 1]"
5561,3,3,6,0.7178589825602126,"[0, 0, 1, 0, 0, 1, 1, 1, 0, 0]"
5562,2,2,4,0.878428025060386,"[1, 0, 0, 1, 1, 1, 0, 1, 0, 1]"
5563,1,1,2,0.47419028829498744,"[1, 0, 0, 1, 1, 1, 0, 1, 1, 1]"
5564,1,1,2,0.2694218492932977,"[0, 1, 1, 0, 0, 0, 0, 1, 0, 1]"
5565,3,3,6,0.46171092387398893,"[1, 0, 0, 0, 1, 0, 1, 1, 1, 0]"
5566,2,2,4,0.5830697413061773,"[1, 1, 1, 0, 0, 1, 0, 1, 1, 1]"
5567,1,1,2,0.4879994391577106,"[0, 1, 0, 1, 1, 1, 0, 0, 0, 1]"
5568,5,5,10,0.6170630606872209,"[1, 1, 0, 0, 1, 0, 1, 1, 1, 1]"
5569,1,1,2,0.1802576556800889,"[1, 0, 1, 0, 0, 0, 0, 1, 1, 1]"
5570,1,1,2,0.4735510931122373,"[1, 0, 0, 0, 1, 0, 0, 1, 0, 0]"
5571,1,1,2,0.4255250328998159,"[0, 1, 0, 0, 1, 0, 1, 1, 0, 0]"
5572,3,3,6,0.7388383396497794,"[1, 0, 1, 0, 0, 1, 0, 1, 1, 1]"
5573,1,1,2,0.8486937600556607,"[1, 1, 0, 0, 1, 0, 1, 0, 0, 1]"
5574,3,3,6,0.5824996961180429,"[1, 1, 0, 1, 0, 0, 0, 1, 0, 0]"
5575,1,1,2,0.938948526148723,"[1, 0, 1, 1, 0, 1, 1, 1, 0, 1]"
5576,1,1,2,0.0031965803440927587,"[1, 1, 0, 0, 1, 1, 0, 1, 0, 0]"
5577,1,1,2,0.4583426575852707,"[1, 1, 0, 1, 0, 0, 0, 0, 0, 1]"
5578,2,2,4,0.2580071224031071,"[0, 0, 0, 0, 1, 1, 1, 1, 0, 1]"
5579,3,3,6,0.44106969933898454,"[0, 0, 1, 0, 1, 1, 1, 0, 1, 1]"
5580,2,2,4,0.4132153721988149,"[0, 1, 1, 0, 1, 0, 1, 0, 0, 1]"
5581,1,1,2,0.8910317826708918,"[0, 1, 1, 1, 0, 1, 0, 0, 1, 1]"
5582,3,3,6,0.7584034789835444,"[1, 1, 1, 0, 1, 1, 0, 1, 0, 1]"
5583,2,2,4,0.12937045608402364,"[1, 1, 1, 1, 0, 1, 0, 1, 0, 0]"
5584,1,1,2,0.9805461107379534,"[0, 1, 0, 1, 0, 1, 1, 1, 0, 0]"
5585,3,3,6,0.9386475154484243,"[0, 0, 1, 0, 1, 0, 1, 0, 1, 0]"
5586,2,2,4,0.5831820760354178,"[1, 0, 1, 0, 0, 0, 1, 1, 1, 0]"
5587,2,2,4,0.5970858515350292,"[0, 0, 0, 1, 0, 1, 1, 1, 1, 0]"
5588,1,1,2,0.44390849728574266,"[1, 1, 1, 1, 1, 0, 1, 0, 0, 0]"
5589,2,2,4,0.6292650064420721,"[1, 0, 1, 1, 0, 1, 0, 1, 1, 0]"
5590,1,1,2,0.21690929433459316,"[0, 1, 0, 0, 0, 1, 1, 0, 0, 0]"
5591,1,1,2,0.590749265877321,"[0, 0, 1, 0, 1, 1, 1, 0, 0, 0]"
5592,2,2,4,0.04719599822365883,"[1, 1, 0, 1, 1, 1, 0, 1, 0, 0]"
5593,1,1,2,0.08107798737880745,"[1, 0, 0, 0, 0, 1, 1, 1, 0, 0]"
5594,3,3,6,0.9847188790839225,"[1, 0, 0, 0, 1, 1, 1, 0, 0, 0]"
5595,3,3,6,0.6619434727263545,"[1, 0, 0, 1, 1, 0, 0, 1, 1, 1]"
5596,5,5,10,0.5853017400442555,"[1, 0, 1, 0, 0, 1, 1, 0, 1, 1]"
5597,1,1,2,0.2752979951122241,"[1, 0, 1, 0, 1, 0, 0, 0, 1, 1]"
5598,1,1,2,0.2071076601054822,"[1, 1, 1, 0, 1, 0, 0, 0, 0, 1]"
5599,1,1,2,0.2732717618377505,"[1, 0, 0, 1, 1, 1, 1, 1, 1, 0]"
5600,1,1,2,0.25941367587611985,"[0, 1, 0, 1, 0, 0, 1, 0, 0, 1]"
5601,2,2,4,0.45873834994317353,"[1, 1, 0, 1, 0, 0, 0, 1, 0, 1]"
5602,2,2,4,0.21081954005185055,"[0, 1, 1, 1, 0, 1, 1, 0, 1, 1]"
5603,1,1,2,0.8699927759143563,"[1, 1, 0, 1, 0, 1, 0, 0, 0, 1]"
5604,3,3,6,0.15948155303837452,"[1, 0, 0, 1, 1, 0, 1, 0, 1, 0]"
5605,1,1,2,0.4345500946131261,"[0, 1, 0, 1, 1, 0, 0, 1, 0, 1]"
5606,2,2,4,0.6016308643989589,"[1, 0, 1, 0, 1, 0, 1, 1, 0, 0]"
5607,1,1,2,0.028375949742068474,"[0, 1, 0, 1, 1, 1, 0, 0, 1, 0]"
5608,1,1,2,0.76249440765295,"[1, 0, 1, 1, 0, 1, 1, 0, 0, 0]"
5609,2,2,4,0.2832082038824423,"[0, 1, 1, 1, 0, 1, 1, 0, 0, 0]"
5610,2,2,4,0.4034375122229341,"[1, 0, 1, 1, 0, 1, 1, 0, 0, 1]"
5611,1,1,2,0.45641229681105133,"[0, 0, 1, 1, 0, 0, 0, 1, 0, 0]"
5612,1,1,2,0.740837918932886,"[0, 1, 1, 0, 1, 1, 1, 1, 1, 0]"
5613,1,1,2,0.8007331583778199,"[1, 0, 0, 0, 1, 0, 1, 1, 0, 1]"
5614,1,1,2,0.45230576050938376,"[0, 1, 1, 0, 1, 0, 1, 1, 0, 0]"
5615,1,1,2,0.22949416559745273,"[1, 0, 0, 0, 1, 0, 0, 1, 1, 0]"
5616,1,1,2,0.07417760386360517,"[0, 1, 1, 0, 0, 1, 1, 0, 0, 0]"
5617,1,1,2,0.9116419225575884,"[0, 1, 0, 1, 0, 1, 0, 0, 0, 1]"
5618,1,1,2,0.952663707250106,"[0, 1, 1, 1, 0, 0, 1, 1, 1, 1]"
5619,2,2,4,0.7490781993644632,"[0, 1, 0, 0, 1, 1, 1, 0, 0, 0]"
5620,1,1,2,0.5019093171459905,"[1, 1, 1, 0, 0, 1, 1, 0, 1, 0]"
5621,1,1,2,0.4975301178331212,"[1, 1, 0, 0, 0, 1, 1, 1, 1, 1]"
5622,3,3,6,0.7175354521715857,"[1, 1, 1, 0, 1, 0, 0, 1, 1, 0]"
5623,2,2,4,0.1935099805273396,"[0, 1, 0, 1, 1, 1, 0, 0, 1, 0]"
5624,1,1,2,0.19956815363525926,"[0, 0, 0, 0, 0, 0, 1, 1, 0, 0]"
5625,4,4,8,0.3652893185659847,"[0, 1, 1, 1, 0, 1, 1, 1, 1, 1]"
5626,1,1,2,0.6024482695347285,"[1, 1, 1, 0, 0, 0, 1, 0, 0, 0]"
5627,1,1,2,0.6578375946108408,"[1, 0, 0, 1, 1, 0, 0, 1, 0, 0]"
5628,1,1,2,0.47410993365241194,"[1, 1, 0, 1, 0, 0, 1, 0, 1, 0]"
5629,4,4,8,0.8299586715102928,"[0, 1, 1, 1, 0, 0, 1, 0, 0, 1]"
5630,2,2,4,0.7370946889533873,"[1, 1, 1, 1, 0, 0, 1, 1, 1, 1]"
5631,1,1,2,0.9364884857543875,"[0, 0, 1, 1, 1, 0, 1, 1, 1, 0]"
5632,2,2,4,0.23877772121489926,"[0, 1, 0, 0, 1, 1, 1, 1, 0, 0]"
5633,1,1,2,0.014591230334232486,"[0, 0, 1, 0, 1, 1, 0, 1, 1, 1]"
5634,1,1,2,0.7305112473525988,"[0, 0, 0, 0, 0, 1, 1, 1, 1, 1]"
5635,5,5,10,0.3235140546761177,"[1, 0, 0, 0, 0, 1, 0, 1, 1, 0]"
5636,3,3,6,0.30528983197914683,"[1, 1, 0, 1, 0, 1, 0, 1, 1, 1]"
5637,4,4,8,0.8886584854916117,"[1, 1, 0, 1, 1, 0, 0, 0, 1, 1]"
5638,2,2,4,0.7105858124486132,"[0, 0, 0, 1, 0, 1, 1, 0, 1, 0]"
5639,3,3,6,0.6402535746860677,"[1, 0, 0, 1, 1, 0, 1, 0, 1, 0]"
5640,1,1,2,0.21554679646287367,"[1, 0, 1, 1, 0, 0, 0, 1, 0, 1]"
5641,1,1,2,0.3995288074593625,"[0, 1, 0, 0, 0, 0, 1, 1, 0, 0]"
5642,1,1,2,0.817484009081726,"[0, 0, 1, 1, 1, 1, 0, 0, 1, 0]"
5643,2,2,4,0.013965573216646598,"[0, 1, 0, 0, 0, 1, 0, 0, 0, 1]"
5644,1,1,2,0.7968438444137678,"[1, 0, 0, 1, 0, 1, 1, 0, 0, 1]"
5645,2,2,4,0.3190648029316049,"[0, 0, 0, 0, 1, 1, 0, 1, 1, 1]"
5646,3,3,6,0.8156554495680628,"[1, 0, 0, 1, 1, 1, 0, 1, 0, 0]"
5647,1,1,2,0.9177722250819154,"[0, 1, 0, 1, 1, 1, 1, 0, 0, 1]"
5648,1,1,2,0.06651752495875396,"[1, 1, 0, 1, 1, 0, 1, 1, 1, 0]"
5649,1,1,2,0.5633089642873068,"[0, 1, 0, 0, 1, 0, 0, 1, 1, 0]"
5650,3,3,6,0.0325053229912885,"[0, 0, 1, 1, 0, 0, 1, 0, 1, 0]"
5651,1,1,2,0.3917922707567766,"[0, 0, 0, 0, 0, 0, 0, 0, 1, 1]"
5652,2,2,4,0.9114552328460572,"[0, 1, 0, 0, 1, 1, 1, 1, 0, 0]"
5653,5,5,10,0.8689397441498503,"[0, 1, 0, 1, 1, 1, 1, 1, 0, 1]"
5654,1,1,2,0.44054323072365065,"[1, 0, 1, 1, 1, 0, 0, 0, 0, 1]"
5655,1,1,2,0.7999797152771524,"[1, 0, 1, 1, 1, 1, 1, 0, 1, 1]"
5656,1,1,2,0.7068494343085919,"[0, 0, 1, 0, 1, 1, 0, 1, 1, 1]"
5657,1,1,2,0.1243140828020044,"[0, 1, 0, 0, 1, 0, 0, 1, 0, 0]"
5658,3,3,6,0.3721645200791657,"[1, 1, 1, 0, 1, 0, 1, 1, 1, 1]"
5659,1,1,2,0.6103869841629156,"[0, 1, 1, 1, 0, 1, 0, 0, 0, 1]"
5660,1,1,2,0.6984463199760167,"[1, 0, 1, 0, 0, 0, 1, 0, 1, 1]"
5661,2,2,4,0.9014493755944682,"[1, 0, 0, 0, 1, 1, 0, 1, 1, 0]"
5662,1,1,2,0.7044410429789796,"[1, 0, 0, 1, 0, 1, 0, 0, 0, 1]"
5663,2,2,4,0.42679397023222176,"[1, 0, 0, 0, 1, 1, 0, 1, 0, 1]"
5664,2,2,4,0.9926616526945076,"[1, 0, 0, 0, 1, 1, 1, 0, 1, 1]"
5665,1,1,2,0.027042852110562565,"[1, 1, 1, 1, 0, 0, 0, 0, 1, 1]"
5666,3,3,6,0.9312216563806904,"[0, 0, 1, 0, 1, 1, 0, 0, 0, 1]"
5667,3,3,6,0.548388732229298,"[0, 1, 1, 1, 1, 1, 1, 0, 0, 0]"
5668,1,1,2,0.9524014957377843,"[1, 1, 1, 0, 1, 0, 0, 0, 1, 1]"
5669,1,1,2,0.510806578558682,"[1, 0, 0, 1, 0, 1, 1, 1, 0, 1]"
5670,1,1,2,0.5719396306460715,"[0, 0, 1, 0, 1, 0, 1, 0, 1, 0]"
5671,1,1,2,0.48452629773238676,"[0, 0, 1, 1, 1, 1, 1, 1, 1, 0]"
5672,1,1,2,0.4990595822707645,"[0, 0, 1, 1, 1, 0, 1, 0, 1, 0]"
5673,3,3,6,0.004639609142160772,"[1, 0, 0, 1, 1, 1, 1, 1, 1, 1]"
5674,1,1,2,0.8490819110880921,"[1, 0, 1, 0, 0, 0, 1, 0, 0, 1]"
5675,2,2,4,0.24672668746518023,"[0, 1, 1, 0, 1, 1, 1, 1, 0, 1]"
5676,1,1,2,0.034470503761130145,"[0, 0, 0, 1, 0, 1, 0, 1, 0, 1]"
5677,4,4,8,0.94254436615606,"[1, 0, 0, 1, 0, 0, 1, 0, 1, 1]"
5678,1,1,2,0.26179912664883254,"[0, 0, 0, 0, 1, 0, 0, 0, 0, 0]"
5679,4,4,8,0.07062699236010184,"[1, 0, 0, 0, 1, 1, 0, 1, 1, 1]"
5680,1,1,2,0.6809916801045675,"[1, 1, 0, 0, 1, 1, 0, 0, 1, 1]"
5681,2,2,4,0.33165333526473273,"[1, 0, 0, 1, 1, 1, 1, 0, 1, 1]"
5682,3,3,6,0.6813209388054265,"[0, 0, 0, 0, 0, 0, 0, 0, 1, 1]"
5683,1,1,2,0.05761646176109292,"[0, 1, 1, 0, 1, 0, 1, 0, 0, 0]"
5684,2,2,4,0.4334869745952793,"[1, 1, 0, 0, 0, 1, 0, 0, 1, 1]"
5685,1,1,2,0.5536984142657476,"[1, 1, 0, 0, 1, 1, 1, 0, 0, 0]"
5686,3,3,6,0.2836101929526339,"[0, 1, 1, 0, 0, 1, 1, 0, 0, 0]"
5687,1,1,2,0.2318497054159887,"[0, 0, 0, 1, 1, 1, 1, 1, 1, 1]"
5688,2,2,4,0.08578178772272083,"[1, 0, 0, 0, 0, 1, 0, 1, 1, 1]"
5689,3,3,6,0.1521286522415226,"[0, 0, 1, 0, 1, 1, 0, 1, 0, 0]"
5690,3,3,6,0.35159588971268774,"[0, 0, 1, 1, 1, 1, 0, 0, 0, 1]"
5691,1,1,2,0.29081433237717025,"[0, 1, 0, 1, 1, 0, 0, 0, 1, 0]"
5692,1,1,2,0.22893594758554547,"[0, 1, 1, 0, 0, 1, 0, 1, 1, 1]"
5693,3,3,6,0.7708184554607159,"[0, 1, 1, 1, 1, 1, 1, 0, 0, 1]"
5694,4,4,8,0.09698771001765827,"[1, 1, 0, 0, 0, 1, 1, 1, 1, 0]"
5695,2,2,4,0.3201538369526731,"[1, 1, 1, 0, 1, 1, 0, 1, 0, 1]"
5696,1,1,2,0.1515715039164951,"[0, 1, 1, 0, 1, 1, 0, 0, 1, 0]"
5697,1,1,2,0.17463183369155577,"[0, 0, 0, 1, 1, 0, 1, 0, 1, 0]"
5698,1,1,2,0.995767917349397,"[0, 1, 0, 0, 0, 1, 0, 1, 0, 0]"
5699,1,1,2,0.3930775615217037,"[0, 1, 0, 1, 0, 1, 0, 0, 0, 1]"
5700,1,1,2,0.07575751307053091,"[0, 1, 1, 1, 0, 0, 1, 0, 1, 0]"
5701,1,1,2,0.7506377599614045,"[1, 0, 1, 0, 1, 0, 0, 0, 1, 0]"
5702,1,1,2,0.19709910689145727,"[0, 0, 0, 1, 1, 0, 0, 1, 1, 1]"
5703,2,2,4,0.6113136584779864,"[0, 0, 0, 1, 1, 0, 0, 0, 0, 0]"
5704,1,1,2,0.9462808856220604,"[0, 1, 0, 0, 0, 1, 1, 0, 1, 0]"
5705,1,1,2,0.013595165421903643,"[0, 0, 1, 1, 1, 0, 1, 0, 1, 1]"
5706,1,1,2,0.996722652763173,"[1, 0, 0, 1, 1, 0, 0, 0, 1, 0]"
5707,1,1,2,0.5516081856746367,"[0, 0, 1, 1, 1, 1, 1, 0, 0, 0]"
5708,1,1,2,0.11435164447381929,"[0, 1, 0, 0, 1, 0, 0, 0, 1, 1]"
5709,1,1,2,0.04470010767950794,"[1, 0, 0, 0, 0, 1, 0, 1, 1, 0]"
5710,1,1,2,0.868449064765556,"[1, 1, 0, 0, 1, 1, 1, 0, 1, 0]"
5711,2,2,4,0.10040192494171474,"[0, 1, 0, 1, 1, 0, 1, 0, 1, 0]"
5712,3,3,6,0.726580315510305,"[1, 1, 1, 1, 1, 0, 0, 1, 0, 1]"
5713,1,1,2,0.9828714107775106,"[1, 1, 0, 0, 1, 1, 0, 1, 1, 0]"
5714,1,1,2,0.8521902100404387,"[1, 0, 0, 1, 1, 1, 1, 0, 1, 0]"
5715,1,1,2,0.21381118549066347,"[1, 0, 0, 1, 1, 0, 1, 0, 0, 1]"
5716,1,1,2,0.6418361019431499,"[0, 0, 1, 0, 1, 1, 1, 1, 1, 1]"
5717,1,1,2,0.9473176986853997,"[0, 0, 1, 0, 1, 0, 0, 1, 0, 0]"
5718,2,2,4,0.059284293810610844,"[0, 0, 1, 0, 0, 0, 1, 0, 1, 1]"
5719,1,1,2,0.9955148684989343,"[0, 1, 1, 1, 1, 1, 1, 0, 0, 1]"
5720,1,1,2,0.7641009293941982,"[1, 0, 0, 0, 0, 1, 0, 1, 0, 0]"
5721,2,2,4,0.10744215600126461,"[0, 1, 1, 1, 0, 0, 0, 0, 0, 1]"
5722,2,2,4,0.20988019649046308,"[0, 1, 1, 0, 1, 1, 0, 1, 1, 1]"
5723,1,1,2,0.953363477853468,"[1, 1, 1, 0, 0, 0, 0, 0, 1, 1]"
5724,1,1,2,0.2810042911557864,"[1, 0, 1, 0, 1, 1, 1, 0, 1, 0]"
5725,1,1,2,0.08614975311558559,"[0, 0, 0, 1, 0, 0, 1, 0, 0, 1]"
5726,3,3,6,0.9908587137843512,"[0, 1, 1, 1, 0, 0, 0, 1, 0, 0]"
5727,2,2,4,0.8785587156899831,"[1, 0, 1, 0, 1, 1, 1, 0, 1, 0]"
5728,2,2,4,0.9431727887602874,"[0, 1, 0, 1, 0, 1, 0, 1, 1, 0]"
5729,1,1,2,0.3513854773079452,"[0, 0, 1, 1, 0, 1, 1, 1, 0, 0]"
5730,1,1,2,0.3789028986366161,"[0, 1, 1, 1, 1, 1, 1, 0, 0, 0]"
5731,1,1,2,0.5317945627833712,"[0, 0, 1, 0, 1, 0, 0, 0, 1, 1]"
5732,2,2,4,0.41796692094519794,"[1, 1, 1, 0, 0, 1, 1, 1, 0, 1]"
5733,3,3,6,0.3435867586718294,"[0, 0, 1, 1, 1, 1, 1, 1, 0, 0]"
5734,1,1,2,0.916345760644949,"[1, 0, 0, 1, 1, 0, 0, 1, 1, 1]"
5735,1,1,2,0.5832436626257363,"[0, 1, 0, 0, 1, 1, 0, 1, 0, 1]"
5736,1,1,2,0.3061861284350803,"[0, 1, 1, 1, 1, 0, 0, 0, 1, 1]"
5737,1,1,2,0.6524764028083797,"[1, 1, 0, 1, 0, 1, 0, 0, 1, 1]"
5738,2,2,4,0.527715241401425,"[0, 0, 1, 1, 0, 0, 1, 1, 0, 1]"
5739,1,1,2,0.20520026749718157,"[0, 0, 0, 0, 0, 1, 1, 1, 1, 0]"
5740,1,1,2,0.28979656970999745,"[0, 1, 1, 0, 1, 1, 1, 1, 1, 0]"
5741,1,1,2,0.7094640753267375,"[1, 1, 0, 1, 0, 0, 0, 1, 1, 0]"
5742,1,1,2,0.6635388476771381,"[0, 0, 0, 1, 1, 0, 0, 0, 1, 0]"
5743,1,1,2,0.8967322274159115,"[0, 0, 0, 1, 1, 1, 0, 1, 0, 1]"
5744,1,1,2,0.8372845512377276,"[0, 0, 0, 0, 0, 0, 0, 1, 0, 1]"
5745,1,1,2,0.7821463654489849,"[1, 1, 0, 0, 0, 0, 1, 0, 0, 0]"
5746,2,2,4,0.9995660122890098,"[1, 1, 0, 1, 0, 1, 1, 1, 1, 1]"
5747,1,1,2,0.35412126005008704,"[0, 0, 1, 0, 0, 1, 0, 0, 0, 0]"
5748,1,1,2,0.05493243885660215,"[1, 0, 1, 0, 1, 0, 0, 1, 0, 0]"
5749,1,1,2,0.16846440834362986,"[0, 1, 0, 1, 0, 0, 1, 1, 1, 0]"
5750,2,2,4,0.7528876279547232,"[0, 0, 1, 0, 0, 1, 0, 0, 0, 0]"
5751,1,1,2,0.2339617024114321,"[1, 1, 0, 1, 0, 1, 1, 0, 0, 0]"
5752,3,3,6,0.21064832176095827,"[1, 1, 0, 1, 0, 1, 1, 1, 1, 0]"
5753,2,2,4,0.29549428883603557,"[1, 0, 1, 0, 1, 0, 1, 1, 0, 1]"
5754,5,5,10,0.6292301989455726,"[1, 0, 1, 1, 1, 0, 0, 0, 0, 0]"
5755,1,1,2,0.6842983357484979,"[0, 1, 1, 0, 1, 0, 1, 1, 0, 0]"
5756,1,1,2,0.4384108160028375,"[1, 1, 1, 1, 0, 1, 1, 0, 0, 0]"
5757,1,1,2,0.4927107326265785,"[1, 1, 0, 1, 0, 1, 0, 0, 0, 0]"
5758,2,2,4,0.8234277274240217,"[0, 0, 1, 1, 0, 0, 0, 0, 0, 1]"
5759,2,2,4,0.6496160351838619,"[1, 0, 0, 0, 1, 1, 1, 1, 0, 1]"
5760,1,1,2,0.10882909412665076,"[0, 1, 0, 0, 0, 1, 0, 1, 0, 0]"
5761,1,1,2,0.7117450405548342,"[1, 0, 0, 1, 0, 0, 0, 0, 0, 1]"
5762,2,2,4,0.6184738545431473,"[1, 1, 0, 1, 1, 0, 0, 1, 0, 1]"
5763,2,2,4,0.037246603734630845,"[1, 1, 0, 1, 0, 0, 0, 0, 0, 1]"
5764,1,1,2,0.759187209439884,"[1, 1, 1, 0, 1, 0, 0, 1, 1, 0]"
5765,2,2,4,0.4899486836473197,"[0, 0, 0, 0, 1, 0, 0, 1, 0, 1]"
5766,2,2,4,0.7558159748588242,"[0, 1, 0, 1, 0, 0, 0, 1, 1, 1]"
5767,1,1,2,0.7943916522823242,"[0, 1, 0, 0, 0, 1, 1, 0, 1, 0]"
5768,1,1,2,0.22795242463533727,"[1, 0, 0, 1, 0, 0, 0, 1, 0, 0]"
5769,2,2,4,0.9859858922874564,"[1, 0, 0, 1, 1, 1, 0, 1, 1, 1]"
5770,1,1,2,0.8641986332023537,"[1, 0, 0, 1, 1, 0, 0, 1, 1, 1]"
5771,2,2,4,0.43639216124246805,"[0, 1, 1, 0, 1, 0, 0, 1, 0, 0]"
5772,1,1,2,0.13497255568192779,"[1, 0, 0, 0, 0, 1, 0, 1, 0, 0]"
5773,1,1,2,0.28513076865125464,"[1, 0, 1, 1, 1, 0, 0, 0, 0, 1]"
5774,2,2,4,0.8111854095084576,"[0, 1, 1, 1, 0, 1, 0, 1, 1, 0]"
5775,2,2,4,0.43569456738861967,"[0, 1, 0, 1, 1, 1, 0, 1, 0, 0]"
5776,2,2,4,0.9452305269324074,"[1, 0, 0, 0, 0, 1, 1, 0, 1, 0]"
5777,3,3,6,0.8480547522278092,"[0, 1, 0, 1, 0, 1, 1, 1, 0, 1]"
5778,1,1,2,0.31950863638610194,"[1, 0, 0, 0, 0, 1, 0, 1, 0, 1]"
5779,2,2,4,0.08675921150291466,"[0, 1, 0, 1, 0, 1, 1, 1, 0, 1]"
5780,2,2,4,0.6883474886854697,"[0, 0, 1, 1, 0, 0, 0, 1, 1, 0]"
5781,2,2,4,0.7521981409340566,"[1, 1, 0, 1, 0, 0, 1, 1, 0, 1]"
5782,1,1,2,0.41518977888486686,"[0, 1, 1, 1, 1, 1, 1, 0, 1, 0]"
5783,1,1,2,0.4687944812116861,"[1, 0, 1, 1, 0, 1, 0, 1, 1, 0]"
5784,1,1,2,0.5893749985274519,"[0, 0, 1, 1, 0, 0, 0, 1, 1, 1]"
5785,1,1,2,0.5994323247819132,"[0, 1, 1, 0, 1, 0, 0, 0, 1, 0]"
5786,1,1,2,0.7878410767645402,"[0, 0, 0, 0, 1, 1, 0, 0, 0, 0]"
5787,1,1,2,0.9877854482516384,"[1, 1, 0, 0, 0, 0, 1, 1, 0, 1]"
5788,1,1,2,0.5741808213573661,"[1, 1, 0, 0, 0, 0, 0, 1, 1, 0]"
5789,1,1,2,0.15042866477929262,"[0, 0, 0, 1, 1, 1, 1, 1, 0, 0]"
5790,1,1,2,0.27837739460912836,"[0, 0, 0, 0, 1, 0, 0, 1, 1, 1]"
5791,2,2,4,0.11611801211478012,"[1, 1, 1, 1, 0, 0, 0, 1, 1, 0]"
5792,1,1,2,0.19174127566701105,"[0, 0, 0, 0, 1, 0, 1, 1, 1, 0]"
5793,2,2,4,0.5456730750138272,"[1, 0, 0, 0, 0, 0, 1, 1, 0, 0]"
5794,4,4,8,0.33368287169277133,"[0, 1, 0, 1, 0, 1, 1, 0, 1, 1]"
5795,1,1,2,0.8782385382135505,"[1, 1, 0, 0, 1, 1, 1, 0, 1, 0]"
5796,3,3,6,0.17464535185466712,"[1, 1, 0, 0, 0, 0, 0, 0, 1, 1]"
5797,1,1,2,0.2019502256802751,"[1, 0, 1, 0, 0, 1, 0, 0, 1, 0]"
5798,2,2,4,0.8954659240075774,"[0, 0, 0, 1, 0, 1, 1, 0, 0, 0]"
5799,4,4,8,0.4581829563650798,"[1, 1, 0, 0, 1, 0, 0, 1, 1, 1]"
5800,1,1,2,0.0002670296798962246,"[0, 0, 0, 1, 0, 1, 1, 0, 0, 1]"
5801,2,2,4,0.7100123216804981,"[0, 0, 1, 1, 1, 1, 0, 0, 0, 0]"
5802,3,3,6,0.2743372325620209,"[1, 1, 0, 0, 1, 1, 1, 0, 1, 0]"
5803,1,1,2,0.880593583306809,"[1, 1, 0, 0, 0, 1, 0, 1, 1, 0]"
5804,1,1,2,0.9214356092899506,"[1, 1, 1, 0, 0, 0, 1, 0, 0, 0]"
5805,2,2,4,0.4563279000547471,"[0, 1, 0, 0, 0, 1, 1, 0, 0, 1]"
5806,1,1,2,0.9494692989230616,"[0, 1, 0, 1, 0, 0, 0, 1, 1, 0]"
5807,2,2,4,0.5166738393937551,"[1, 1, 0, 1, 0, 0, 0, 0, 0, 0]"
5808,3,3,6,0.9679154532200529,"[1, 0, 0, 1, 1, 1, 0, 1, 0, 1]"
5809,1,1,2,0.36622735924101646,"[0, 1, 1, 1, 1, 1, 0, 0, 0, 0]"
5810,2,2,4,0.3204443379523365,"[1, 1, 0, 0, 1, 0, 1, 0, 0, 1]"
5811,1,1,2,0.9093871260519542,"[1, 1, 1, 1, 1, 1, 1, 1, 0, 0]"
5812,1,1,2,0.6979211419925976,"[0, 0, 1, 0, 0, 1, 1, 0, 1, 1]"
5813,2,2,4,0.6354477655552779,"[1, 0, 1, 0, 0, 0, 1, 0, 1, 1]"
5814,2,2,4,0.5216807945389991,"[1, 1, 1, 1, 1, 1, 0, 1, 0, 0]"
5815,2,2,4,0.9415304303137995,"[1, 0, 0, 0, 0, 1, 1, 0, 1, 0]"
5816,1,1,2,0.3114219825854895,"[0, 1, 0, 0, 0, 1, 0, 1, 1, 0]"
5817,2,2,4,0.6235678668330887,"[0, 0, 1, 1, 0, 0, 1, 1, 1, 1]"
5818,1,1,2,0.5202753100306564,"[0, 1, 0, 0, 1, 0, 0, 1, 0, 1]"
5819,3,3,6,0.8921727739116841,"[0, 0, 1, 1, 1, 0, 1, 0, 1, 1]"
5820,1,1,2,0.967022246627583,"[0, 0, 1, 1, 1, 0, 0, 0, 1, 0]"
5821,3,3,6,0.8716227092723228,"[1, 0, 0, 1, 1, 0, 0, 1, 1, 0]"
5822,2,2,4,0.9372841163906808,"[0, 1, 1, 1, 1, 1, 0, 0, 0, 1]"
5823,2,2,4,0.15486312259122115,"[1, 1, 0, 0, 1, 0, 1, 0, 1, 1]"
5824,1,1,2,0.5617599237878969,"[1, 0, 0, 0, 0, 0, 1, 0, 1, 0]"
5825,1,1,2,0.5221749213797784,"[1, 0, 0, 0, 0, 0, 0, 1, 0, 0]"
5826,1,1,2,0.8125365673787052,"[0, 1, 0, 1, 0, 1, 0, 0, 0, 0]"
5827,1,1,2,0.12317471774823396,"[1, 0, 0, 0, 0, 1, 0, 0, 1, 1]"
5828,1,1,2,0.025682748111206744,"[0, 1, 1, 1, 0, 0, 0, 1, 1, 0]"
5829,1,1,2,0.46084676711372097,"[1, 0, 0, 1, 0, 1, 0, 0, 1, 1]"
5830,2,2,4,0.33710278906882085,"[0, 1, 1, 1, 0, 1, 0, 0, 0, 1]"
5831,1,1,2,0.5730276410674908,"[0, 1, 0, 1, 0, 0, 1, 0, 0, 0]"
5832,1,1,2,0.9727293912520718,"[0, 0, 0, 1, 0, 0, 0, 0, 0, 1]"
5833,2,2,4,0.3924877479514509,"[1, 0, 1, 1, 0, 0, 1, 0, 0, 0]"
5834,3,3,6,0.24913473850813828,"[1, 0, 1, 0, 1, 1, 1, 1, 0, 0]"
5835,1,1,2,0.8736295761955467,"[1, 0, 0, 1, 1, 1, 1, 0, 1, 1]"
5836,1,1,2,0.892714303832159,"[0, 0, 0, 0, 1, 0, 1, 1, 0, 0]"
5837,1,1,2,0.8947531447187007,"[0, 0, 1, 1, 1, 0, 1, 0, 0, 1]"
5838,2,2,4,0.9056620558455318,"[0, 1, 1, 0, 0, 1, 1, 1, 0, 1]"
5839,1,1,2,0.2124885561033334,"[0, 0, 1, 0, 0, 0, 0, 0, 0, 0]"
5840,1,1,2,0.8100840191262355,"[1, 0, 1, 1, 0, 0, 0, 1, 0, 1]"
5841,1,1,2,0.8964303428763543,"[1, 0, 0, 1, 0, 0, 0, 0, 0, 1]"
5842,1,1,2,0.4999419412148439,"[0, 0, 0, 1, 1, 0, 0, 1, 0, 1]"
5843,1,1,2,0.20945960047726986,"[0, 0, 1, 0, 1, 1, 1, 1, 1, 0]"
5844,1,1,2,0.4495279768627507,"[0, 1, 0, 0, 1, 1, 1, 1, 0, 1]"
5845,2,2,4,0.17827645723943641,"[1, 0, 1, 1, 1, 1, 1, 0, 0, 0]"
5846,2,2,4,0.43646498348584484,"[0, 0, 0, 0, 0, 0, 0, 1, 0, 0]"
5847,1,1,2,0.6227555068354552,"[1, 0, 1, 0, 0, 1, 0, 0, 0, 1]"
5848,1,1,2,0.5653929118468433,"[0, 1, 0, 1, 1, 0, 1, 1, 0, 0]"
5849,1,1,2,0.5904153537318798,"[1, 0, 1, 0, 0, 0, 0, 1, 1, 1]"
5850,2,2,4,0.3247182028408139,"[1, 0, 1, 1, 1, 0, 0, 0, 1, 0]"
5851,1,1,2,0.7941750637987667,"[1, 0, 0, 1, 1, 0, 1, 1, 1, 0]"
5852,2,2,4,0.7732251834377557,"[1, 0, 1, 1, 0, 0, 0, 0, 0, 0]"
5853,2,2,4,0.8451966686986903,"[0, 0, 1, 0, 1, 0, 1, 1, 0, 1]"
5854,1,1,2,0.8768380890232128,"[0, 1, 1, 0, 0, 0, 1, 1, 0, 1]"
5855,1,1,2,0.9468546572426332,"[1, 1, 1, 1, 0, 0, 0, 0, 0, 1]"
5856,1,1,2,0.5256327599500263,"[0, 0, 1, 0, 0, 1, 0, 1, 1, 1]"
5857,1,1,2,0.9737776010276109,"[1, 1, 0, 1, 1, 1, 1, 0, 1, 0]"
5858,1,1,2,0.4700086139927131,"[1, 1, 0, 0, 0, 1, 0, 1, 0, 0]"
5859,5,5,10,0.4348246746191241,"[0, 1, 0, 1, 1, 1, 1, 1, 1, 1]"
5860,1,1,2,0.585022610827458,"[1, 1, 1, 0, 1, 0, 0, 0, 0, 1]"
5861,1,1,2,0.9501747855827981,"[1, 0, 0, 1, 1, 0, 0, 1, 0, 0]"
5862,1,1,2,0.011147735819792337,"[0, 0, 0, 1, 0, 1, 1, 1, 0, 1]"
5863,2,2,4,0.5773227143961884,"[0, 0, 0, 1, 0, 0, 1, 1, 0, 1]"
5864,1,1,2,0.5869022118499776,"[0, 0, 0, 1, 1, 1, 0, 0, 0, 0]"
5865,1,1,2,0.7382248381001127,"[1, 1, 0, 1, 0, 0, 0, 0, 0, 1]"
5866,2,2,4,0.6061824033911327,"[1, 1, 0, 1, 1, 0, 1, 0, 0, 0]"
5867,1,1,2,0.10437712115407372,"[0, 0, 0, 1, 1, 0, 1, 1, 1, 1]"
5868,1,1,2,0.7176847908299431,"[1, 0, 0, 1, 0, 1, 1, 0, 1, 1]"
5869,1,1,2,0.6702311563566556,"[0, 1, 0, 1, 1, 1, 1, 1, 0, 1]"
5870,1,1,2,0.3035764037531806,"[0, 0, 1, 0, 1, 1, 0, 1, 1, 0]"
5871,3,3,6,0.6278466236828495,"[0, 0, 1, 0, 1, 0, 0, 1, 0, 0]"
5872,2,2,4,0.8490631690360406,"[1, 1, 1, 0, 0, 0, 0, 1, 1, 1]"
5873,2,2,4,0.822193227247624,"[1, 1, 1, 0, 1, 0, 1, 0, 0, 1]"
5874,2,2,4,0.18909168855414193,"[1, 1, 0, 0, 0, 0, 1, 1, 1, 0]"
5875,1,1,2,0.023024028068110325,"[1, 0, 1, 0, 1, 1, 0, 0, 1, 0]"
5876,2,2,4,0.08287118132982929,"[0, 1, 0, 0, 0, 0, 1, 0, 0, 0]"
5877,2,2,4,0.9733900334944934,"[1, 1, 1, 0, 1, 0, 1, 1, 1, 1]"
5878,1,1,2,0.6141180174484918,"[0, 1, 0, 0, 0, 1, 1, 1, 0, 1]"
5879,3,3,6,0.5911671354404404,"[1, 0, 1, 1, 0, 0, 0, 0, 1, 1]"
5880,3,3,6,0.456630711598062,"[1, 1, 1, 1, 0, 0, 0, 1, 1, 1]"
5881,2,2,4,0.9721271253146564,"[0, 1, 1, 0, 1, 0, 1, 0, 0, 0]"
5882,1,1,2,0.034604199332493035,"[1, 0, 1, 0, 1, 1, 1, 0, 0, 0]"
5883,7,7,14,0.2794420806917738,"[1, 1, 1, 0, 0, 1, 0, 1, 1, 1]"
5884,1,1,2,0.1835545185239954,"[0, 0, 1, 0, 1, 1, 0, 1, 1, 0]"
5885,3,3,6,0.33314200011057316,"[1, 1, 1, 0, 0, 1, 0, 0, 1, 1]"
5886,2,2,4,0.8042744566957347,"[1, 0, 0, 1, 1, 1, 1, 1, 1, 1]"
5887,7,7,14,0.22173568282210865,"[1, 0, 1, 0, 0, 1, 1, 0, 1, 1]"
5888,2,2,4,0.39684480587643123,"[1, 0, 1, 0, 1, 1, 0, 0, 0, 1]"
5889,1,1,2,0.5796502611793402,"[1, 0, 1, 0, 1, 0, 0, 1, 1, 0]"
5890,2,2,4,0.6835697060896876,"[0, 0, 0, 1, 1, 0, 1, 0, 0, 0]"
5891,9,9,18,0.32153123002733985,"[1, 1, 1, 1, 1, 1, 0, 1, 1, 0]"
5892,1,1,2,0.9010446902954679,"[0, 1, 1, 0, 1, 0, 0, 0, 0, 0]"
5893,1,1,2,0.5929390875681649,"[0, 0, 0, 0, 0, 1, 0, 1, 1, 0]"
5894,1,1,2,0.24299044347428445,"[1, 0, 0, 1, 1, 0, 0, 0, 0, 0]"
5895,4,4,8,0.37199701700599286,"[1, 1, 1, 1, 0, 0, 0, 0, 1, 1]"
5896,1,1,2,0.4256748029546038,"[1, 1, 0, 1, 1, 1, 0, 1, 1, 0]"
5897,5,5,10,0.8160207381034933,"[1, 0, 0, 0, 1, 1, 0, 1, 1, 1]"
5898,5,5,10,0.8873460515883795,"[1, 1, 1, 1, 1, 0, 1, 1, 1, 1]"
5899,2,2,4,0.6451140382509095,"[0, 1, 0, 0, 1, 1, 0, 1, 0, 0]"
5900,3,3,6,0.9806529668436634,"[0, 0, 1, 1, 1, 1, 0, 0, 1, 1]"
5901,1,1,2,0.6781307539303306,"[1, 1, 0, 1, 0, 0, 0, 1, 1, 0]"
5902,1,1,2,0.4355814968377497,"[1, 0, 1, 1, 1, 0, 1, 0, 1, 1]"
5903,1,1,2,0.5503222156996174,"[0, 0, 0, 0, 1, 0, 1, 0, 0, 1]"
5904,5,5,10,0.7534464517533045,"[0, 1, 1, 1, 0, 1, 0, 0, 0, 0]"
5905,1,1,2,0.8361985987026886,"[1, 0, 0, 0, 1, 0, 1, 1, 0, 0]"
5906,1,1,2,0.9702314646416158,"[1, 1, 1, 0, 0, 0, 1, 0, 0, 0]"
5907,1,1,2,0.39428863023976723,"[0, 0, 1, 0, 0, 0, 0, 1, 1, 0]"
5908,1,1,2,0.36886314298603384,"[0, 0, 1, 0, 0, 1, 1, 0, 0, 1]"
5909,1,1,2,0.8893457721636728,"[0, 0, 0, 0, 0, 1, 1, 1, 1, 0]"
5910,1,1,2,0.7061050191534386,"[0, 1, 1, 1, 1, 1, 0, 1, 0, 0]"
5911,3,3,6,0.3634896298155734,"[1, 0, 0, 1, 0, 1, 0, 0, 1, 1]"
5912,2,2,4,0.7412515618629647,"[0, 0, 1, 1, 1, 1, 0, 0, 0, 1]"
5913,1,1,2,0.3228917341678267,"[1, 0, 1, 0, 0, 1, 1, 1, 1, 0]"
5914,1,1,2,0.5001914721367301,"[1, 0, 0, 1, 0, 0, 1, 1, 0, 0]"
5915,1,1,2,0.5562232598278123,"[1, 0, 0, 0, 1, 0, 0, 1, 0, 0]"
5916,2,2,4,0.5576958180224119,"[0, 1, 0, 1, 1, 1, 1, 1, 1, 0]"
5917,1,1,2,0.7964131048940463,"[0, 1, 1, 0, 1, 0, 1, 1, 0, 1]"
5918,1,1,2,0.5148446831285288,"[1, 0, 1, 1, 0, 1, 0, 0, 0, 0]"
5919,1,1,2,0.7801490536158833,"[1, 0, 0, 1, 0, 0, 1, 0, 0, 1]"
5920,2,2,4,0.652733737644426,"[1, 1, 0, 0, 1, 0, 1, 0, 0, 1]"
5921,2,2,4,0.004476063162399013,"[0, 0, 1, 0, 1, 1, 1, 0, 1, 0]"
5922,1,1,2,0.5853577181867945,"[0, 0, 1, 1, 0, 1, 0, 1, 0, 0]"
5923,1,1,2,0.17436367513904505,"[1, 1, 1, 0, 1, 0, 0, 0, 0, 0]"
5924,1,1,2,0.12979900040850822,"[1, 1, 0, 0, 1, 1, 0, 1, 1, 0]"
5925,1,1,2,0.4475742265584962,"[0, 0, 1, 0, 0, 1, 0, 1, 1, 0]"
5926,4,4,8,0.3515936832680071,"[0, 1, 1, 0, 1, 1, 1, 0, 1, 1]"
5927,3,3,6,0.6179002406761673,"[1, 0, 0, 0, 0, 1, 1, 0, 0, 0]"
5928,1,1,2,0.3551427566921497,"[0, 1, 0, 0, 1, 1, 1, 0, 0, 0]"
5929,1,1,2,0.886724737638272,"[1, 0, 1, 0, 0, 0, 1, 0, 0, 0]"
5930,1,1,2,0.12095251854938094,"[1, 1, 0, 0, 0, 0, 0, 0, 1, 0]"
5931,2,2,4,0.5962820566169346,"[0, 0, 1, 1, 0, 0, 0, 0, 0, 0]"
5932,1,1,2,0.5341295009398712,"[0, 0, 1, 0, 0, 0, 0, 1, 0, 0]"
5933,6,6,12,0.6055916876104164,"[0, 1, 1, 1, 1, 0, 0, 1, 0, 1]"
5934,5,5,10,0.34380716465363026,"[0, 1, 1, 1, 0, 1, 1, 1, 0, 1]"
5935,3,3,6,0.5274436413910626,"[0, 0, 1, 0, 0, 1, 0, 1, 0, 1]"
5936,1,1,2,0.27820533002792935,"[1, 1, 1, 1, 0, 0, 1, 1, 1, 0]"
5937,1,1,2,0.8273569613816928,"[1, 0, 1, 1, 1, 0, 1, 0, 0, 1]"
5938,1,1,2,0.25583655491600366,"[0, 0, 0, 1, 0, 0, 1, 0, 0, 0]"
5939,5,5,10,0.5564924515596231,"[0, 1, 0, 0, 0, 1, 1, 0, 1, 1]"
5940,2,2,4,0.2824003226409487,"[1, 0, 1, 0, 0, 1, 1, 0, 0, 0]"
5941,2,2,4,0.7269560993951183,"[1, 0, 1, 0, 1, 1, 1, 1, 0, 0]"
5942,1,1,2,0.9588205710919796,"[0, 1, 0, 1, 0, 0, 0, 1, 0, 0]"
5943,3,3,6,0.10854671322848697,"[0, 1, 0, 1, 1, 1, 1, 1, 0, 0]"
5944,2,2,4,0.9645026737855427,"[1, 0, 1, 0, 0, 1, 1, 1, 0, 1]"
5945,1,1,2,0.6582741699798842,"[1, 0, 0, 0, 0, 0, 0, 0, 0, 0]"
5946,1,1,2,0.08462471293140528,"[0, 0, 1, 1, 0, 1, 1, 1, 0, 1]"
5947,2,2,4,0.3419049165589625,"[0, 1, 1, 0, 1, 1, 1, 1, 0, 0]"
5948,2,2,4,0.7645056459981102,"[0, 1, 1, 1, 1, 0, 0, 0, 0, 1]"
5949,1,1,2,0.24553255862327084,"[0, 1, 0, 1, 0, 0, 1, 0, 1, 1]"
5950,1,1,2,0.5821274939504466,"[1, 0, 0, 1, 0, 1, 0, 1, 0, 0]"
5951,3,3,6,0.3676104014101116,"[0, 0, 0, 1, 1, 0, 1, 1, 1, 1]"
5952,7,7,14,0.95881666654783,"[1, 1, 1, 1, 0, 1, 1, 0, 0, 0]"
5953,2,2,4,0.6829344600546511,"[0, 0, 1, 0, 0, 1, 1, 1, 1, 1]"
5954,5,5,10,0.03807064848807784,"[0, 0, 0, 1, 1, 0, 0, 1, 1, 0]"
5955,1,1,2,0.16065985972818753,"[1, 0, 1, 1, 1, 1, 0, 1, 0, 0]"
5956,2,2,4,0.7346312433780943,"[1, 1, 1, 0, 1, 1, 1, 0, 1, 1]"
5957,2,2,4,0.04835537855726346,"[0, 0, 1, 0, 0, 1, 0, 0, 0, 1]"
5958,3,3,6,0.3934161670850286,"[1, 0, 0, 1, 0, 0, 0, 1, 1, 1]"
5959,1,1,2,0.4590569167342452,"[1, 1, 0, 1, 1, 1, 0, 1, 0, 1]"
5960,2,2,4,0.4014646117480519,"[0, 1, 0, 1, 1, 0, 0, 0, 1, 1]"
5961,1,1,2,0.018021538592858488,"[0, 1, 1, 0, 1, 0, 0, 1, 0, 1]"
5962,4,4,8,0.8251505446969221,"[0, 0, 0, 0, 0, 1, 1, 1, 1, 0]"
5963,1,1,2,0.9658345688094773,"[0, 1, 0, 0, 1, 1, 1, 0, 0, 1]"
5964,1,1,2,0.6649813372126662,"[1, 0, 1, 1, 1, 1, 0, 0, 0, 0]"
5965,1,1,2,0.6749940053836367,"[1, 1, 0, 1, 0, 0, 0, 0, 1, 0]"
5966,1,1,2,0.48425930703666964,"[1, 0, 0, 0, 0, 1, 0, 1, 0, 1]"
5967,2,2,4,0.04911659250300393,"[1, 0, 0, 1, 1, 1, 0, 0, 1, 1]"
5968,1,1,2,0.6388445148013032,"[0, 0, 1, 0, 0, 0, 0, 1, 0, 0]"
5969,2,2,4,0.9375575377663278,"[1, 0, 1, 0, 1, 0, 1, 1, 1, 1]"
5970,1,1,2,0.692594681721322,"[1, 1, 0, 0, 0, 1, 0, 1, 1, 0]"
5971,1,1,2,0.18779659369861668,"[1, 1, 1, 1, 0, 0, 1, 1, 1, 1]"
5972,1,1,2,0.06435505960929033,"[1, 0, 0, 1, 0, 0, 1, 0, 0, 0]"
5973,2,2,4,0.16374954556719423,"[1, 0, 0, 0, 1, 1, 0, 1, 0, 0]"
5974,1,1,2,0.9981918950095218,"[0, 0, 0, 0, 0, 0, 1, 1, 0, 1]"
5975,1,1,2,0.8869788993513262,"[0, 0, 0, 1, 0, 1, 0, 0, 1, 0]"
5976,3,3,6,0.5295717407403678,"[0, 1, 1, 1, 1, 0, 1, 0, 0, 1]"
5977,1,1,2,0.48398607516240766,"[0, 0, 1, 0, 0, 0, 0, 0, 0, 0]"
5978,1,1,2,0.9358610946466527,"[1, 0, 1, 0, 1, 1, 1, 1, 0, 1]"
5979,1,1,2,0.9441342043101926,"[1, 1, 1, 1, 0, 0, 0, 0, 0, 0]"
5980,4,4,8,0.02509067162436185,"[0, 1, 1, 1, 1, 1, 1, 1, 1, 0]"
5981,1,1,2,0.1886560626142606,"[1, 0, 0, 0, 1, 1, 1, 0, 0, 1]"
5982,1,1,2,0.4778362121069385,"[1, 0, 1, 1, 0, 1, 0, 0, 0, 0]"
5983,1,1,2,0.9770576630978669,"[1, 0, 0, 0, 0, 1, 1, 1, 0, 0]"
5984,1,1,2,0.47267513018750784,"[0, 1, 1, 1, 1, 1, 0, 1, 0, 0]"
5985,1,1,2,0.7895447887090404,"[0, 1, 0, 1, 0, 1, 1, 0, 0, 1]"
5986,1,1,2,0.3534235926261502,"[1, 0, 1, 1, 0, 0, 0, 1, 0, 0]"
5987,1,1,2,0.7229619359390421,"[0, 0, 1, 0, 0, 1, 0, 0, 0, 1]"
5988,1,1,2,0.35872584520115514,"[1, 0, 1, 1, 0, 1, 1, 0, 1, 1]"
5989,1,1,2,0.12103749948364295,"[1, 1, 0, 1, 1, 1, 0, 0, 1, 1]"
5990,1,1,2,0.7718499633618505,"[1, 0, 0, 0, 0, 0, 1, 1, 0, 0]"
5991,1,1,2,0.23238004463118545,"[1, 0, 1, 0, 1, 0, 1, 0, 0, 1]"
5992,1,1,2,0.42809155778345453,"[0, 0, 0, 0, 1, 0, 0, 1, 0, 0]"
5993,1,1,2,0.5388119428118042,"[1, 0, 1, 1, 1, 0, 0, 1, 0, 0]"
5994,2,2,4,0.7287075259994907,"[1, 1, 0, 0, 1, 0, 0, 1, 0, 0]"
5995,5,5,10,0.8428728538269178,"[0, 1, 1, 1, 1, 0, 1, 0, 1, 0]"
5996,1,1,2,0.5022896024911025,"[0, 0, 0, 0, 0, 1, 1, 1, 0, 1]"
5997,2,2,4,0.7477662689864806,"[1, 0, 1, 0, 1, 0, 1, 1, 1, 0]"
5998,2,2,4,0.9976468632204963,"[1, 0, 1, 1, 1, 1, 1, 0, 0, 1]"
5999,1,1,2,0.4060112614089587,"[0, 0, 0, 0, 0, 0, 0, 0, 1, 1]"
6000,1,1,2,0.46920938753249664,"[0, 1, 0, 1, 0, 0, 1, 0, 1, 1]"
6001,2,2,4,0.7850241952123531,"[0, 0, 1, 0, 1, 0, 0, 1, 1, 1]"
6002,2,2,4,0.8506133637263504,"[0, 0, 0, 0, 0, 0, 0, 0, 0, 1]"
6003,1,1,2,0.36136920690314767,"[1, 0, 0, 1, 0, 0, 0, 0, 1, 1]"
6004,1,1,2,0.9194705858246898,"[0, 1, 0, 0, 0, 1, 0, 0, 1, 0]"
6005,3,3,6,0.7350414459756621,"[0, 1, 1, 1, 0, 1, 0, 0, 1, 0]"
6006,1,1,2,0.6994968403464534,"[1, 1, 1, 0, 0, 1, 1, 0, 0, 0]"
6007,1,1,2,0.4416796772189914,"[0, 0, 0, 1, 1, 1, 0, 1, 1, 1]"
6008,1,1,2,0.44258774484164154,"[1, 1, 0, 1, 1, 1, 0, 1, 0, 0]"
6009,2,2,4,0.7813066565391429,"[0, 0, 1, 0, 0, 0, 0, 1, 1, 1]"
6010,4,4,8,0.6903053821643154,"[1, 1, 0, 0, 1, 0, 1, 1, 1, 0]"
6011,1,1,2,0.4595786621335597,"[0, 0, 1, 1, 0, 0, 0, 1, 1, 0]"
6012,1,1,2,0.33680576043297494,"[0, 0, 1, 0, 1, 0, 1, 0, 1, 1]"
6013,3,3,6,0.30773786928198055,"[1, 0, 1, 0, 0, 1, 1, 0, 1, 1]"
6014,3,3,6,0.828755320561225,"[0, 0, 1, 1, 0, 1, 0, 1, 0, 0]"
6015,4,4,8,0.2746949991401,"[1, 1, 1, 1, 1, 1, 1, 0, 0, 1]"
6016,1,1,2,0.7120274492305753,"[0, 0, 0, 0, 0, 1, 1, 0, 0, 0]"
6017,1,1,2,0.3614063262551336,"[1, 0, 1, 0, 1, 0, 1, 0, 1, 1]"
6018,2,2,4,0.17032523502733288,"[0, 1, 0, 1, 1, 0, 1, 0, 0, 0]"
6019,1,1,2,0.43133524951072444,"[0, 0, 0, 0, 0, 0, 1, 0, 1, 0]"
6020,1,1,2,0.7620011887716448,"[1, 1, 1, 1, 0, 0, 1, 0, 1, 1]"
6021,1,1,2,0.4811386342127676,"[1, 0, 0, 1, 1, 1, 0, 1, 1, 1]"
6022,2,2,4,0.6903485579428887,"[0, 0, 0, 1, 1, 1, 1, 0, 0, 0]"
6023,1,1,2,0.6077096806598831,"[1, 1, 1, 0, 1, 1, 0, 1, 0, 1]"
6024,1,1,2,0.3403854416835479,"[0, 0, 0, 0, 0, 0, 0, 0, 0, 0]"
6025,2,2,4,0.3871145389865994,"[1, 1, 0, 1, 0, 1, 0, 0, 1, 1]"
6026,1,1,2,0.08517835462556056,"[0, 1, 0, 0, 0, 0, 0, 0, 1, 1]"
6027,1,1,2,0.9944518193044551,"[0, 0, 1, 0, 1, 1, 1, 1, 1, 0]"
6028,1,1,2,0.18854953762216498,"[0, 0, 0, 1, 1, 0, 0, 1, 1, 0]"
6029,1,1,2,0.23422126855485348,"[1, 0, 0, 0, 0, 0, 0, 0, 1, 1]"
6030,1,1,2,0.3281090733216019,"[0, 0, 0, 1, 1, 1, 0, 0, 0, 0]"
6031,1,1,2,0.925666918306595,"[1, 0, 0, 0, 1, 0, 1, 1, 1, 0]"
6032,1,1,2,0.543867059677376,"[1, 0, 1, 1, 1, 0, 0, 0, 1, 1]"
6033,2,2,4,0.5495818052321322,"[1, 1, 1, 1, 0, 0, 0, 1, 1, 1]"
6034,2,2,4,0.8093016642072988,"[0, 1, 1, 0, 0, 1, 1, 1, 1, 1]"
6035,4,4,8,0.5560383263615735,"[1, 0, 1, 0, 1, 1, 0, 1, 1, 0]"
6036,1,1,2,0.20588780143930185,"[1, 1, 1, 0, 0, 0, 1, 0, 0, 0]"
6037,2,2,4,0.29181384526311405,"[0, 1, 0, 1, 0, 1, 0, 1, 1, 0]"
6038,1,1,2,0.3493481145961076,"[0, 0, 0, 0, 0, 0, 0, 0, 1, 1]"
6039,1,1,2,0.275899968434715,"[0, 0, 0, 0, 1, 0, 1, 1, 1, 0]"
6040,4,4,8,0.5469459190282926,"[0, 1, 1, 0, 1, 0, 1, 0, 0, 1]"
6041,1,1,2,0.6610827246501599,"[0, 1, 1, 1, 0, 1, 1, 0, 0, 0]"
6042,2,2,4,0.15710908102190801,"[1, 1, 0, 1, 1, 0, 1, 0, 1, 1]"
6043,1,1,2,0.885331857154143,"[0, 0, 0, 1, 1, 1, 0, 1, 1, 0]"
6044,4,4,8,0.7909358198296513,"[1, 1, 1, 0, 0, 1, 1, 0, 1, 0]"
6045,1,1,2,0.995925528386649,"[0, 0, 0, 1, 0, 0, 1, 0, 1, 0]"
6046,1,1,2,0.4245737433457336,"[1, 1, 0, 0, 1, 0, 0, 0, 0, 0]"
6047,6,6,12,0.2940104695379071,"[1, 0, 1, 1, 0, 0, 0, 0, 0, 1]"
6048,1,1,2,0.5686239226946137,"[1, 0, 0, 0, 1, 0, 1, 1, 0, 1]"
6049,1,1,2,0.9143980512570246,"[0, 1, 0, 1, 0, 0, 1, 1, 1, 1]"
6050,1,1,2,0.9914741279766814,"[1, 1, 0, 1, 0, 0, 0, 1, 0, 0]"
6051,2,2,4,0.7077223317344591,"[1, 0, 1, 0, 1, 0, 1, 1, 0, 0]"
6052,1,1,2,0.22906880876781954,"[0, 1, 0, 0, 0, 0, 1, 0, 1, 0]"
6053,1,1,2,0.6385327377531069,"[0, 0, 1, 1, 0, 1, 0, 0, 0, 1]"
6054,5,5,10,0.4397012309688819,"[1, 0, 0, 1, 1, 1, 1, 1, 0, 1]"
6055,3,3,6,0.5715826015136999,"[0, 0, 0, 0, 0, 0, 0, 1, 1, 0]"
6056,1,1,2,0.3315958664028007,"[1, 1, 0, 1, 1, 1, 1, 0, 0, 0]"
6057,1,1,2,0.3343698734407391,"[1, 1, 0, 1, 0, 0, 1, 1, 0, 0]"
6058,1,1,2,0.25627658734395475,"[1, 1, 0, 0, 1, 1, 0, 0, 1, 0]"
6059,1,1,2,0.9694737813478308,"[0, 0, 0, 1, 0, 1, 1, 0, 1, 0]"
6060,1,1,2,0.8101666280679934,"[0, 0, 0, 0, 1, 1, 0, 0, 1, 1]"
6061,4,4,8,0.5706712642761695,"[0, 0, 1, 1, 0, 1, 1, 1, 1, 1]"
6062,1,1,2,0.7032334761146497,"[0, 1, 0, 0, 1, 1, 1, 0, 0, 0]"
6063,1,1,2,0.9170344674284042,"[1, 0, 1, 1, 1, 0, 0, 0, 0, 0]"
6064,1,1,2,0.3145303212765851,"[0, 0, 1, 1, 0, 1, 0, 1, 0, 0]"
6065,7,7,14,0.019009789367580354,"[0, 0, 0, 0, 1, 0, 1, 0, 1, 1]"
6066,2,2,4,0.807211462068184,"[0, 1, 0, 1, 1, 1, 0, 0, 0, 1]"
6067,1,1,2,0.3547641525643652,"[1, 1, 0, 0, 1, 1, 0, 1, 1, 0]"
6068,2,2,4,0.8271654057688013,"[1, 0, 0, 0, 0, 0, 1, 1, 0, 0]"
6069,1,1,2,0.051021571440480584,"[0, 1, 1, 1, 0, 0, 1, 0, 0, 0]"
6070,2,2,4,0.7690063101800998,"[1, 0, 0, 0, 1, 0, 0, 1, 1, 0]"
6071,3,3,6,0.4520773045490789,"[1, 0, 0, 1, 0, 0, 1, 1, 0, 1]"
6072,1,1,2,0.2546311234472963,"[0, 0, 0, 0, 1, 0, 0, 0, 0, 0]"
6073,1,1,2,0.17987796384488897,"[1, 1, 0, 0, 0, 0, 1, 1, 1, 1]"
6074,1,1,2,0.3265403202007712,"[0, 1, 0, 0, 0, 0, 1, 0, 1, 0]"
6075,2,2,4,0.1956643774021798,"[0, 1, 1, 0, 0, 1, 1, 1, 1, 0]"
6076,1,1,2,0.7565269147629274,"[0, 0, 0, 0, 1, 0, 1, 0, 0, 0]"
6077,1,1,2,0.5957510200687233,"[1, 0, 0, 0, 1, 1, 1, 0, 1, 0]"
6078,3,3,6,0.22947785655030495,"[1, 0, 1, 0, 1, 0, 1, 0, 0, 1]"
6079,1,1,2,0.6276755613506608,"[1, 1, 0, 1, 1, 1, 1, 0, 1, 1]"
6080,1,1,2,0.9213702349728039,"[0, 1, 0, 1, 1, 1, 0, 1, 0, 0]"
6081,3,3,6,0.09342052555001623,"[1, 0, 0, 0, 1, 1, 1, 1, 0, 0]"
6082,2,2,4,0.6644922622626206,"[0, 1, 1, 1, 0, 1, 0, 1, 0, 0]"
6083,1,1,2,0.6635691679166935,"[0, 0, 0, 1, 0, 0, 0, 0, 1, 0]"
6084,1,1,2,0.17135355897882132,"[1, 0, 0, 1, 0, 0, 0, 1, 1, 0]"
6085,3,3,6,0.1110126730081974,"[1, 1, 1, 0, 0, 0, 0, 1, 0, 1]"
6086,6,6,12,0.7764919644773879,"[1, 1, 0, 1, 1, 0, 1, 1, 0, 1]"
6087,2,2,4,0.19637795172506978,"[0, 0, 0, 0, 1, 0, 1, 1, 1, 1]"
6088,1,1,2,0.7140695181981985,"[0, 1, 0, 1, 0, 1, 0, 0, 0, 1]"
6089,2,2,4,0.13497089244845795,"[0, 1, 1, 0, 1, 1, 0, 1, 0, 0]"
6090,2,2,4,0.09233653239680184,"[1, 1, 0, 1, 1, 1, 0, 0, 0, 0]"
6091,2,2,4,0.2078920277171984,"[1, 1, 1, 1, 1, 0, 0, 1, 0, 1]"
6092,2,2,4,0.29981664211013037,"[0, 0, 0, 1, 0, 1, 0, 0, 1, 1]"
6093,1,1,2,0.7743973642845808,"[0, 1, 0, 1, 0, 0, 0, 1, 0, 1]"
6094,1,1,2,0.4357232632452288,"[1, 0, 1, 0, 0, 0, 0, 1, 0, 0]"
6095,1,1,2,0.9014933311427528,"[1, 1, 0, 1, 0, 0, 0, 0, 0, 1]"
6096,1,1,2,0.8163701211859312,"[0, 0, 0, 0, 1, 0, 1, 0, 1, 0]"
6097,4,4,8,0.19449613417831357,"[0, 1, 1, 1, 0, 0, 1, 0, 0, 1]"
6098,1,1,2,0.050036628924118975,"[0, 1, 1, 1, 1, 0, 1, 1, 0, 0]"
6099,3,3,6,0.0786164154339859,"[0, 1, 1, 1, 0, 1, 1, 0, 0, 1]"
6100,3,3,6,0.027535278969429755,"[1, 1, 1, 0, 1, 0, 0, 0, 1, 0]"
6101,1,1,2,0.5922024855617426,"[1, 0, 1, 1, 0, 1, 1, 0, 0, 0]"
6102,1,1,2,0.8760867523711492,"[0, 1, 0, 0, 0, 1, 1, 0, 0, 0]"
6103,3,3,6,0.3674531760134512,"[1, 1, 1, 1, 0, 1, 1, 1, 1, 0]"
6104,3,3,6,0.6184292132741863,"[1, 1, 0, 0, 0, 0, 0, 1, 1, 1]"
6105,2,2,4,0.6298921397597264,"[1, 1, 0, 0, 0, 0, 1, 0, 0, 1]"
6106,5,5,10,0.5295873511591467,"[1, 0, 0, 1, 0, 1, 0, 1, 1, 1]"
6107,1,1,2,0.7115717103569911,"[0, 0, 1, 0, 0, 0, 1, 0, 0, 0]"
6108,1,1,2,0.4433216758526971,"[0, 0, 1, 1, 1, 0, 1, 1, 1, 0]"
6109,2,2,4,0.13430705003111743,"[1, 0, 1, 1, 1, 0, 1, 1, 1, 1]"
6110,1,1,2,0.1189693574828441,"[0, 0, 0, 1, 0, 0, 0, 0, 1, 0]"
6111,5,5,10,0.6706955956226536,"[1, 1, 0, 1, 1, 0, 1, 0, 1, 0]"
6112,2,2,4,0.38998919836544144,"[0, 0, 1, 1, 1, 1, 1, 1, 0, 1]"
6113,3,3,6,0.10635250898946014,"[0, 0, 1, 1, 1, 1, 0, 1, 1, 1]"
6114,2,2,4,0.09456451336272431,"[0, 1, 1, 1, 1, 0, 0, 1, 1, 1]"
6115,1,1,2,0.1584775888935146,"[1, 1, 0, 0, 0, 1, 0, 1, 1, 1]"
6116,1,1,2,0.016737632822612092,"[0, 1, 0, 1, 0, 1, 0, 0, 1, 0]"
6117,1,1,2,0.8853835596685093,"[0, 1, 0, 1, 0, 1, 0, 0, 0, 0]"
6118,1,1,2,0.8320121025814023,"[0, 1, 1, 0, 0, 1, 0, 0, 0, 0]"
6119,1,1,2,0.7553233244595131,"[0, 0, 1, 1, 1, 0, 1, 1, 0, 1]"
6120,2,2,4,0.8160169486234619,"[0, 0, 0, 0, 1, 0, 0, 0, 0, 1]"
6121,1,1,2,0.3990061673699843,"[0, 0, 1, 1, 1, 1, 0, 0, 0, 1]"
6122,2,2,4,0.5349241876513825,"[0, 0, 1, 1, 0, 0, 1, 1, 0, 0]"
6123,3,3,6,0.04556981007117833,"[0, 1, 1, 0, 1, 1, 1, 1, 0, 0]"
6124,1,1,2,0.007824432457654407,"[1, 0, 0, 0, 1, 1, 0, 1, 0, 1]"
6125,2,2,4,0.9127823122736448,"[1, 1, 1, 1, 0, 0, 0, 1, 1, 0]"
6126,3,3,6,0.12431465720600376,"[1, 0, 0, 1, 0, 0, 1, 1, 1, 1]"
6127,1,1,2,0.8300984316996014,"[1, 0, 0, 0, 0, 0, 1, 0, 0, 0]"
6128,2,2,4,0.36698473563882783,"[1, 1, 0, 1, 1, 1, 0, 0, 1, 1]"
6129,1,1,2,0.5532568435035736,"[1, 0, 0, 0, 0, 1, 1, 1, 0, 0]"
6130,4,4,8,0.21118692990647825,"[0, 1, 0, 1, 1, 1, 0, 1, 1, 1]"
6131,1,1,2,0.5284940289704042,"[0, 0, 0, 0, 1, 0, 1, 0, 1, 0]"
6132,2,2,4,0.28640962195635244,"[0, 1, 1, 0, 1, 0, 0, 0, 1, 1]"
6133,2,2,4,0.015893218251494923,"[0, 1, 1, 1, 0, 0, 1, 1, 1, 0]"
6134,1,1,2,0.7680472417085029,"[1, 1, 1, 0, 1, 0, 1, 0, 1, 0]"
6135,1,1,2,0.34836767272052993,"[1, 0, 0, 1, 1, 1, 1, 0, 1, 0]"
6136,4,4,8,0.7852498466625155,"[1, 0, 0, 1, 1, 0, 1, 1, 1, 1]"
6137,2,2,4,0.06170712941660095,"[0, 1, 1, 1, 1, 1, 0, 0, 0, 0]"
6138,1,1,2,0.9929406360932728,"[0, 1, 0, 0, 0, 0, 1, 0, 1, 0]"
6139,1,1,2,0.6562276433780619,"[1, 1, 0, 1, 1, 1, 0, 1, 1, 0]"
6140,1,1,2,0.41264900735731114,"[0, 1, 1, 0, 0, 0, 1, 0, 1, 0]"
6141,1,1,2,0.15172433641734262,"[1, 1, 0, 1, 1, 1, 1, 1, 0, 1]"
6142,1,1,2,0.1868434058989813,"[0, 0, 1, 1, 0, 0, 1, 0, 1, 0]"
6143,1,1,2,0.29569367085268194,"[1, 1, 1, 1, 0, 1, 0, 0, 0, 0]"
6144,3,3,6,0.8444081546957666,"[1, 0, 1, 0, 0, 1, 0, 0, 0, 1]"
6145,1,1,2,0.04472444429021383,"[0, 0, 1, 1, 1, 1, 0, 1, 0, 0]"
6146,5,5,10,0.019225688372030647,"[1, 1, 1, 0, 1, 0, 1, 0, 0, 0]"
6147,1,1,2,0.5606139616117541,"[0, 0, 0, 1, 1, 1, 0, 0, 0, 0]"
6148,1,1,2,0.8599163410649081,"[0, 0, 0, 1, 1, 1, 0, 1, 1, 1]"
6149,1,1,2,0.785794389320165,"[0, 0, 1, 1, 1, 1, 0, 0, 1, 0]"
6150,1,1,2,0.48596396666681396,"[0, 1, 1, 1, 0, 1, 1, 0, 1, 1]"
6151,1,1,2,0.40083272240950696,"[1, 1, 0, 1, 0, 0, 1, 0, 0, 1]"
6152,1,1,2,0.1811712560422276,"[0, 0, 0, 1, 0, 1, 1, 1, 1, 0]"
6153,2,2,4,0.7951944697984977,"[0, 0, 0, 0, 1, 0, 1, 1, 1, 0]"
6154,1,1,2,0.9277940033684062,"[1, 0, 0, 1, 1, 0, 1, 1, 0, 0]"
6155,1,1,2,0.9326313531342083,"[0, 0, 0, 1, 1, 1, 1, 0, 1, 0]"
6156,1,1,2,0.15295888980011185,"[1, 1, 0, 0, 1, 0, 0, 1, 0, 0]"
6157,1,1,2,0.16600504098285518,"[1, 0, 1, 1, 0, 0, 1, 1, 1, 0]"
6158,1,1,2,0.9256238403415702,"[0, 0, 1, 1, 0, 1, 1, 0, 1, 0]"
6159,1,1,2,0.2922260065810337,"[0, 0, 1, 1, 0, 1, 0, 1, 0, 1]"
6160,1,1,2,0.6861341727141838,"[1, 1, 0, 0, 1, 0, 1, 1, 1, 1]"
6161,1,1,2,0.6611603998987132,"[1, 0, 1, 1, 1, 0, 0, 1, 0, 1]"
6162,1,1,2,0.15960205393613436,"[0, 1, 1, 0, 1, 0, 1, 0, 0, 0]"
6163,1,1,2,0.029223450758657843,"[1, 0, 0, 0, 1, 0, 0, 0, 0, 0]"
6164,1,1,2,0.020514732682093362,"[0, 0, 0, 1, 0, 0, 0, 0, 1, 1]"
6165,2,2,4,0.7279768203132194,"[0, 0, 0, 0, 1, 0, 0, 1, 1, 1]"
6166,1,1,2,0.1825924899466258,"[0, 0, 1, 0, 0, 1, 1, 0, 0, 1]"
6167,1,1,2,0.6207217965313218,"[0, 1, 0, 0, 0, 0, 1, 1, 0, 0]"
6168,2,2,4,0.2272793389654818,"[0, 1, 1, 0, 1, 0, 1, 0, 0, 1]"
6169,2,2,4,0.5779942181716572,"[1, 0, 0, 0, 0, 0, 1, 1, 0, 0]"
6170,1,1,2,0.3881052211854371,"[1, 1, 1, 0, 1, 1, 1, 1, 0, 0]"
6171,4,4,8,0.509161404137818,"[0, 0, 1, 0, 0, 1, 1, 1, 1, 0]"
6172,2,2,4,0.2938989409130697,"[1, 1, 1, 0, 1, 0, 0, 1, 0, 1]"
6173,1,1,2,0.5410357793785381,"[1, 0, 0, 1, 0, 1, 0, 0, 0, 0]"
6174,3,3,6,0.687876454262676,"[0, 0, 0, 0, 0, 1, 1, 0, 1, 0]"
6175,1,1,2,0.6607143865201958,"[1, 1, 0, 1, 1, 1, 1, 0, 0, 1]"
6176,1,1,2,0.524874637214645,"[0, 0, 1, 0, 1, 0, 1, 1, 1, 0]"
6177,1,1,2,0.8625999659672403,"[1, 0, 0, 1, 1, 1, 1, 0, 1, 0]"
6178,1,1,2,0.07479956428596668,"[0, 1, 0, 1, 1, 0, 0, 1, 1, 0]"
6179,1,1,2,0.5874940842881607,"[0, 0, 1, 1, 0, 0, 0, 1, 1, 1]"
6180,2,2,4,0.740274018916542,"[1, 1, 0, 0, 1, 1, 0, 1, 0, 0]"
6181,1,1,2,0.6313260693106064,"[0, 1, 0, 1, 0, 0, 1, 0, 0, 1]"
6182,2,2,4,0.4162029918928859,"[0, 0, 0, 1, 1, 1, 0, 1, 0, 1]"
6183,1,1,2,0.10435551752770766,"[0, 0, 0, 1, 0, 0, 0, 0, 0, 0]"
6184,4,4,8,0.15468422013001482,"[1, 0, 1, 1, 0, 0, 1, 1, 1, 1]"
6185,2,2,4,0.1845348991585949,"[0, 0, 0, 1, 0, 1, 0, 0, 1, 0]"
6186,1,1,2,0.8534986940703637,"[0, 1, 1, 1, 0, 0, 1, 0, 0, 0]"
6187,5,5,10,0.5150895428365545,"[1, 1, 0, 1, 1, 1, 0, 0, 0, 1]"
6188,2,2,4,0.48160134780331765,"[0, 1, 0, 0, 0, 0, 0, 1, 0, 0]"
6189,3,3,6,0.39965619044577916,"[1, 0, 1, 1, 0, 1, 0, 1, 0, 0]"
6190,1,1,2,0.9073353630488409,"[1, 0, 0, 0, 0, 1, 1, 0, 0, 0]"
6191,1,1,2,0.2011758276448532,"[1, 0, 0, 0, 1, 0, 1, 0, 0, 0]"
6192,1,1,2,0.4050884920103681,"[0, 1, 1, 0, 0, 1, 1, 1, 1, 0]"
6193,2,2,4,0.32941593768756294,"[0, 1, 1, 0, 1, 0, 1, 1, 0, 1]"
6194,1,1,2,0.42604710999115747,"[1, 1, 0, 0, 0, 0, 0, 1, 0, 1]"
6195,1,1,2,0.6867318049732781,"[1, 0, 1, 1, 0, 0, 0, 1, 1, 1]"
6196,1,1,2,0.078030931754137,"[0, 0, 0, 1, 0, 0, 1, 0, 1, 1]"
6197,4,4,8,0.08725897377515968,"[0, 0, 1, 1, 1, 0, 1, 1, 0, 1]"
6198,1,1,2,0.8236827668815542,"[0, 1, 0, 0, 0, 0, 0, 0, 1, 1]"
6199,3,3,6,0.16679674318080273,"[0, 0, 0, 0, 0, 1, 1, 0, 1, 1]"
6200,2,2,4,0.6673438040012821,"[1, 1, 1, 1, 0, 1, 1, 1, 1, 1]"
6201,1,1,2,0.6943412220900025,"[0, 1, 1, 1, 0, 0, 1, 1, 1, 0]"
6202,2,2,4,0.6670578873544758,"[0, 0, 0, 1, 0, 0, 1, 1, 1, 0]"
6203,1,1,2,0.569081992782868,"[0, 0, 0, 1, 1, 1, 1, 1, 1, 1]"
6204,2,2,4,0.3896255980665977,"[0, 1, 0, 1, 1, 1, 1, 1, 1, 0]"
6205,1,1,2,0.3279336151048663,"[1, 0, 0, 1, 0, 0, 1, 0, 0, 0]"
6206,3,3,6,0.3176478543065011,"[0, 0, 0, 0, 1, 0, 1, 1, 1, 1]"
6207,8,8,16,0.213343519233688,"[1, 1, 1, 1, 0, 0, 0, 1, 0, 0]"
6208,2,2,4,0.8932602567023195,"[0, 1, 0, 1, 0, 0, 0, 1, 0, 1]"
6209,1,1,2,0.09094369885522235,"[1, 0, 1, 1, 1, 1, 0, 1, 0, 1]"
6210,1,1,2,0.19775676248685115,"[1, 1, 1, 0, 0, 0, 1, 1, 1, 1]"
6211,1,1,2,0.9220332129602264,"[0, 1, 0, 0, 0, 0, 0, 1, 0, 1]"
6212,1,1,2,0.21418125550999212,"[1, 0, 1, 0, 1, 0, 1, 0, 0, 1]"
6213,1,1,2,0.5766235344274965,"[1, 0, 0, 0, 1, 0, 1, 0, 0, 1]"
6214,3,3,6,0.8920666591740418,"[1, 0, 1, 0, 0, 1, 1, 1, 1, 0]"
6215,1,1,2,0.7799408522124672,"[0, 1, 1, 1, 1, 0, 0, 1, 1, 0]"
6216,1,1,2,0.811914661827914,"[0, 0, 0, 1, 0, 0, 0, 1, 1, 0]"
6217,3,3,6,0.8258272381455096,"[1, 0, 1, 0, 0, 1, 1, 1, 0, 1]"
6218,2,2,4,0.1657782978527811,"[0, 0, 1, 0, 0, 1, 1, 0, 0, 1]"
6219,1,1,2,0.2424064194353912,"[0, 0, 1, 1, 1, 0, 1, 1, 0, 1]"
6220,1,1,2,0.04003431535752733,"[0, 1, 0, 1, 1, 0, 1, 0, 0, 0]"
6221,1,1,2,0.9333682103979358,"[1, 1, 0, 0, 1, 1, 0, 0, 1, 0]"
6222,1,1,2,0.9319483808003795,"[0, 0, 0, 1, 1, 0, 0, 0, 0, 1]"
6223,1,1,2,0.6613688880729575,"[0, 0, 0, 0, 0, 1, 0, 0, 0, 0]"
6224,1,1,2,0.19301696114488975,"[0, 0, 1, 1, 0, 0, 1, 0, 1, 1]"
6225,2,2,4,0.25636657723837486,"[1, 1, 0, 0, 1, 1, 0, 0, 0, 1]"
6226,1,1,2,0.851149779127982,"[0, 1, 0, 0, 1, 1, 1, 1, 0, 0]"
6227,1,1,2,0.8442299202634987,"[1, 1, 1, 0, 0, 1, 1, 0, 0, 0]"
6228,1,1,2,0.17087770027145455,"[1, 0, 1, 0, 1, 0, 1, 0, 1, 0]"
6229,1,1,2,0.7958880783198401,"[1, 1, 1, 1, 0, 0, 0, 0, 1, 1]"
6230,1,1,2,0.9459375870680815,"[1, 0, 0, 1, 0, 0, 0, 0, 1, 1]"
6231,1,1,2,0.6394385600091875,"[1, 1, 0, 0, 1, 1, 1, 0, 1, 0]"
6232,1,1,2,0.08853482190634698,"[1, 1, 0, 0, 1, 1, 1, 1, 0, 1]"
6233,1,1,2,0.6542668312347812,"[0, 1, 0, 0, 0, 0, 0, 0, 1, 1]"
6234,2,2,4,0.13118548833618626,"[0, 0, 1, 1, 1, 0, 0, 0, 0, 0]"
6235,1,1,2,0.5307727027327154,"[0, 1, 1, 1, 1, 1, 0, 1, 0, 0]"
6236,1,1,2,0.04995359954033585,"[1, 0, 1, 1, 1, 0, 1, 1, 0, 1]"
6237,1,1,2,0.04149314153285033,"[0, 1, 1, 1, 0, 0, 0, 0, 1, 1]"
6238,2,2,4,0.5826900532172672,"[1, 1, 1, 0, 1, 1, 1, 0, 0, 0]"
6239,1,1,2,0.20645751515204003,"[0, 0, 0, 0, 1, 1, 1, 1, 1, 0]"
6240,2,2,4,0.7942177813533071,"[0, 1, 1, 1, 1, 1, 0, 0, 0, 0]"
6241,3,3,6,0.7362121788855077,"[1, 0, 1, 0, 1, 0, 0, 0, 0, 1]"
6242,1,1,2,0.47298804179318765,"[1, 1, 0, 1, 1, 1, 0, 0, 0, 1]"
6243,1,1,2,0.2863267737863777,"[0, 1, 0, 0, 1, 0, 1, 0, 0, 1]"
6244,1,1,2,0.2525964408551574,"[1, 1, 1, 1, 0, 1, 1, 1, 1, 0]"
6245,1,1,2,0.520952255059279,"[0, 1, 0, 1, 1, 0, 0, 1, 0, 0]"
6246,1,1,2,0.2213459443347382,"[0, 1, 1, 0, 1, 1, 0, 1, 0, 0]"
6247,3,3,6,0.5179920923357001,"[0, 1, 1, 1, 0, 1, 0, 0, 1, 0]"
6248,2,2,4,0.7288014767914057,"[0, 1, 1, 0, 0, 0, 0, 1, 1, 1]"
6249,1,1,2,0.3259842189362938,"[1, 1, 1, 1, 0, 0, 1, 0, 1, 1]"
6250,1,1,2,0.7895154436647205,"[1, 0, 0, 0, 0, 1, 0, 1, 1, 1]"
6251,2,2,4,0.11718157093020465,"[0, 1, 1, 0, 1, 0, 0, 1, 1, 0]"
6252,2,2,4,0.49907166753846377,"[1, 1, 0, 1, 1, 0, 0, 1, 1, 1]"
6253,1,1,2,0.03033696757829818,"[0, 0, 0, 1, 1, 0, 0, 1, 1, 1]"
6254,1,1,2,0.14330072720535902,"[0, 1, 0, 1, 0, 0, 0, 1, 1, 1]"
6255,1,1,2,0.9340721553831962,"[1, 0, 0, 0, 0, 1, 1, 0, 0, 0]"
6256,1,1,2,0.890829977093243,"[0, 0, 0, 0, 0, 0, 1, 0, 1, 1]"
6257,1,1,2,0.40583506838519345,"[1, 1, 1, 0, 0, 0, 0, 1, 1, 1]"
6258,1,1,2,0.3120288027383359,"[0, 0, 1, 0, 0, 0, 0, 0, 0, 0]"
6259,1,1,2,0.1806893667812921,"[0, 0, 0, 1, 0, 0, 1, 1, 0, 1]"
6260,2,2,4,0.13933068544925808,"[0, 1, 0, 1, 0, 1, 0, 1, 1, 0]"
6261,1,1,2,0.05322168293731544,"[1, 0, 0, 0, 0, 1, 0, 0, 0, 1]"
6262,2,2,4,0.7560478125755531,"[0, 0, 1, 1, 0, 1, 1, 0, 1, 0]"
6263,3,3,6,0.6220698449514893,"[1, 1, 0, 0, 1, 1, 1, 1, 1, 1]"
6264,3,3,6,0.715841127807153,"[1, 1, 1, 1, 1, 0, 1, 1, 1, 1]"
6265,1,1,2,0.2952073044926262,"[0, 0, 0, 0, 0, 1, 0, 0, 0, 0]"
6266,2,2,4,0.3210975482926335,"[0, 0, 1, 1, 1, 0, 0, 1, 0, 0]"
6267,1,1,2,0.7639040599268367,"[0, 1, 1, 1, 1, 1, 1, 0, 0, 0]"
6268,2,2,4,0.43850213372158153,"[1, 1, 0, 0, 1, 1, 0, 0, 0, 1]"
6269,1,1,2,0.32863043575212747,"[1, 1, 0, 0, 0, 0, 1, 0, 1, 0]"
6270,1,1,2,0.4774947247827548,"[0, 0, 1, 0, 1, 0, 0, 0, 1, 0]"
6271,1,1,2,0.7234719007609124,"[1, 1, 0, 0, 0, 1, 1, 0, 0, 1]"
6272,1,1,2,0.6849311627241768,"[1, 1, 1, 0, 0, 0, 1, 1, 1, 0]"
6273,1,1,2,0.8114490742616647,"[0, 1, 0, 0, 1, 1, 0, 1, 0, 1]"
6274,1,1,2,0.5800355870950756,"[0, 1, 0, 1, 1, 1, 0, 1, 0, 0]"
6275,1,1,2,0.29533445448970896,"[1, 0, 0, 0, 0, 0, 1, 0, 1, 1]"
6276,9,9,18,0.9916598116104054,"[1, 1, 0, 0, 1, 1, 1, 0, 1, 0]"
6277,1,1,2,0.5181020552363428,"[1, 0, 0, 1, 1, 0, 0, 1, 0, 1]"
6278,1,1,2,0.5275873832717782,"[0, 1, 0, 0, 0, 1, 0, 1, 1, 0]"
6279,1,1,2,0.6902713086144187,"[1, 0, 1, 0, 0, 1, 0, 1, 0, 1]"
6280,1,1,2,0.4447882054789588,"[0, 0, 0, 0, 0, 0, 0, 1, 0, 0]"
6281,1,1,2,0.44127008258488354,"[0, 0, 0, 1, 0, 0, 0, 1, 1, 1]"
6282,3,3,6,0.1577308175009049,"[0, 1, 1, 1, 0, 1, 1, 1, 1, 1]"
6283,1,1,2,0.095129720016086,"[0, 0, 1, 0, 1, 1, 1, 0, 0, 0]"
6284,3,3,6,0.26781325253813704,"[0, 1, 0, 0, 1, 1, 0, 1, 1, 0]"
6285,2,2,4,0.6129926837596229,"[0, 0, 0, 0, 1, 0, 1, 0, 1, 1]"
6286,2,2,4,0.28776292943279924,"[1, 1, 0, 0, 0, 0, 1, 1, 1, 0]"
6287,1,1,2,0.21113905389197307,"[0, 1, 0, 1, 0, 1, 1, 1, 1, 1]"
6288,2,2,4,0.5875838354067412,"[1, 1, 1, 1, 0, 0, 1, 1, 1, 0]"
6289,2,2,4,0.1840466880296029,"[0, 0, 1, 1, 0, 0, 1, 0, 0, 0]"
6290,1,1,2,0.7486927780051936,"[0, 0, 0, 0, 0, 0, 1, 0, 0, 1]"
6291,1,1,2,0.8402753428313099,"[1, 0, 1, 0, 1, 0, 0, 0, 1, 0]"
6292,1,1,2,0.519780284254166,"[0, 1, 0, 0, 0, 0, 0, 0, 1, 1]"
6293,2,2,4,0.3336381181931878,"[0, 1, 0, 0, 1, 0, 0, 0, 0, 0]"
6294,4,4,8,0.32348781029493756,"[1, 0, 1, 0, 1, 1, 1, 0, 0, 1]"
6295,3,3,6,0.2695206552208137,"[1, 1, 1, 0, 0, 1, 1, 0, 1, 0]"
6296,2,2,4,0.05793822581578878,"[0, 1, 0, 0, 0, 0, 0, 0, 1, 1]"
6297,2,2,4,0.5863173419113256,"[0, 0, 0, 0, 0, 1, 1, 1, 0, 0]"
6298,1,1,2,0.5772117788800796,"[0, 1, 1, 1, 0, 0, 0, 0, 0, 0]"
6299,1,1,2,0.6575784614961689,"[1, 1, 1, 1, 0, 0, 0, 0, 1, 0]"
6300,3,3,6,0.7132954654760891,"[0, 1, 0, 0, 1, 0, 0, 1, 1, 1]"
6301,2,2,4,0.18961191830888646,"[0, 1, 0, 0, 1, 0, 1, 0, 0, 0]"
6302,1,1,2,0.29743452825517647,"[0, 0, 1, 0, 0, 0, 1, 1, 1, 0]"
6303,3,3,6,0.8278779034924523,"[1, 1, 0, 0, 0, 1, 1, 0, 1, 0]"
6304,1,1,2,0.5807760371756958,"[0, 0, 1, 0, 1, 0, 0, 0, 0, 1]"
6305,1,1,2,0.7322559312220094,"[1, 0, 0, 0, 0, 0, 0, 0, 0, 0]"
6306,1,1,2,0.6135233597490509,"[0, 0, 1, 0, 1, 1, 0, 1, 0, 0]"
6307,2,2,4,0.9360927240739283,"[1, 1, 1, 1, 0, 1, 0, 1, 0, 0]"
6308,2,2,4,0.17928070834833754,"[0, 0, 0, 0, 1, 0, 0, 1, 0, 0]"
6309,3,3,6,0.9761166668552793,"[1, 1, 1, 1, 1, 0, 0, 1, 0, 1]"
6310,1,1,2,0.0034876874187890206,"[0, 1, 1, 0, 0, 1, 0, 1, 1, 0]"
6311,1,1,2,0.6288853077493114,"[1, 1, 0, 0, 1, 1, 0, 0, 1, 0]"
6312,2,2,4,0.47409208317533613,"[0, 1, 1, 0, 0, 0, 0, 1, 0, 0]"
6313,3,3,6,0.6544344357544589,"[0, 1, 1, 0, 0, 1, 1, 0, 1, 1]"
6314,1,1,2,0.45977178320356793,"[0, 1, 1, 1, 0, 1, 0, 0, 1, 0]"
6315,1,1,2,0.2898579215404078,"[0, 0, 1, 0, 1, 1, 0, 0, 0, 1]"
6316,1,1,2,0.49063856860536315,"[0, 1, 0, 0, 1, 1, 1, 0, 1, 1]"
6317,1,1,2,0.041250761475328135,"[1, 1, 1, 0, 0, 1, 1, 0, 1, 0]"
6318,1,1,2,0.4150553155083745,"[0, 1, 1, 1, 1, 0, 0, 1, 1, 1]"
6319,1,1,2,0.8465620020386845,"[0, 1, 1, 1, 0, 1, 1, 0, 1, 1]"
6320,4,4,8,0.47781576537003967,"[1, 0, 1, 0, 1, 0, 0, 1, 1, 1]"
6321,2,2,4,0.20020240171064851,"[1, 1, 0, 1, 0, 1, 1, 0, 1, 0]"
6322,4,4,8,0.6876355615436209,"[0, 0, 0, 1, 1, 0, 0, 0, 1, 0]"
6323,1,1,2,0.09008011439071495,"[0, 0, 1, 1, 1, 0, 1, 0, 0, 0]"
6324,1,1,2,0.5628496826738374,"[0, 1, 0, 1, 1, 0, 1, 1, 1, 0]"
6325,5,5,10,0.8537494453471148,"[1, 1, 1, 0, 1, 1, 0, 0, 1, 0]"
6326,1,1,2,0.20230794222756499,"[0, 0, 1, 1, 1, 0, 0, 1, 0, 0]"
6327,1,1,2,0.5534371452765269,"[0, 0, 0, 0, 1, 0, 0, 0, 0, 0]"
6328,2,2,4,0.01290879936449818,"[0, 1, 0, 1, 1, 0, 0, 0, 0, 1]"
6329,1,1,2,0.41941819411949344,"[0, 1, 0, 0, 1, 1, 1, 0, 1, 0]"
6330,8,8,16,0.7609276578974794,"[1, 1, 1, 0, 1, 1, 1, 1, 1, 1]"
6331,3,3,6,0.7012208524663803,"[0, 0, 1, 0, 0, 1, 1, 1, 1, 1]"
6332,1,1,2,0.752267298669845,"[0, 0, 0, 1, 0, 1, 0, 0, 1, 0]"
6333,1,1,2,0.3026643485139502,"[0, 1, 0, 1, 0, 1, 0, 1, 1, 0]"
6334,7,7,14,0.15454720266000743,"[0, 0, 1, 1, 0, 1, 1, 1, 1, 1]"
6335,1,1,2,0.5774533686938066,"[1, 0, 0, 1, 1, 0, 1, 0, 0, 1]"
6336,2,2,4,0.467516711417278,"[1, 0, 0, 0, 1, 0, 0, 0, 1, 0]"
6337,2,2,4,0.3214767059581557,"[1, 0, 0, 1, 0, 1, 0, 1, 0, 0]"
6338,3,3,6,0.35571325242303253,"[0, 0, 1, 1, 1, 1, 1, 0, 1, 1]"
6339,2,2,4,0.008266326349462116,"[0, 0, 1, 0, 0, 1, 0, 0, 1, 0]"
6340,1,1,2,0.637259866898823,"[0, 0, 0, 0, 0, 0, 0, 0, 1, 0]"
6341,1,1,2,0.17810862315347153,"[0, 0, 0, 0, 1, 0, 0, 1, 1, 0]"
6342,1,1,2,0.709992349302999,"[1, 0, 1, 0, 1, 0, 0, 1, 1, 1]"
6343,1,1,2,0.3569860164047718,"[1, 1, 0, 1, 0, 1, 0, 1, 1, 0]"
6344,1,1,2,0.29107703064279844,"[1, 0, 0, 0, 0, 0, 0, 0, 0, 1]"
6345,2,2,4,0.5087569136455311,"[0, 1, 0, 1, 0, 1, 0, 0, 1, 1]"
6346,3,3,6,0.9192049485143694,"[0, 0, 0, 0, 0, 1, 0, 1, 1, 1]"
6347,1,1,2,0.0962402710431367,"[1, 1, 1, 0, 1, 0, 1, 1, 0, 0]"
6348,1,1,2,0.08692774347388565,"[1, 0, 0, 0, 0, 1, 1, 0, 1, 1]"
6349,2,2,4,0.6457339994638165,"[0, 1, 1, 1, 0, 1, 0, 0, 1, 0]"
6350,3,3,6,0.9059051223937153,"[0, 0, 1, 1, 0, 1, 1, 1, 1, 0]"
6351,3,3,6,0.4856259866682473,"[1, 1, 0, 1, 1, 1, 0, 0, 1, 1]"
6352,3,3,6,0.8035525793352812,"[0, 0, 1, 1, 1, 1, 0, 0, 1, 0]"
6353,2,2,4,0.6922721552034596,"[0, 0, 0, 1, 0, 1, 1, 0, 1, 1]"
6354,2,2,4,0.08446537661778841,"[0, 1, 1, 0, 0, 1, 1, 1, 0, 1]"
6355,2,2,4,0.40318573541420144,"[1, 1, 0, 1, 0, 1, 0, 1, 1, 0]"
6356,2,2,4,0.5680255929864373,"[1, 1, 0, 0, 0, 1, 1, 0, 1, 1]"
6357,1,1,2,0.03201327878589588,"[1, 0, 0, 0, 1, 0, 1, 0, 1, 1]"
6358,2,2,4,0.19118611387135231,"[1, 0, 1, 0, 0, 1, 0, 1, 1, 1]"
6359,1,1,2,0.6255441700050447,"[0, 1, 1, 0, 0, 1, 0, 1, 0, 1]"
6360,1,1,2,0.2269447411491733,"[0, 0, 1, 1, 0, 1, 1, 1, 0, 0]"
6361,1,1,2,0.12510795970015853,"[1, 0, 1, 0, 0, 0, 1, 0, 0, 1]"
6362,2,2,4,0.2196992318498946,"[0, 0, 0, 0, 1, 1, 1, 0, 0, 1]"
6363,1,1,2,0.649722653586488,"[0, 0, 1, 1, 0, 1, 1, 0, 1, 0]"
6364,1,1,2,0.8570800892997116,"[1, 0, 1, 0, 0, 1, 1, 0, 1, 1]"
6365,4,4,8,0.07920806829597826,"[0, 1, 1, 1, 0, 0, 1, 0, 1, 0]"
6366,2,2,4,0.5777282568265434,"[1, 0, 1, 1, 0, 1, 0, 0, 1, 1]"
6367,1,1,2,0.675696838876729,"[0, 1, 1, 0, 0, 0, 0, 1, 0, 1]"
6368,1,1,2,0.8789488262509146,"[1, 0, 0, 1, 0, 1, 0, 0, 1, 0]"
6369,2,2,4,0.28117726069947513,"[0, 1, 0, 0, 1, 0, 1, 1, 0, 1]"
6370,2,2,4,0.2331011642465134,"[0, 1, 1, 0, 0, 0, 1, 1, 1, 1]"
6371,5,5,10,0.21583807838400015,"[0, 1, 1, 0, 1, 1, 1, 1, 0, 0]"
6372,1,1,2,0.544039514640241,"[0, 1, 0, 0, 1, 1, 1, 0, 1, 1]"
6373,1,1,2,0.6874244100082053,"[0, 1, 0, 1, 1, 0, 1, 0, 0, 0]"
6374,1,1,2,0.9330532100992931,"[1, 1, 0, 0, 0, 0, 1, 0, 0, 1]"
6375,1,1,2,0.10960860451811172,"[0, 0, 0, 1, 1, 1, 1, 1, 1, 1]"
6376,2,2,4,0.2849509542914225,"[0, 1, 1, 0, 1, 1, 1, 0, 0, 0]"
6377,1,1,2,0.3682712854318858,"[1, 0, 1, 1, 1, 1, 0, 0, 1, 0]"
6378,1,1,2,0.36860469317998956,"[0, 1, 0, 0, 1, 0, 1, 0, 1, 1]"
6379,2,2,4,0.08287616367598583,"[1, 1, 0, 0, 0, 0, 0, 1, 1, 0]"
6380,1,1,2,0.6896367647340627,"[1, 1, 0, 0, 0, 0, 0, 0, 0, 1]"
6381,1,1,2,0.14748452098247877,"[1, 0, 1, 0, 0, 1, 0, 0, 0, 1]"
6382,1,1,2,0.7982804791207376,"[0, 0, 1, 0, 0, 1, 0, 1, 0, 0]"
6383,1,1,2,0.4120077480938126,"[1, 1, 0, 0, 0, 1, 1, 0, 1, 1]"
6384,3,3,6,0.1397344819762456,"[0, 1, 1, 1, 1, 1, 0, 1, 1, 1]"
6385,2,2,4,0.6567712948523986,"[1, 0, 1, 1, 1, 0, 0, 0, 0, 0]"
6386,2,2,4,0.3180129093327094,"[1, 0, 1, 1, 1, 0, 1, 0, 1, 0]"
6387,6,6,12,0.7356220444630314,"[1, 1, 1, 1, 1, 1, 1, 1, 1, 1]"
6388,1,1,2,0.015079915420630585,"[1, 0, 0, 0, 0, 0, 1, 1, 1, 0]"
6389,3,3,6,0.3538582111404438,"[0, 1, 1, 1, 1, 0, 0, 0, 0, 0]"
6390,1,1,2,0.16513114164545606,"[1, 0, 0, 1, 0, 1, 0, 0, 0, 0]"
6391,1,1,2,0.4501292588897615,"[1, 1, 1, 0, 0, 0, 1, 1, 1, 1]"
6392,1,1,2,0.12296443665648249,"[0, 1, 0, 0, 1, 0, 0, 1, 0, 1]"
6393,1,1,2,0.31092008367330426,"[0, 0, 1, 0, 0, 1, 0, 1, 1, 1]"
6394,1,1,2,0.9833569248784094,"[0, 0, 1, 1, 1, 0, 0, 0, 1, 1]"
6395,1,1,2,0.04822926541368944,"[1, 0, 0, 1, 0, 1, 0, 1, 0, 0]"
6396,1,1,2,0.02577835826649799,"[0, 1, 1, 1, 1, 1, 1, 1, 1, 0]"
6397,2,2,4,0.5426868806210364,"[1, 1, 0, 1, 0, 1, 1, 0, 1, 0]"
6398,1,1,2,0.06964560069211878,"[0, 1, 1, 0, 0, 1, 1, 0, 1, 0]"
6399,1,1,2,0.18131456180217165,"[0, 1, 1, 1, 0, 1, 0, 1, 0, 0]"
6400,2,2,4,0.9220033595200937,"[0, 1, 0, 1, 0, 0, 0, 0, 1, 0]"
6401,4,4,8,0.9462694233007993,"[1, 1, 0, 0, 0, 0, 1, 0, 0, 1]"
6402,2,2,4,0.33615805449238845,"[0, 1, 0, 0, 0, 0, 0, 1, 1, 1]"
6403,1,1,2,0.01924412773192863,"[0, 1, 0, 1, 1, 0, 0, 1, 1, 1]"
6404,1,1,2,0.3257743485127633,"[1, 0, 1, 0, 1, 0, 0, 0, 1, 1]"
6405,1,1,2,0.6112152023567329,"[1, 0, 0, 1, 0, 1, 0, 0, 0, 0]"
6406,1,1,2,0.16409157035133848,"[1, 0, 0, 1, 0, 0, 0, 1, 1, 1]"
6407,1,1,2,0.6406551878880713,"[1, 0, 1, 1, 1, 1, 0, 0, 0, 1]"
6408,1,1,2,0.6006423703361781,"[1, 1, 0, 1, 1, 1, 0, 1, 1, 1]"
6409,2,2,4,0.16223788659071492,"[1, 1, 0, 0, 0, 1, 1, 1, 0, 0]"
6410,1,1,2,0.8963657101801653,"[1, 0, 1, 0, 0, 0, 1, 0, 0, 1]"
6411,2,2,4,0.1262473291428543,"[0, 0, 1, 1, 0, 0, 0, 0, 1, 0]"
6412,1,1,2,0.09152304792158128,"[0, 0, 0, 1, 1, 0, 0, 1, 0, 0]"
6413,2,2,4,0.3922331645450824,"[1, 0, 0, 1, 0, 0, 1, 0, 1, 0]"
6414,2,2,4,0.7437626789221707,"[1, 1, 1, 0, 1, 1, 0, 1, 1, 0]"
6415,2,2,4,0.5741141887988093,"[1, 1, 1, 1, 1, 1, 0, 0, 1, 1]"
6416,1,1,2,0.2709382732395902,"[0, 0, 0, 0, 1, 0, 0, 1, 1, 0]"
6417,1,1,2,0.6128304442884348,"[0, 1, 1, 0, 0, 0, 1, 0, 1, 0]"
6418,2,2,4,0.8304270529810592,"[1, 1, 0, 1, 0, 0, 0, 1, 0, 1]"
6419,1,1,2,0.1515204844042145,"[1, 1, 0, 1, 1, 0, 1, 1, 1, 0]"
6420,2,2,4,0.07667530142694112,"[0, 0, 1, 1, 1, 1, 0, 1, 1, 1]"
6421,2,2,4,0.0071383030641795076,"[1, 1, 1, 1, 0, 1, 0, 0, 1, 0]"
6422,1,1,2,0.17492992606227353,"[1, 1, 0, 1, 0, 0, 0, 0, 0, 1]"
6423,1,1,2,0.4588867910388945,"[0, 0, 0, 0, 1, 1, 1, 1, 1, 1]"
6424,3,3,6,0.38445910673338224,"[0, 1, 1, 1, 0, 0, 0, 0, 1, 0]"
6425,1,1,2,0.7519458383504265,"[1, 1, 1, 1, 1, 1, 1, 1, 0, 0]"
6426,1,1,2,0.2586628537295004,"[1, 1, 0, 0, 1, 0, 0, 1, 1, 0]"
6427,3,3,6,0.12179091372054196,"[0, 1, 1, 1, 0, 1, 0, 1, 1, 1]"
6428,1,1,2,0.13371959651566034,"[0, 0, 0, 0, 0, 0, 0, 1, 1, 1]"
6429,1,1,2,0.8033590016812353,"[1, 1, 0, 0, 0, 1, 1, 0, 1, 0]"
6430,1,1,2,0.4175725084892289,"[1, 0, 1, 0, 0, 0, 1, 0, 0, 1]"
6431,1,1,2,0.09130410617705553,"[1, 0, 0, 0, 0, 0, 0, 1, 1, 1]"
6432,2,2,4,0.4799512019360701,"[0, 1, 0, 1, 0, 0, 0, 1, 1, 0]"
6433,3,3,6,0.7123213310921013,"[0, 0, 0, 0, 0, 1, 1, 1, 1, 0]"
6434,5,5,10,0.7257984527914911,"[1, 0, 0, 1, 0, 1, 1, 1, 1, 1]"
6435,1,1,2,0.9519426145633197,"[1, 0, 1, 1, 1, 0, 1, 0, 0, 0]"
6436,1,1,2,0.12121434156497157,"[0, 1, 1, 1, 1, 1, 1, 0, 0, 0]"
6437,2,2,4,0.5529932682570802,"[0, 1, 0, 0, 1, 1, 1, 0, 1, 0]"
6438,1,1,2,0.3154444832206429,"[1, 1, 1, 0, 1, 0, 0, 1, 1, 0]"
6439,3,3,6,0.01689547279935244,"[1, 0, 1, 0, 0, 0, 0, 0, 1, 1]"
6440,1,1,2,0.9084109454628563,"[1, 1, 0, 1, 0, 1, 0, 1, 0, 0]"
6441,1,1,2,0.581596419957175,"[1, 0, 1, 0, 0, 0, 0, 1, 1, 1]"
6442,1,1,2,0.20027465343013384,"[1, 1, 1, 0, 0, 0, 0, 1, 0, 0]"
6443,1,1,2,0.9550901154606266,"[1, 0, 0, 1, 0, 0, 0, 0, 0, 0]"
6444,2,2,4,0.24627505580879772,"[0, 1, 1, 0, 0, 1, 0, 1, 1, 0]"
6445,1,1,2,0.8482557825579684,"[0, 1, 1, 0, 1, 0, 0, 1, 0, 0]"
6446,3,3,6,0.31874130093638564,"[0, 0, 1, 0, 1, 0, 1, 1, 1, 0]"
6447,1,1,2,0.7260674095744389,"[1, 0, 0, 1, 1, 1, 1, 1, 1, 1]"
6448,2,2,4,0.1982177198200099,"[0, 0, 0, 1, 1, 1, 0, 1, 1, 1]"
6449,1,1,2,0.37173029716508454,"[1, 0, 0, 1, 1, 0, 0, 1, 0, 0]"
6450,3,3,6,0.885662803084446,"[1, 0, 0, 1, 1, 1, 1, 1, 0, 0]"
6451,1,1,2,0.02108721330200125,"[1, 0, 0, 0, 0, 1, 0, 0, 0, 0]"
6452,1,1,2,0.32024685513094275,"[1, 0, 1, 1, 1, 1, 1, 0, 0, 1]"
6453,5,5,10,0.30067149838333795,"[1, 0, 1, 1, 0, 1, 1, 1, 1, 0]"
6454,2,2,4,0.9324983950703711,"[0, 1, 0, 0, 0, 0, 1, 1, 0, 0]"
6455,1,1,2,0.6380243661873566,"[1, 1, 1, 0, 0, 1, 0, 0, 0, 0]"
6456,1,1,2,0.5460609581248961,"[0, 1, 0, 0, 0, 1, 1, 0, 0, 0]"
6457,1,1,2,0.9438125328485949,"[0, 1, 1, 0, 0, 0, 0, 1, 0, 0]"
6458,1,1,2,0.05672924537082702,"[1, 0, 1, 0, 1, 1, 1, 0, 0, 0]"
6459,1,1,2,0.4227443739529205,"[1, 1, 1, 1, 0, 1, 0, 1, 0, 1]"
6460,3,3,6,0.5387855770171133,"[1, 0, 1, 0, 1, 0, 1, 1, 0, 0]"
6461,1,1,2,0.03281719669922922,"[1, 1, 1, 1, 0, 1, 1, 0, 1, 0]"
6462,3,3,6,0.38722059342374837,"[0, 1, 1, 0, 0, 0, 1, 1, 0, 1]"
6463,2,2,4,0.09234170846168144,"[1, 0, 1, 0, 0, 0, 1, 0, 0, 1]"
6464,1,1,2,0.9762757824901235,"[1, 0, 0, 0, 1, 0, 1, 1, 0, 1]"
6465,1,1,2,0.4315529363871101,"[0, 1, 0, 1, 0, 0, 1, 1, 1, 1]"
6466,2,2,4,0.7755600552381816,"[1, 1, 0, 0, 0, 1, 0, 0, 1, 1]"
6467,1,1,2,0.7877886110824532,"[1, 1, 0, 1, 0, 0, 0, 0, 1, 0]"
6468,2,2,4,0.38380727480796795,"[0, 1, 1, 0, 1, 0, 0, 1, 0, 0]"
6469,1,1,2,0.5155600930963348,"[0, 1, 1, 0, 0, 1, 0, 1, 1, 1]"
6470,1,1,2,0.9205058114250204,"[0, 0, 1, 0, 0, 1, 0, 0, 0, 0]"
6471,3,3,6,0.9810867139876542,"[1, 0, 1, 0, 1, 1, 0, 1, 0, 1]"
6472,3,3,6,0.30132452774447804,"[0, 0, 1, 1, 0, 1, 0, 0, 1, 1]"
6473,1,1,2,0.33804032808548845,"[1, 1, 0, 0, 0, 0, 1, 1, 1, 1]"
6474,2,2,4,0.43592070584562914,"[0, 0, 0, 0, 1, 1, 1, 1, 1, 1]"
6475,1,1,2,0.9468249002185568,"[0, 1, 1, 0, 1, 0, 0, 0, 0, 1]"
6476,1,1,2,0.2256175034194169,"[0, 0, 0, 1, 1, 1, 1, 0, 0, 0]"
6477,3,3,6,0.2626973374507582,"[1, 1, 0, 0, 1, 0, 0, 1, 0, 0]"
6478,2,2,4,0.8519995470531323,"[1, 0, 1, 0, 1, 0, 1, 1, 1, 1]"
6479,1,1,2,0.15355005623790052,"[1, 0, 0, 0, 0, 1, 0, 0, 0, 0]"
6480,1,1,2,0.4711554094849315,"[1, 1, 1, 0, 0, 0, 1, 0, 0, 1]"
6481,2,2,4,0.03322191653931161,"[0, 1, 1, 1, 0, 0, 1, 1, 0, 0]"
6482,2,2,4,0.8992477341744873,"[0, 0, 1, 1, 0, 0, 1, 1, 1, 0]"
6483,1,1,2,0.022965420840589168,"[1, 1, 0, 0, 1, 1, 0, 1, 1, 0]"
6484,1,1,2,0.769445734343341,"[0, 0, 1, 1, 0, 1, 1, 0, 1, 0]"
6485,3,3,6,0.6545328372717254,"[0, 0, 1, 1, 0, 1, 0, 1, 0, 1]"
6486,1,1,2,0.4085279246957577,"[1, 0, 1, 1, 1, 1, 1, 1, 1, 1]"
6487,1,1,2,0.8201470746558573,"[0, 1, 0, 1, 0, 0, 0, 0, 1, 1]"
6488,1,1,2,0.595725913486746,"[0, 1, 1, 0, 1, 1, 1, 0, 1, 0]"
6489,2,2,4,0.9004026767027301,"[1, 0, 0, 0, 1, 1, 1, 1, 0, 0]"
6490,2,2,4,0.9974011023121443,"[1, 1, 1, 1, 1, 1, 0, 0, 0, 0]"
6491,2,2,4,0.916050542060247,"[0, 0, 0, 1, 0, 0, 0, 0, 1, 0]"
6492,1,1,2,0.4684528754400906,"[0, 0, 1, 0, 1, 1, 0, 0, 0, 1]"
6493,2,2,4,0.673974455095945,"[0, 0, 1, 1, 0, 1, 1, 0, 1, 0]"
6494,1,1,2,0.33622985717040177,"[1, 0, 0, 1, 1, 0, 1, 1, 0, 0]"
6495,2,2,4,0.9636434842457032,"[0, 1, 1, 1, 1, 0, 1, 1, 0, 1]"
6496,4,4,8,0.013540151482529184,"[0, 0, 1, 1, 1, 0, 1, 0, 1, 1]"
6497,1,1,2,0.269025375067512,"[0, 1, 1, 1, 0, 0, 1, 1, 0, 0]"
6498,1,1,2,0.8607297065751517,"[0, 1, 0, 0, 0, 0, 1, 0, 0, 1]"
6499,1,1,2,0.7012698332344233,"[1, 1, 1, 0, 0, 0, 0, 1, 1, 0]"
6500,1,1,2,0.7831988495871538,"[1, 1, 1, 0, 0, 0, 0, 0, 0, 1]"
6501,1,1,2,0.20374983812832392,"[0, 0, 0, 0, 0, 0, 0, 1, 1, 0]"
6502,1,1,2,0.8880206440731615,"[1, 1, 0, 1, 0, 1, 0, 0, 0, 0]"
6503,5,5,10,0.9531509594859736,"[1, 1, 1, 1, 1, 0, 1, 1, 1, 0]"
6504,2,2,4,0.3053609399806144,"[1, 1, 0, 1, 1, 1, 0, 0, 0, 0]"
6505,1,1,2,0.06933238201935366,"[1, 0, 1, 0, 0, 1, 0, 1, 0, 0]"
6506,3,3,6,0.6326420948747101,"[1, 0, 1, 1, 1, 0, 1, 1, 0, 1]"
6507,1,1,2,0.15893395158607193,"[1, 1, 1, 1, 1, 0, 0, 0, 1, 1]"
6508,1,1,2,0.20448009804473988,"[0, 1, 1, 0, 0, 0, 0, 0, 1, 0]"
6509,4,4,8,0.8907831893676774,"[0, 1, 1, 0, 1, 0, 1, 1, 1, 1]"
6510,1,1,2,0.05987162585579631,"[0, 0, 1, 1, 1, 1, 1, 1, 1, 0]"
6511,5,5,10,0.9927756322661737,"[0, 1, 0, 0, 1, 1, 1, 0, 0, 1]"
6512,1,1,2,0.1156010652258821,"[0, 0, 1, 1, 0, 1, 1, 0, 0, 0]"
6513,1,1,2,0.5148811327041004,"[0, 0, 0, 1, 1, 0, 0, 1, 1, 0]"
6514,1,1,2,0.7688483688104708,"[1, 0, 1, 1, 1, 1, 1, 1, 0, 0]"
6515,2,2,4,0.3278120067551187,"[1, 1, 0, 1, 1, 0, 1, 0, 1, 1]"
6516,1,1,2,0.9650564079525126,"[1, 1, 0, 0, 1, 0, 1, 1, 1, 1]"
6517,1,1,2,0.9107930386613194,"[1, 1, 0, 1, 1, 1, 0, 1, 1, 1]"
6518,1,1,2,0.5707596042211631,"[0, 1, 1, 1, 0, 1, 0, 0, 0, 1]"
6519,2,2,4,0.7474888150890868,"[0, 0, 0, 1, 0, 1, 0, 0, 0, 1]"
6520,2,2,4,0.396138856198449,"[0, 0, 0, 0, 0, 0, 1, 0, 1, 0]"
6521,1,1,2,0.5879122936858034,"[1, 0, 0, 0, 0, 0, 1, 1, 1, 1]"
6522,1,1,2,0.9770644524562468,"[0, 1, 0, 1, 1, 0, 0, 1, 0, 0]"
6523,4,4,8,0.4891827809381535,"[0, 0, 1, 0, 1, 0, 0, 1, 1, 1]"
6524,3,3,6,0.6626335710527267,"[1, 1, 1, 0, 0, 0, 1, 1, 0, 1]"
6525,1,1,2,0.03395318434043404,"[1, 1, 0, 0, 1, 0, 1, 0, 0, 0]"
6526,3,3,6,0.33447665718138186,"[1, 1, 0, 1, 1, 0, 1, 1, 0, 1]"
6527,1,1,2,0.6732446384324846,"[0, 1, 1, 0, 1, 0, 0, 1, 0, 1]"
6528,2,2,4,0.8383990612257345,"[0, 1, 0, 1, 1, 1, 0, 1, 0, 1]"
6529,1,1,2,0.05682592798864028,"[0, 0, 1, 1, 0, 1, 1, 1, 1, 1]"
6530,1,1,2,0.3419712539094386,"[0, 1, 1, 1, 0, 0, 1, 1, 0, 0]"
6531,2,2,4,0.16051326995503923,"[1, 0, 1, 1, 0, 1, 0, 1, 1, 0]"
6532,1,1,2,0.8774287899322321,"[0, 1, 1, 0, 1, 1, 0, 1, 0, 0]"
6533,1,1,2,0.13875002704268935,"[0, 0, 0, 0, 1, 1, 0, 1, 0, 0]"
6534,1,1,2,0.3827226050940947,"[0, 1, 0, 1, 1, 0, 0, 1, 1, 1]"
6535,1,1,2,0.4104697123521409,"[0, 0, 1, 1, 1, 0, 1, 0, 0, 1]"
6536,2,2,4,0.7214964748010915,"[1, 0, 0, 0, 0, 0, 1, 0, 1, 0]"
6537,1,1,2,0.11600734056726403,"[1, 1, 0, 0, 0, 0, 1, 1, 0, 0]"
6538,1,1,2,0.37597348630257377,"[1, 0, 0, 1, 1, 1, 0, 0, 0, 1]"
6539,1,1,2,0.7419503501211964,"[0, 1, 0, 1, 0, 0, 0, 1, 1, 0]"
6540,5,5,10,0.29399489050352823,"[1, 1, 0, 0, 1, 1, 1, 1, 1, 1]"
6541,1,1,2,0.1665126914255376,"[1, 0, 1, 0, 0, 1, 1, 1, 0, 0]"
6542,1,1,2,0.6963215230183253,"[0, 0, 0, 0, 0, 0, 1, 0, 0, 1]"
6543,1,1,2,0.33907541163425614,"[0, 0, 0, 1, 1, 0, 0, 1, 0, 1]"
6544,1,1,2,0.8099630160630893,"[1, 0, 1, 0, 1, 0, 0, 0, 0, 1]"
6545,1,1,2,0.8666792857242273,"[0, 0, 1, 1, 1, 0, 1, 1, 0, 1]"
6546,1,1,2,0.543328603392812,"[0, 0, 1, 0, 1, 1, 1, 0, 0, 0]"
6547,1,1,2,0.6601365010098035,"[1, 0, 1, 1, 1, 1, 0, 1, 1, 0]"
6548,6,6,12,0.24971520279003068,"[1, 0, 0, 1, 1, 0, 1, 1, 1, 1]"
6549,1,1,2,0.2418846980442606,"[0, 1, 1, 0, 0, 0, 1, 1, 0, 1]"
6550,1,1,2,0.5079037755295707,"[0, 0, 0, 0, 0, 0, 1, 0, 1, 0]"
6551,1,1,2,0.3735136623980265,"[0, 1, 1, 1, 1, 1, 1, 1, 1, 1]"
6552,2,2,4,0.8272559368960019,"[1, 0, 0, 0, 1, 0, 1, 0, 1, 1]"
6553,3,3,6,0.0315896610634131,"[1, 0, 0, 1, 0, 1, 1, 1, 0, 1]"
6554,2,2,4,0.3393877493264915,"[0, 0, 1, 1, 1, 0, 0, 0, 1, 0]"
6555,1,1,2,0.3114054000183294,"[1, 0, 1, 1, 1, 1, 1, 1, 1, 0]"
6556,2,2,4,0.8116037321283118,"[0, 0, 0, 0, 0, 0, 1, 0, 1, 1]"
6557,1,1,2,0.40210035155939405,"[0, 0, 0, 0, 1, 0, 0, 1, 1, 0]"
6558,1,1,2,0.9822300394192087,"[0, 1, 0, 1, 0, 0, 1, 0, 1, 1]"
6559,3,3,6,0.9113878860856175,"[1, 0, 1, 1, 1, 1, 0, 1, 0, 0]"
6560,1,1,2,0.3880277096772484,"[0, 0, 0, 0, 0, 0, 1, 1, 1, 1]"
6561,1,1,2,0.6476036113988481,"[0, 1, 0, 0, 1, 1, 1, 0, 1, 0]"
6562,1,1,2,0.49518714794091934,"[0, 0, 0, 0, 1, 0, 1, 1, 0, 1]"
6563,2,2,4,0.9333402675702325,"[1, 0, 0, 1, 1, 0, 0, 0, 0, 0]"
6564,1,1,2,0.46629425593481744,"[0, 0, 1, 1, 1, 1, 0, 0, 0, 1]"
6565,1,1,2,0.02435116025480899,"[1, 0, 0, 1, 0, 1, 0, 0, 0, 0]"
6566,1,1,2,0.9741204041336976,"[0, 0, 0, 0, 0, 1, 1, 1, 1, 0]"
6567,1,1,2,0.6345708406595372,"[1, 0, 1, 0, 1, 0, 1, 1, 0, 0]"
6568,2,2,4,0.28826300064408217,"[1, 0, 0, 0, 0, 0, 0, 0, 1, 1]"
6569,2,2,4,0.023846605165587786,"[0, 0, 0, 1, 1, 1, 0, 1, 0, 1]"
6570,1,1,2,0.7183853484823733,"[0, 0, 0, 1, 0, 1, 0, 1, 0, 1]"
6571,1,1,2,0.9707269041076051,"[1, 1, 0, 0, 0, 1, 1, 0, 0, 1]"
6572,1,1,2,0.33712802988193813,"[0, 0, 0, 0, 0, 0, 1, 0, 1, 1]"
6573,1,1,2,0.1383375230892142,"[0, 0, 1, 0, 0, 1, 1, 0, 0, 1]"
6574,2,2,4,0.7949381623695863,"[1, 1, 0, 0, 1, 0, 1, 0, 0, 0]"
6575,1,1,2,0.01778113837789097,"[0, 0, 0, 0, 1, 1, 0, 0, 0, 0]"
6576,1,1,2,0.5852825571609599,"[1, 1, 0, 0, 0, 0, 0, 0, 0, 0]"
6577,1,1,2,0.019076920743295478,"[0, 0, 0, 0, 0, 1, 0, 1, 1, 1]"
6578,8,8,16,0.5881146287180572,"[0, 1, 0, 1, 1, 0, 1, 1, 1, 1]"
6579,2,2,4,0.6268308229950224,"[0, 0, 1, 0, 0, 0, 1, 1, 1, 1]"
6580,1,1,2,0.6610259754427087,"[1, 0, 1, 0, 0, 0, 1, 0, 0, 0]"
6581,2,2,4,0.09629947425206054,"[0, 0, 0, 1, 0, 0, 0, 1, 1, 0]"
6582,1,1,2,0.2074608351582986,"[0, 0, 1, 1, 1, 1, 0, 0, 0, 0]"
6583,1,1,2,0.08458064755324435,"[1, 1, 0, 1, 1, 1, 0, 0, 1, 1]"
6584,1,1,2,0.4496419856303504,"[1, 0, 1, 1, 0, 1, 1, 1, 1, 1]"
6585,1,1,2,0.2233764856759125,"[1, 0, 1, 1, 1, 1, 0, 1, 0, 0]"
6586,1,1,2,0.9085374157492729,"[1, 0, 0, 0, 0, 1, 0, 1, 0, 0]"
6587,1,1,2,0.20383401685769298,"[1, 1, 0, 0, 1, 1, 1, 0, 0, 0]"
6588,1,1,2,0.33326559695438907,"[1, 0, 1, 0, 0, 0, 1, 0, 0, 1]"
6589,1,1,2,0.813328433642168,"[1, 0, 0, 0, 0, 0, 1, 0, 1, 1]"
6590,1,1,2,0.37220382188462886,"[0, 0, 0, 1, 0, 1, 0, 0, 1, 0]"
6591,1,1,2,0.5078897693796869,"[1, 1, 0, 0, 1, 0, 0, 1, 0, 0]"
6592,1,1,2,0.6591989080951648,"[1, 1, 0, 1, 0, 1, 1, 0, 0, 1]"
6593,1,1,2,0.4805520251385087,"[1, 0, 0, 0, 0, 0, 0, 1, 0, 0]"
6594,1,1,2,0.6715359760235929,"[0, 0, 1, 0, 1, 1, 0, 1, 0, 1]"
6595,1,1,2,0.1920568398239617,"[1, 0, 1, 0, 1, 0, 0, 0, 0, 0]"
6596,1,1,2,0.6223450194328428,"[0, 1, 0, 1, 0, 0, 0, 0, 1, 0]"
6597,1,1,2,0.11826003204524393,"[1, 0, 0, 0, 1, 0, 1, 0, 0, 1]"
6598,1,1,2,0.1965611638439657,"[0, 1, 1, 1, 1, 1, 1, 1, 0, 1]"
6599,2,2,4,0.838749072076987,"[1, 1, 0, 0, 0, 0, 1, 1, 1, 1]"
6600,1,1,2,0.09185011255199382,"[1, 1, 1, 1, 0, 1, 0, 1, 1, 0]"
6601,1,1,2,0.08077286308031728,"[1, 0, 1, 1, 0, 1, 0, 1, 0, 1]"
6602,2,2,4,0.06725584324894207,"[0, 0, 1, 1, 0, 0, 1, 0, 1, 1]"
6603,1,1,2,0.46740278247230993,"[1, 1, 1, 1, 1, 0, 1, 1, 1, 1]"
6604,2,2,4,0.5491411627582726,"[1, 1, 0, 1, 1, 0, 0, 0, 1, 1]"
6605,1,1,2,0.687428055456106,"[1, 0, 1, 1, 1, 1, 0, 1, 0, 0]"
6606,1,1,2,0.43453105615781884,"[0, 0, 0, 0, 1, 1, 0, 0, 0, 1]"
6607,1,1,2,0.3738995970491894,"[0, 0, 0, 1, 0, 0, 1, 0, 1, 0]"
6608,2,2,4,0.23753139176273275,"[0, 0, 1, 1, 1, 0, 1, 0, 0, 0]"
6609,1,1,2,0.8539062860938962,"[0, 0, 1, 1, 1, 0, 0, 1, 0, 0]"
6610,1,1,2,0.6308844289098471,"[1, 1, 0, 1, 1, 0, 0, 0, 0, 0]"
6611,1,1,2,0.32546522344993334,"[0, 1, 1, 1, 1, 1, 1, 0, 1, 1]"
6612,1,1,2,0.9232475671208933,"[0, 0, 1, 0, 0, 1, 0, 0, 0, 0]"
6613,1,1,2,0.04373311976812644,"[0, 1, 0, 1, 1, 1, 0, 1, 0, 1]"
6614,1,1,2,0.8058333579024438,"[1, 0, 0, 0, 0, 0, 0, 1, 1, 0]"
6615,2,2,4,0.5558184685459464,"[0, 0, 0, 0, 0, 0, 0, 1, 1, 0]"
6616,3,3,6,0.2691513347404373,"[1, 0, 0, 1, 1, 1, 0, 0, 0, 1]"
6617,5,5,10,0.7092437190903694,"[1, 1, 1, 0, 1, 1, 1, 1, 0, 0]"
6618,2,2,4,0.8564745010956947,"[1, 1, 0, 1, 1, 1, 1, 1, 0, 1]"
6619,1,1,2,0.6598418940136164,"[1, 0, 0, 1, 0, 0, 0, 1, 1, 1]"
6620,1,1,2,0.7114996053190172,"[0, 1, 0, 0, 0, 1, 0, 0, 0, 1]"
6621,1,1,2,0.311140401888657,"[0, 0, 0, 1, 1, 0, 0, 1, 1, 1]"
6622,1,1,2,0.3166609360525452,"[1, 0, 1, 1, 0, 0, 1, 0, 1, 0]"
6623,1,1,2,0.620383589192506,"[1, 1, 1, 1, 0, 0, 1, 1, 1, 1]"
6624,1,1,2,0.9716046755867499,"[0, 1, 1, 0, 0, 1, 0, 0, 0, 1]"
6625,1,1,2,0.3895942313103985,"[0, 0, 1, 0, 0, 1, 0, 0, 0, 1]"
6626,3,3,6,0.437084686304411,"[1, 1, 1, 0, 1, 1, 1, 1, 0, 0]"
6627,3,3,6,0.19421091851492944,"[0, 1, 0, 1, 1, 0, 1, 0, 0, 0]"
6628,1,1,2,0.7710106253079035,"[1, 1, 0, 0, 1, 1, 1, 0, 0, 1]"
6629,1,1,2,0.8348368577182097,"[0, 0, 1, 0, 1, 0, 0, 1, 0, 0]"
6630,1,1,2,0.6014626533352051,"[1, 1, 0, 0, 0, 0, 1, 0, 0, 1]"
6631,1,1,2,0.9191735405917871,"[1, 0, 0, 0, 1, 0, 0, 1, 1, 0]"
6632,2,2,4,0.7343898712204874,"[1, 0, 1, 0, 0, 0, 1, 1, 1, 0]"
6633,1,1,2,0.16331616052808695,"[0, 1, 1, 1, 1, 0, 1, 0, 1, 0]"
6634,3,3,6,0.719127185202036,"[1, 1, 0, 0, 1, 0, 0, 0, 1, 1]"
6635,1,1,2,0.8572444451095554,"[0, 1, 1, 0, 1, 0, 0, 0, 1, 0]"
6636,1,1,2,0.012632067184671802,"[0, 1, 1, 0, 0, 1, 1, 1, 0, 0]"
6637,1,1,2,0.18821082080759177,"[0, 1, 0, 0, 1, 0, 1, 1, 1, 1]"
6638,2,2,4,0.5561511701259706,"[0, 1, 0, 0, 0, 0, 0, 0, 1, 1]"
6639,1,1,2,0.10307721099044909,"[1, 0, 0, 0, 0, 1, 0, 0, 1, 1]"
6640,1,1,2,0.17304147622677424,"[0, 1, 1, 1, 1, 1, 0, 0, 0, 1]"
6641,1,1,2,0.415317014017337,"[0, 0, 1, 0, 0, 0, 0, 1, 1, 1]"
6642,2,2,4,0.4121344074447181,"[0, 0, 0, 0, 1, 1, 0, 1, 0, 0]"
6643,1,1,2,0.9833262337118837,"[0, 0, 1, 1, 1, 0, 0, 1, 1, 0]"
6644,1,1,2,0.4102759432676816,"[1, 0, 0, 1, 1, 1, 0, 0, 0, 0]"
6645,1,1,2,0.7376585207425359,"[0, 0, 1, 0, 0, 0, 1, 0, 1, 1]"
6646,2,2,4,0.5951809453515194,"[1, 0, 0, 0, 0, 1, 0, 0, 0, 1]"
6647,1,1,2,0.18350137601032335,"[0, 0, 1, 0, 1, 1, 1, 0, 1, 0]"
6648,2,2,4,0.34283621219550997,"[1, 1, 1, 1, 1, 0, 0, 1, 1, 0]"
6649,4,4,8,0.32599062086123043,"[1, 1, 0, 0, 0, 1, 0, 1, 0, 1]"
6650,1,1,2,0.31804298852590496,"[1, 0, 0, 0, 0, 0, 0, 1, 0, 1]"
6651,1,1,2,0.8840639410622815,"[1, 0, 1, 0, 1, 0, 1, 1, 1, 0]"
6652,2,2,4,0.48027302874356004,"[1, 1, 0, 0, 1, 1, 1, 0, 1, 1]"
6653,4,4,8,0.8865593031448071,"[0, 1, 1, 0, 0, 1, 1, 1, 0, 0]"
6654,1,1,2,0.5576972207214611,"[1, 0, 0, 0, 1, 1, 1, 1, 1, 1]"
6655,3,3,6,0.87075166013006,"[0, 0, 1, 1, 1, 0, 1, 1, 0, 1]"
6656,5,5,10,0.5255951964752195,"[1, 1, 0, 1, 0, 1, 1, 1, 0, 0]"
6657,2,2,4,0.666380565645482,"[1, 0, 0, 1, 1, 0, 0, 0, 1, 1]"
6658,1,1,2,0.4826895753436944,"[1, 0, 1, 0, 1, 0, 1, 1, 1, 1]"
6659,2,2,4,0.6132943060022044,"[0, 1, 1, 0, 1, 1, 1, 1, 1, 1]"
6660,1,1,2,0.42703045128260086,"[0, 0, 1, 1, 0, 0, 0, 1, 0, 1]"
6661,2,2,4,0.4144575462618766,"[1, 0, 0, 0, 1, 1, 1, 0, 0, 0]"
6662,1,1,2,0.4478308420530631,"[1, 1, 1, 1, 1, 0, 1, 1, 0, 0]"
6663,2,2,4,0.4347537755455291,"[0, 1, 0, 0, 1, 0, 0, 1, 0, 0]"
6664,2,2,4,0.4079756174645356,"[1, 0, 1, 1, 1, 0, 0, 0, 1, 0]"
6665,4,4,8,0.22122717587270646,"[1, 0, 0, 0, 1, 1, 1, 0, 0, 1]"
6666,3,3,6,0.5411935653751424,"[0, 1, 1, 0, 1, 1, 1, 0, 0, 0]"
6667,1,1,2,0.2543602464238437,"[1, 1, 1, 0, 0, 0, 0, 1, 1, 1]"
6668,3,3,6,0.870120744445227,"[1, 1, 1, 0, 1, 1, 1, 1, 1, 0]"
6669,2,2,4,0.9653506462169679,"[0, 0, 1, 0, 1, 0, 0, 0, 1, 0]"
6670,2,2,4,0.5228640444875093,"[0, 1, 1, 1, 1, 0, 0, 1, 0, 1]"
6671,9,9,18,0.8268752490311913,"[1, 0, 1, 1, 1, 1, 1, 1, 1, 0]"
6672,1,1,2,0.5083981178662278,"[1, 1, 1, 1, 1, 0, 0, 0, 1, 1]"
6673,2,2,4,0.7725665183507339,"[1, 1, 1, 1, 1, 0, 1, 1, 1, 1]"
6674,1,1,2,0.6157730843867022,"[0, 0, 0, 0, 0, 0, 1, 0, 1, 0]"
6675,2,2,4,0.3138689129272051,"[0, 0, 0, 1, 0, 1, 1, 1, 1, 0]"
6676,1,1,2,0.8447997971871058,"[1, 1, 1, 1, 0, 1, 1, 1, 0, 1]"
6677,1,1,2,0.996231825765079,"[0, 1, 0, 0, 0, 1, 1, 0, 0, 1]"
6678,1,1,2,0.3365194304527156,"[1, 0, 0, 0, 1, 0, 0, 1, 0, 0]"
6679,2,2,4,0.36611775909541144,"[0, 1, 0, 0, 1, 1, 0, 1, 1, 0]"
6680,2,2,4,0.6723379897968551,"[0, 1, 1, 0, 0, 1, 1, 0, 1, 0]"
6681,4,4,8,0.057413017184478776,"[1, 0, 1, 1, 1, 1, 0, 1, 1, 1]"
6682,1,1,2,0.6616126399274306,"[1, 0, 0, 0, 0, 1, 1, 1, 1, 1]"
6683,4,4,8,0.5986631974883652,"[1, 1, 1, 0, 0, 1, 1, 0, 1, 1]"
6684,2,2,4,0.43260014126249724,"[1, 1, 1, 1, 1, 0, 0, 1, 1, 0]"
6685,5,5,10,0.04137468584069459,"[1, 0, 1, 1, 0, 1, 0, 1, 1, 1]"
6686,3,3,6,0.21139110221989865,"[1, 1, 0, 1, 0, 0, 0, 0, 1, 1]"
6687,1,1,2,0.45215620123013966,"[0, 1, 1, 1, 0, 1, 1, 1, 1, 1]"
6688,2,2,4,0.5768719186175724,"[1, 0, 1, 0, 0, 1, 1, 0, 1, 1]"
6689,1,1,2,0.6735756462160013,"[1, 0, 1, 1, 1, 0, 0, 1, 1, 0]"
6690,2,2,4,0.1137629641391592,"[0, 1, 0, 0, 0, 0, 1, 0, 1, 0]"
6691,2,2,4,0.35116685761239863,"[0, 1, 0, 1, 1, 0, 0, 1, 0, 1]"
6692,1,1,2,0.4655591286015017,"[0, 1, 0, 0, 1, 1, 1, 0, 1, 0]"
6693,7,7,14,0.5736695090640281,"[0, 1, 1, 0, 1, 1, 1, 0, 0, 1]"
6694,1,1,2,0.2219360195809219,"[0, 1, 0, 0, 0, 0, 1, 1, 0, 1]"
6695,3,3,6,0.23075917617481845,"[1, 1, 1, 0, 1, 1, 1, 1, 0, 0]"
6696,2,2,4,0.04187084475197511,"[1, 1, 1, 0, 1, 1, 0, 0, 1, 1]"
6697,1,1,2,0.5976277603811248,"[1, 0, 1, 1, 0, 0, 1, 1, 0, 1]"
6698,1,1,2,0.6668374851007803,"[0, 1, 1, 0, 1, 1, 1, 1, 0, 0]"
6699,1,1,2,0.593178788187049,"[1, 0, 1, 1, 0, 0, 1, 0, 0, 0]"
6700,1,1,2,0.4211939609788874,"[1, 0, 0, 1, 1, 1, 0, 0, 0, 0]"
6701,1,1,2,0.31150112399433183,"[0, 0, 0, 0, 1, 1, 0, 0, 0, 1]"
6702,1,1,2,0.7839236139717026,"[1, 0, 0, 0, 0, 1, 1, 1, 0, 0]"
6703,1,1,2,0.7996381602668392,"[1, 0, 1, 1, 0, 0, 0, 1, 1, 1]"
6704,2,2,4,0.9550403712992247,"[1, 1, 0, 0, 0, 1, 0, 0, 1, 0]"
6705,1,1,2,0.589684330601827,"[0, 0, 0, 0, 0, 0, 1, 1, 0, 0]"
6706,3,3,6,0.9504542921528293,"[0, 0, 1, 1, 1, 1, 1, 1, 1, 0]"
6707,5,5,10,0.8164372865344033,"[1, 1, 0, 1, 1, 0, 0, 0, 0, 1]"
6708,1,1,2,0.21434530778031546,"[0, 1, 0, 0, 1, 1, 1, 0, 1, 1]"
6709,1,1,2,0.9338027476260039,"[1, 0, 1, 0, 0, 0, 1, 1, 1, 0]"
6710,1,1,2,0.4889414935131926,"[0, 0, 0, 1, 1, 0, 1, 1, 1, 1]"
6711,2,2,4,0.20309288825530392,"[1, 1, 0, 1, 1, 0, 1, 1, 1, 1]"
6712,1,1,2,0.2544884582473639,"[1, 0, 0, 0, 0, 1, 0, 0, 1, 1]"
6713,1,1,2,0.6343893825396247,"[0, 1, 1, 1, 0, 1, 1, 0, 1, 0]"
6714,1,1,2,0.7732551674785492,"[1, 1, 1, 0, 1, 0, 1, 0, 1, 1]"
6715,3,3,6,0.6754822769621105,"[1, 0, 0, 0, 1, 0, 0, 0, 1, 0]"
6716,1,1,2,0.10907500169906381,"[1, 0, 0, 1, 0, 1, 0, 0, 0, 1]"
6717,2,2,4,0.44636486150935495,"[0, 0, 0, 0, 0, 0, 1, 0, 0, 0]"
6718,2,2,4,0.7653865182550841,"[0, 0, 1, 1, 1, 0, 1, 0, 1, 1]"
6719,2,2,4,0.8286583700457834,"[0, 1, 0, 0, 0, 0, 0, 0, 1, 0]"
6720,1,1,2,0.181290111214907,"[0, 1, 1, 1, 1, 0, 0, 1, 0, 0]"
6721,1,1,2,0.6882169105386796,"[1, 1, 1, 1, 0, 1, 1, 1, 1, 0]"
6722,1,1,2,0.5736075570589968,"[0, 1, 1, 1, 1, 0, 1, 1, 0, 0]"
6723,1,1,2,0.8886619447326816,"[1, 0, 1, 0, 1, 1, 1, 0, 0, 1]"
6724,3,3,6,0.949990332881636,"[0, 1, 0, 0, 1, 1, 1, 0, 1, 0]"
6725,1,1,2,0.2908304119468136,"[1, 0, 1, 1, 0, 0, 1, 1, 1, 0]"
6726,1,1,2,0.07128703534560177,"[1, 1, 1, 1, 0, 0, 1, 0, 0, 0]"
6727,2,2,4,0.29020705813880054,"[0, 1, 0, 0, 1, 1, 1, 0, 1, 0]"
6728,1,1,2,0.21204868965307444,"[0, 1, 1, 1, 1, 1, 0, 0, 0, 1]"
6729,1,1,2,0.6401079948410755,"[1, 1, 1, 0, 1, 0, 0, 1, 0, 1]"
6730,2,2,4,0.10107943641171879,"[0, 1, 1, 1, 0, 1, 1, 1, 1, 1]"
6731,2,2,4,0.9740796646877663,"[1, 0, 1, 1, 0, 1, 1, 1, 0, 1]"
6732,1,1,2,0.06964083942787869,"[0, 0, 1, 1, 1, 0, 1, 0, 1, 0]"
6733,1,1,2,0.3316933121368858,"[1, 1, 0, 1, 0, 0, 1, 1, 0, 0]"
6734,1,1,2,0.7566084323662998,"[0, 1, 1, 0, 1, 0, 1, 1, 0, 0]"
6735,1,1,2,0.8504918907419754,"[0, 0, 0, 0, 0, 0, 0, 1, 0, 0]"
6736,1,1,2,0.0977473427127522,"[1, 0, 0, 1, 1, 1, 0, 1, 1, 1]"
6737,2,2,4,0.635125112002161,"[1, 1, 1, 1, 0, 1, 0, 0, 0, 1]"
6738,2,2,4,0.5486089205238333,"[0, 1, 1, 1, 1, 1, 1, 0, 1, 0]"
6739,1,1,2,0.8513934086624961,"[0, 0, 0, 1, 0, 1, 0, 1, 0, 0]"
6740,2,2,4,0.5271318215045692,"[0, 0, 0, 1, 1, 0, 1, 1, 1, 1]"
6741,2,2,4,0.3959357258613829,"[0, 0, 1, 0, 0, 1, 0, 0, 0, 1]"
6742,1,1,2,0.8922299412716561,"[0, 1, 0, 0, 0, 1, 0, 0, 1, 1]"
6743,3,3,6,0.3430262532941889,"[1, 0, 1, 0, 1, 0, 1, 1, 1, 0]"
6744,2,2,4,0.21505262610821674,"[1, 0, 0, 1, 0, 0, 0, 1, 1, 1]"
6745,3,3,6,0.8025800920169532,"[0, 1, 1, 1, 0, 0, 1, 0, 1, 1]"
6746,2,2,4,0.743848225767199,"[0, 1, 0, 1, 1, 0, 1, 0, 0, 0]"
6747,2,2,4,0.4558082848665498,"[1, 1, 0, 0, 1, 1, 1, 0, 0, 0]"
6748,1,1,2,0.8349132680656163,"[0, 0, 1, 1, 1, 0, 0, 0, 0, 1]"
6749,2,2,4,0.8245855387408081,"[1, 1, 1, 1, 0, 0, 0, 1, 1, 1]"
6750,2,2,4,0.4537238021162556,"[1, 0, 1, 1, 0, 0, 0, 1, 0, 1]"
6751,2,2,4,0.8778793079155944,"[0, 0, 1, 0, 0, 1, 1, 1, 0, 0]"
6752,4,4,8,0.984961736318246,"[1, 1, 1, 0, 1, 1, 1, 1, 0, 1]"
6753,2,2,4,0.5673300159769439,"[0, 0, 1, 1, 1, 0, 0, 1, 1, 1]"
6754,1,1,2,0.013639509399132055,"[1, 1, 0, 1, 0, 0, 0, 1, 1, 1]"
6755,2,2,4,0.7584035683618208,"[1, 0, 1, 1, 0, 1, 1, 1, 0, 0]"
6756,1,1,2,0.1028919751461701,"[1, 0, 1, 1, 1, 0, 1, 1, 0, 1]"
6757,3,3,6,0.35027243804553276,"[0, 1, 0, 1, 1, 0, 0, 1, 1, 1]"
6758,1,1,2,0.8242040751647695,"[0, 1, 0, 0, 0, 0, 1, 0, 1, 0]"
6759,1,1,2,0.01598198150919028,"[0, 0, 1, 0, 0, 1, 0, 1, 1, 0]"
6760,1,1,2,0.22035683302498732,"[1, 0, 1, 0, 1, 0, 1, 1, 0, 0]"
6761,1,1,2,0.8746775953403515,"[1, 0, 0, 0, 0, 0, 0, 0, 1, 0]"
6762,1,1,2,0.5992556626798505,"[0, 0, 1, 1, 0, 1, 0, 0, 1, 0]"
6763,1,1,2,0.48690927512215165,"[1, 1, 0, 0, 1, 0, 0, 0, 0, 0]"
6764,1,1,2,0.4429280624937878,"[0, 0, 1, 1, 1, 0, 0, 1, 1, 1]"
6765,1,1,2,0.9803139151514852,"[0, 1, 0, 0, 1, 1, 0, 1, 0, 0]"
6766,2,2,4,0.11602342716673752,"[1, 0, 0, 0, 0, 0, 0, 1, 1, 1]"
6767,1,1,2,0.32062362205551886,"[1, 0, 1, 1, 1, 0, 1, 1, 0, 1]"
6768,1,1,2,0.25972980476141816,"[1, 0, 1, 1, 0, 1, 0, 0, 1, 1]"
6769,1,1,2,0.9332645504230737,"[1, 0, 1, 0, 1, 1, 0, 1, 0, 1]"
6770,1,1,2,0.8905112261411662,"[0, 0, 1, 0, 1, 0, 1, 0, 0, 0]"
6771,1,1,2,0.6397302564587163,"[1, 0, 1, 1, 1, 0, 0, 0, 0, 1]"
6772,1,1,2,0.6009966001639058,"[1, 0, 0, 1, 1, 1, 1, 1, 0, 0]"
6773,1,1,2,0.36417394162540995,"[0, 1, 1, 0, 1, 1, 0, 0, 0, 0]"
6774,1,1,2,0.28404617378947117,"[1, 0, 1, 1, 0, 1, 0, 1, 1, 0]"
6775,1,1,2,0.3729914019920363,"[0, 0, 1, 0, 0, 1, 1, 1, 1, 1]"
6776,4,4,8,0.9472224623974008,"[1, 0, 0, 0, 1, 0, 1, 1, 1, 1]"
6777,1,1,2,0.9806650160538252,"[1, 0, 0, 1, 1, 1, 0, 0, 0, 1]"
6778,1,1,2,0.8215185260264155,"[0, 0, 0, 1, 0, 1, 0, 1, 1, 1]"
6779,2,2,4,0.5419591674062724,"[0, 0, 1, 0, 1, 0, 0, 1, 0, 0]"
6780,1,1,2,0.9642521967441379,"[1, 0, 0, 1, 0, 0, 0, 0, 1, 1]"
6781,2,2,4,0.5815723609639031,"[1, 1, 0, 0, 1, 1, 0, 1, 1, 0]"
6782,1,1,2,0.2491105875652997,"[1, 1, 1, 1, 0, 0, 0, 0, 0, 0]"
6783,3,3,6,0.3351708420075542,"[0, 1, 1, 0, 1, 1, 1, 1, 1, 1]"
6784,3,3,6,0.7486951286761125,"[1, 1, 0, 1, 1, 0, 0, 1, 1, 0]"
6785,1,1,2,0.05217473424294705,"[1, 0, 0, 0, 0, 0, 0, 0, 0, 0]"
6786,1,1,2,0.47790141514146056,"[0, 0, 0, 0, 1, 1, 0, 0, 0, 1]"
6787,1,1,2,0.22738636325022965,"[1, 0, 1, 0, 1, 0, 1, 0, 0, 1]"
6788,2,2,4,0.18562917143655844,"[1, 1, 1, 0, 0, 0, 1, 1, 1, 0]"
6789,1,1,2,0.5377487779630572,"[1, 0, 0, 0, 0, 0, 1, 1, 1, 1]"
6790,4,4,8,0.016321520437271975,"[1, 0, 1, 1, 0, 1, 1, 1, 1, 1]"
6791,1,1,2,0.541043987803967,"[0, 0, 0, 1, 0, 1, 1, 1, 0, 1]"
6792,1,1,2,0.8095703978349055,"[1, 0, 1, 0, 0, 0, 0, 1, 0, 0]"
6793,1,1,2,0.40697589924758926,"[1, 1, 1, 1, 1, 1, 1, 1, 1, 1]"
6794,1,1,2,0.10797473429196092,"[0, 0, 0, 1, 1, 0, 0, 1, 1, 0]"
6795,1,1,2,0.9190020756494083,"[0, 0, 1, 0, 0, 0, 0, 0, 0, 0]"
6796,1,1,2,0.7030608748613982,"[0, 0, 1, 0, 0, 0, 1, 1, 1, 0]"
6797,2,2,4,0.2867536384604682,"[1, 1, 0, 0, 0, 0, 0, 0, 0, 0]"
6798,3,3,6,0.9400215119801848,"[1, 0, 0, 0, 1, 1, 1, 1, 0, 0]"
6799,1,1,2,0.4080718153441606,"[0, 0, 0, 0, 1, 1, 1, 0, 1, 1]"
6800,2,2,4,0.14003878784905854,"[0, 1, 1, 0, 1, 1, 0, 1, 1, 0]"
6801,8,8,16,0.829027397397525,"[1, 1, 1, 0, 1, 0, 1, 0, 1, 1]"
6802,1,1,2,0.9270734414453682,"[1, 0, 0, 0, 1, 0, 0, 0, 0, 0]"
6803,2,2,4,0.29543257326401917,"[0, 0, 1, 0, 1, 1, 1, 0, 1, 1]"
6804,1,1,2,0.640846306781454,"[0, 0, 0, 0, 1, 1, 0, 0, 1, 0]"
6805,2,2,4,0.29459723235937585,"[0, 1, 1, 0, 1, 1, 1, 1, 1, 0]"
6806,3,3,6,0.5467288853301304,"[0, 1, 0, 0, 0, 0, 1, 0, 1, 1]"
6807,1,1,2,0.14684140178755534,"[1, 0, 1, 1, 1, 1, 0, 0, 1, 0]"
6808,4,4,8,0.014648996283616711,"[0, 1, 1, 0, 0, 1, 1, 0, 0, 1]"
6809,5,5,10,0.1837924670575658,"[1, 0, 0, 1, 1, 1, 1, 1, 1, 0]"
6810,1,1,2,0.2924563972316909,"[1, 1, 1, 0, 0, 1, 0, 0, 1, 1]"
6811,1,1,2,0.476120322701879,"[0, 1, 0, 1, 1, 1, 1, 1, 0, 0]"
6812,2,2,4,0.6199044561431958,"[0, 0, 1, 0, 1, 0, 1, 0, 0, 0]"
6813,1,1,2,0.6315558965581997,"[0, 1, 1, 1, 1, 1, 0, 0, 0, 1]"
6814,1,1,2,0.9562290391607102,"[1, 1, 0, 1, 1, 0, 0, 1, 0, 1]"
6815,1,1,2,0.34168825004380765,"[1, 0, 0, 1, 1, 0, 0, 1, 1, 1]"
6816,5,5,10,0.2657693203149223,"[1, 1, 1, 1, 1, 0, 0, 1, 1, 0]"
6817,1,1,2,0.8012109137656702,"[0, 0, 1, 0, 1, 0, 0, 0, 1, 1]"
6818,1,1,2,0.4469557024262938,"[1, 0, 0, 0, 0, 1, 0, 1, 1, 0]"
6819,1,1,2,0.8376644874653988,"[1, 1, 0, 1, 1, 1, 1, 1, 1, 0]"
6820,2,2,4,0.9603455813977931,"[1, 0, 1, 0, 1, 1, 1, 1, 0, 0]"
6821,3,3,6,0.55349804168097,"[0, 1, 0, 0, 0, 1, 0, 1, 1, 1]"
6822,2,2,4,0.7926612668690206,"[0, 0, 1, 0, 1, 0, 1, 0, 0, 1]"
6823,2,2,4,0.45396043588906854,"[0, 0, 0, 1, 0, 0, 1, 1, 0, 1]"
6824,1,1,2,0.3811797644796542,"[1, 0, 1, 1, 0, 1, 1, 0, 0, 1]"
6825,3,3,6,0.3469894187411877,"[0, 0, 1, 1, 0, 1, 1, 0, 0, 0]"
6826,2,2,4,0.4874072105727909,"[0, 0, 1, 0, 0, 0, 1, 1, 1, 0]"
6827,1,1,2,0.720925304885322,"[1, 1, 1, 0, 0, 1, 1, 1, 0, 1]"
6828,5,5,10,0.09516404620014607,"[1, 0, 0, 0, 1, 1, 0, 0, 0, 1]"
6829,1,1,2,0.48241000552331736,"[0, 1, 0, 0, 1, 1, 0, 0, 0, 1]"
6830,1,1,2,0.06889186311676176,"[0, 0, 0, 0, 0, 0, 0, 0, 1, 0]"
6831,1,1,2,0.3587146810783691,"[1, 0, 1, 1, 0, 1, 0, 1, 0, 1]"
6832,1,1,2,0.5202831528874142,"[0, 0, 0, 0, 0, 1, 1, 1, 0, 0]"
6833,2,2,4,0.15586935095903465,"[0, 1, 0, 0, 1, 1, 0, 1, 1, 1]"
6834,1,1,2,0.6974752026904592,"[0, 1, 0, 1, 0, 1, 0, 0, 0, 0]"
6835,1,1,2,0.4572941693963881,"[0, 0, 1, 1, 0, 0, 0, 1, 1, 1]"
6836,4,4,8,0.23523500152478338,"[1, 0, 0, 0, 0, 1, 1, 1, 1, 1]"
6837,2,2,4,0.8403338007134613,"[1, 0, 0, 0, 0, 0, 1, 0, 1, 0]"
6838,1,1,2,0.19937287969709283,"[1, 1, 0, 0, 0, 1, 1, 0, 0, 1]"
6839,1,1,2,0.09811274226428612,"[0, 1, 1, 1, 0, 0, 0, 1, 0, 0]"
6840,1,1,2,0.44354581373463875,"[0, 1, 1, 1, 1, 1, 0, 0, 0, 0]"
6841,2,2,4,0.1509968279359234,"[0, 0, 0, 0, 0, 1, 0, 1, 1, 0]"
6842,2,2,4,0.7589395099422683,"[1, 0, 0, 0, 0, 1, 0, 0, 1, 1]"
6843,1,1,2,0.3706651934175649,"[1, 1, 1, 0, 0, 1, 1, 1, 0, 0]"
6844,2,2,4,0.7854360973641626,"[1, 1, 1, 1, 1, 1, 1, 0, 0, 1]"
6845,1,1,2,0.6952211245319149,"[1, 0, 0, 0, 0, 0, 0, 1, 1, 1]"
6846,1,1,2,0.5301475742204799,"[0, 0, 1, 0, 0, 1, 0, 0, 1, 0]"
6847,2,2,4,0.4825022791821212,"[0, 1, 1, 1, 0, 1, 0, 0, 0, 1]"
6848,2,2,4,0.564953221950089,"[1, 1, 0, 1, 1, 1, 0, 0, 1, 1]"
6849,1,1,2,0.6296359921083308,"[1, 1, 1, 0, 1, 1, 1, 1, 1, 1]"
6850,1,1,2,0.7561373778932158,"[0, 0, 0, 0, 0, 1, 0, 1, 0, 1]"
6851,1,1,2,0.4026563489341328,"[0, 0, 1, 0, 0, 1, 0, 1, 0, 1]"
6852,1,1,2,0.46128608836377805,"[0, 1, 0, 1, 1, 0, 0, 0, 1, 1]"
6853,1,1,2,0.8269088232770336,"[1, 1, 0, 1, 1, 1, 1, 0, 0, 1]"
6854,1,1,2,0.9014010014523691,"[0, 0, 0, 1, 1, 0, 1, 0, 0, 0]"
6855,1,1,2,0.6243778612311158,"[1, 0, 0, 0, 0, 0, 1, 0, 0, 0]"
6856,4,4,8,0.45746585381556326,"[1, 1, 1, 0, 0, 0, 1, 1, 1, 0]"
6857,2,2,4,0.12031844709777573,"[0, 0, 0, 1, 1, 1, 0, 1, 1, 0]"
6858,1,1,2,0.08548958360917602,"[1, 1, 0, 1, 1, 1, 0, 1, 0, 0]"
6859,3,3,6,0.29768268211877114,"[1, 1, 0, 1, 0, 1, 0, 0, 0, 1]"
6860,1,1,2,0.6298370370870638,"[1, 0, 0, 0, 1, 1, 1, 0, 0, 0]"
6861,2,2,4,0.9588588397382464,"[0, 1, 0, 0, 1, 0, 1, 1, 1, 1]"
6862,1,1,2,0.7362129591538903,"[0, 0, 1, 1, 0, 1, 1, 0, 0, 0]"
6863,1,1,2,0.09557807516154515,"[1, 1, 0, 0, 0, 1, 0, 0, 1, 1]"
6864,1,1,2,0.02608325091423458,"[0, 1, 1, 1, 0, 0, 1, 0, 0, 1]"
6865,1,1,2,0.9134907165782274,"[0, 1, 0, 0, 1, 0, 0, 1, 0, 1]"
6866,1,1,2,0.32504529708450036,"[0, 1, 0, 1, 1, 1, 1, 1, 1, 0]"
6867,1,1,2,0.43500673652936606,"[0, 0, 0, 0, 1, 1, 0, 1, 0, 1]"
6868,1,1,2,0.2586737043544587,"[0, 0, 1, 0, 1, 0, 1, 0, 0, 0]"
6869,4,4,8,0.4344928111642503,"[1, 0, 1, 1, 0, 1, 0, 1, 1, 0]"
6870,3,3,6,0.7393725745321557,"[1, 1, 0, 1, 0, 1, 1, 1, 1, 1]"
6871,1,1,2,0.39241648360384296,"[0, 0, 1, 1, 0, 1, 0, 1, 1, 1]"
6872,3,3,6,0.22958673874705715,"[0, 1, 1, 1, 1, 1, 0, 1, 0, 1]"
6873,2,2,4,0.21371541955108087,"[0, 1, 0, 0, 1, 1, 0, 0, 1, 0]"
6874,2,2,4,0.4349548171023129,"[1, 1, 1, 1, 1, 0, 1, 0, 0, 1]"
6875,1,1,2,0.8245265170622285,"[1, 1, 1, 1, 1, 1, 1, 1, 0, 0]"
6876,1,1,2,0.6845683864964006,"[1, 0, 0, 0, 0, 0, 0, 1, 0, 0]"
6877,3,3,6,0.34004665996230277,"[0, 1, 0, 1, 1, 1, 1, 0, 1, 0]"
6878,4,4,8,0.19026419728755262,"[1, 1, 0, 1, 0, 0, 0, 0, 0, 0]"
6879,2,2,4,0.41843520133922696,"[0, 0, 0, 1, 1, 0, 0, 1, 1, 0]"
6880,2,2,4,0.2726295494872416,"[0, 0, 1, 0, 1, 1, 0, 1, 0, 0]"
6881,1,1,2,0.9672569450050407,"[1, 1, 1, 0, 1, 1, 1, 0, 0, 1]"
6882,1,1,2,0.3627184410725396,"[0, 0, 0, 0, 0, 0, 0, 0, 0, 0]"
6883,2,2,4,0.9454090981168362,"[1, 1, 1, 0, 1, 0, 0, 1, 1, 1]"
6884,3,3,6,0.20154134464397278,"[1, 0, 0, 0, 1, 1, 1, 1, 0, 1]"
6885,1,1,2,0.2486402585646882,"[1, 0, 0, 1, 1, 1, 0, 1, 1, 1]"
6886,1,1,2,0.6277223465163136,"[0, 1, 0, 0, 0, 0, 0, 0, 1, 1]"
6887,1,1,2,0.7436567267186962,"[1, 0, 0, 0, 0, 1, 1, 0, 1, 1]"
6888,1,1,2,0.26105449919653456,"[0, 0, 1, 1, 0, 1, 1, 1, 1, 0]"
6889,1,1,2,0.21775433004431566,"[1, 1, 1, 0, 0, 0, 0, 1, 1, 1]"
6890,1,1,2,0.9040837580628338,"[0, 1, 0, 1, 0, 0, 0, 0, 0, 0]"
6891,3,3,6,0.12252789735139724,"[1, 1, 0, 0, 1, 0, 0, 1, 0, 1]"
6892,1,1,2,0.09564451453785572,"[0, 1, 0, 0, 0, 0, 0, 0, 0, 0]"
6893,1,1,2,0.06505486970982666,"[0, 0, 1, 1, 1, 0, 0, 0, 0, 0]"
6894,3,3,6,0.05646946195566027,"[0, 1, 1, 1, 1, 0, 1, 0, 1, 1]"
6895,1,1,2,0.8385089090635128,"[1, 0, 0, 1, 1, 1, 0, 0, 0, 0]"
6896,7,7,14,0.4538825155400773,"[1, 1, 1, 1, 1, 0, 0, 1, 1, 1]"
6897,2,2,4,0.20732796128567088,"[0, 1, 1, 0, 0, 1, 0, 0, 1, 1]"
6898,2,2,4,0.566475684274448,"[1, 1, 0, 1, 1, 1, 1, 0, 0, 0]"
6899,1,1,2,0.9288053731069584,"[0, 1, 0, 0, 0, 1, 0, 1, 1, 1]"
6900,1,1,2,0.33972177243240775,"[0, 0, 1, 1, 0, 0, 0, 0, 1, 1]"
6901,2,2,4,0.8140664637973833,"[0, 1, 0, 0, 1, 1, 1, 1, 1, 1]"
6902,1,1,2,0.026645866520737638,"[0, 1, 0, 1, 1, 0, 0, 1, 0, 1]"
6903,1,1,2,0.11345084822391238,"[0, 1, 0, 0, 1, 1, 0, 0, 0, 0]"
6904,2,2,4,0.42757100475366383,"[0, 0, 1, 0, 0, 1, 1, 1, 1, 1]"
6905,2,2,4,0.39788267865416915,"[0, 1, 0, 0, 1, 1, 1, 1, 1, 0]"
6906,1,1,2,0.562045400633485,"[1, 0, 1, 1, 1, 1, 1, 1, 1, 0]"
6907,7,7,14,0.8037747924909625,"[1, 1, 0, 0, 1, 1, 1, 0, 1, 1]"
6908,2,2,4,0.3196812187982495,"[1, 0, 1, 1, 0, 1, 0, 1, 0, 1]"
6909,2,2,4,0.3762685871811994,"[0, 0, 1, 0, 1, 1, 1, 1, 1, 1]"
6910,2,2,4,0.05474469599404286,"[0, 0, 1, 1, 0, 0, 0, 0, 1, 1]"
6911,2,2,4,0.871137298293904,"[0, 1, 1, 1, 0, 0, 0, 1, 0, 1]"
6912,1,1,2,0.5509752677549903,"[0, 0, 1, 1, 0, 0, 0, 0, 0, 0]"
6913,1,1,2,0.2142100500349432,"[0, 0, 1, 0, 0, 0, 0, 1, 0, 1]"
6914,1,1,2,0.9700851657134116,"[1, 0, 0, 1, 1, 0, 1, 1, 1, 0]"
6915,1,1,2,0.40950765294901703,"[1, 0, 0, 0, 0, 1, 0, 0, 0, 1]"
6916,1,1,2,0.3974931600184355,"[0, 1, 1, 1, 0, 0, 1, 0, 0, 1]"
6917,1,1,2,0.8568087976535498,"[1, 1, 1, 1, 1, 0, 1, 0, 0, 0]"
6918,2,2,4,0.3551741881806727,"[0, 1, 1, 0, 0, 1, 1, 1, 0, 1]"
6919,1,1,2,0.7105181451889737,"[0, 1, 0, 1, 0, 1, 1, 1, 1, 0]"
6920,2,2,4,0.6156627301968196,"[1, 0, 0, 0, 1, 1, 0, 0, 1, 0]"
6921,2,2,4,0.5570210556856551,"[0, 0, 1, 0, 1, 0, 0, 1, 1, 1]"
6922,1,1,2,0.8902613547189211,"[0, 0, 0, 0, 0, 1, 0, 1, 0, 1]"
6923,2,2,4,0.2659551139602677,"[0, 1, 0, 0, 1, 1, 0, 0, 1, 1]"
6924,1,1,2,0.15696400968585988,"[1, 0, 0, 0, 0, 0, 0, 0, 0, 1]"
6925,2,2,4,0.5096078931398519,"[0, 0, 1, 1, 0, 1, 1, 0, 0, 0]"
6926,1,1,2,0.5161415539032567,"[1, 1, 0, 0, 0, 0, 0, 1, 1, 1]"
6927,2,2,4,0.8769653361921868,"[0, 0, 1, 1, 0, 1, 0, 1, 0, 1]"
6928,1,1,2,0.5130124790581078,"[1, 0, 1, 1, 1, 1, 1, 1, 0, 1]"
6929,4,4,8,0.017676550168649552,"[1, 0, 1, 1, 1, 1, 1, 1, 1, 1]"
6930,1,1,2,0.14910531024789975,"[1, 0, 1, 0, 0, 0, 1, 0, 0, 1]"
6931,2,2,4,0.1577452716137091,"[1, 0, 1, 1, 0, 1, 1, 0, 0, 0]"
6932,1,1,2,0.6643517576462452,"[0, 0, 1, 1, 0, 0, 0, 0, 0, 1]"
6933,2,2,4,0.17935471760857602,"[0, 0, 0, 0, 0, 0, 0, 0, 0, 1]"
6934,2,2,4,0.8613674853592019,"[0, 0, 0, 1, 0, 0, 1, 1, 1, 1]"
6935,3,3,6,0.9538051349702785,"[0, 1, 1, 1, 1, 0, 0, 1, 0, 1]"
6936,2,2,4,0.48322855856291524,"[1, 0, 0, 0, 1, 0, 1, 1, 1, 1]"
6937,1,1,2,0.8872464672725869,"[0, 1, 0, 1, 0, 1, 1, 1, 0, 0]"
6938,5,5,10,0.7796576130745161,"[1, 0, 0, 0, 1, 1, 1, 0, 0, 1]"
6939,3,3,6,0.5960368644668349,"[1, 0, 0, 1, 0, 0, 0, 1, 0, 1]"
6940,1,1,2,0.8146631860694303,"[0, 0, 1, 1, 1, 0, 1, 0, 1, 0]"
6941,1,1,2,0.9143618827238529,"[1, 1, 1, 1, 0, 1, 0, 1, 0, 1]"
6942,2,2,4,0.7195733906042618,"[1, 1, 0, 1, 1, 0, 0, 0, 1, 1]"
6943,2,2,4,0.8841093312330733,"[1, 1, 1, 0, 1, 0, 1, 0, 1, 0]"
6944,1,1,2,0.023364002395781625,"[0, 0, 0, 1, 1, 0, 1, 1, 1, 1]"
6945,1,1,2,0.3516618150170232,"[1, 0, 1, 0, 0, 0, 1, 0, 0, 0]"
6946,2,2,4,0.2582017565694821,"[0, 0, 1, 1, 1, 1, 0, 0, 0, 1]"
6947,1,1,2,0.06145853533643142,"[0, 1, 1, 1, 0, 1, 0, 1, 0, 1]"
6948,2,2,4,0.6521972861943385,"[0, 0, 1, 1, 1, 1, 1, 1, 0, 1]"
6949,2,2,4,0.05980320940159756,"[1, 0, 0, 1, 0, 1, 1, 1, 1, 1]"
6950,1,1,2,0.2885671419947672,"[0, 0, 0, 1, 0, 0, 1, 1, 1, 0]"
6951,3,3,6,0.22860926493412148,"[1, 1, 1, 0, 1, 1, 0, 0, 1, 1]"
6952,2,2,4,0.42926628070825545,"[0, 0, 0, 0, 1, 0, 0, 1, 1, 1]"
6953,3,3,6,0.87802424372124,"[1, 0, 0, 0, 1, 1, 1, 1, 1, 1]"
6954,1,1,2,0.908645798159141,"[0, 0, 0, 0, 0, 0, 1, 0, 0, 0]"
6955,1,1,2,0.3010533635528164,"[1, 1, 1, 0, 1, 0, 0, 1, 0, 0]"
6956,1,1,2,0.07854139588468123,"[0, 1, 1, 0, 0, 1, 1, 0, 0, 0]"
6957,1,1,2,0.6879028125391115,"[1, 1, 0, 0, 1, 1, 0, 1, 1, 1]"
6958,1,1,2,0.43081855092062793,"[0, 0, 0, 0, 0, 0, 0, 0, 1, 0]"
6959,2,2,4,0.060361878640269206,"[0, 0, 0, 1, 1, 1, 0, 1, 1, 0]"
6960,1,1,2,0.07328923135566578,"[1, 0, 1, 0, 0, 0, 0, 1, 1, 1]"
6961,2,2,4,0.6625999198598483,"[1, 0, 1, 0, 1, 1, 1, 0, 0, 1]"
6962,3,3,6,0.2190800323645472,"[0, 1, 0, 0, 1, 1, 0, 1, 1, 1]"
6963,1,1,2,0.5026053995277551,"[1, 0, 0, 1, 1, 0, 1, 0, 0, 0]"
6964,1,1,2,0.17681432423556898,"[1, 0, 0, 1, 1, 1, 0, 1, 1, 1]"
6965,1,1,2,0.08537932785210789,"[0, 0, 1, 1, 1, 1, 1, 0, 0, 0]"
6966,1,1,2,0.8019029645293865,"[1, 1, 1, 1, 1, 1, 0, 1, 1, 1]"
6967,2,2,4,0.5165397287809442,"[0, 0, 0, 1, 1, 0, 1, 0, 1, 1]"
6968,1,1,2,0.5216050256384087,"[0, 0, 0, 0, 0, 0, 1, 1, 0, 1]"
6969,3,3,6,0.5312504301488187,"[1, 1, 1, 1, 1, 0, 0, 0, 1, 1]"
6970,2,2,4,0.4830257687374603,"[0, 1, 1, 1, 1, 1, 0, 0, 0, 0]"
6971,1,1,2,0.7850935653136223,"[1, 1, 0, 1, 1, 0, 1, 1, 0, 1]"
6972,1,1,2,0.049377719758023186,"[0, 0, 0, 0, 0, 0, 0, 0, 0, 1]"
6973,1,1,2,0.6616274080631951,"[0, 1, 0, 1, 1, 0, 1, 0, 0, 1]"
6974,1,1,2,0.3906892642365619,"[1, 1, 1, 0, 0, 1, 1, 0, 1, 0]"
6975,1,1,2,0.0448670919928823,"[0, 1, 1, 0, 0, 1, 0, 0, 0, 1]"
6976,1,1,2,0.33919493929228983,"[1, 1, 0, 1, 0, 0, 0, 0, 1, 0]"
6977,1,1,2,0.8076972602592305,"[0, 0, 0, 1, 1, 1, 1, 1, 0, 0]"
6978,2,2,4,0.5613768549479535,"[1, 0, 1, 1, 0, 1, 1, 0, 1, 1]"
6979,1,1,2,0.371874946932398,"[0, 0, 0, 1, 0, 0, 1, 0, 1, 0]"
6980,2,2,4,0.9133704701309959,"[1, 0, 0, 0, 0, 1, 0, 1, 1, 1]"
6981,2,2,4,0.7440422778367337,"[0, 1, 1, 0, 0, 1, 0, 1, 0, 0]"
6982,1,1,2,0.32307378942350806,"[1, 0, 1, 1, 0, 0, 0, 0, 0, 0]"
6983,2,2,4,0.6520369585251233,"[0, 1, 0, 0, 0, 0, 1, 0, 1, 0]"
6984,1,1,2,0.5109007150151383,"[1, 1, 0, 0, 0, 0, 1, 1, 0, 0]"
6985,3,3,6,0.21119903707325083,"[1, 0, 0, 0, 1, 0, 0, 1, 0, 1]"
6986,1,1,2,0.9731197012664223,"[0, 1, 1, 1, 1, 0, 1, 1, 1, 0]"
6987,3,3,6,0.04806004535251762,"[0, 0, 0, 1, 1, 0, 0, 1, 0, 0]"
6988,2,2,4,0.1762631133673349,"[0, 1, 1, 0, 1, 0, 0, 0, 1, 0]"
6989,1,1,2,0.874680372123709,"[1, 1, 1, 1, 0, 1, 1, 0, 0, 1]"
6990,2,2,4,0.8246793740903238,"[1, 1, 1, 0, 0, 1, 0, 0, 1, 1]"
6991,2,2,4,0.2710929272802992,"[0, 0, 0, 1, 0, 1, 1, 1, 1, 0]"
6992,1,1,2,0.4200087185851229,"[0, 1, 0, 1, 0, 0, 0, 1, 1, 0]"
6993,2,2,4,0.446612522516009,"[1, 0, 1, 0, 0, 1, 1, 1, 1, 1]"
6994,1,1,2,0.3095769534976913,"[1, 0, 0, 0, 0, 1, 0, 0, 0, 0]"
6995,4,4,8,0.3710434325469313,"[0, 1, 1, 1, 0, 0, 0, 0, 1, 1]"
6996,1,1,2,0.3458011375260287,"[1, 0, 1, 0, 1, 0, 1, 1, 0, 0]"
6997,2,2,4,0.7509519738559535,"[1, 1, 0, 0, 1, 0, 1, 0, 1, 1]"
6998,1,1,2,0.48882793686763437,"[1, 1, 0, 1, 0, 0, 0, 0, 1, 1]"
6999,2,2,4,0.7671935586777741,"[1, 1, 0, 1, 1, 1, 1, 1, 0, 0]"
7000,1,1,2,0.9164296193197502,"[1, 0, 1, 1, 0, 0, 0, 1, 1, 0]"
7001,1,1,2,0.4220183627992887,"[0, 1, 0, 1, 0, 1, 1, 1, 1, 1]"
7002,1,1,2,0.4510764998062511,"[1, 1, 1, 1, 0, 1, 0, 1, 1, 0]"
7003,1,1,2,0.6235888038569314,"[1, 1, 1, 1, 0, 1, 1, 1, 0, 0]"
7004,2,2,4,0.14194712753965466,"[1, 0, 0, 0, 0, 1, 1, 0, 1, 0]"
7005,1,1,2,0.978751318934093,"[0, 0, 0, 0, 1, 0, 0, 0, 0, 1]"
7006,2,2,4,0.5046115371500658,"[1, 0, 0, 1, 1, 1, 0, 0, 0, 1]"
7007,1,1,2,0.9305661933506638,"[1, 1, 0, 0, 0, 0, 0, 0, 0, 0]"
7008,1,1,2,0.37300347993341776,"[1, 0, 1, 1, 1, 1, 1, 1, 1, 0]"
7009,2,2,4,0.05282602481336218,"[1, 0, 1, 0, 0, 0, 1, 0, 0, 1]"
7010,1,1,2,0.3941878351644599,"[1, 1, 1, 1, 0, 0, 1, 0, 1, 0]"
7011,1,1,2,0.6710039492325086,"[0, 0, 0, 1, 1, 0, 1, 1, 1, 1]"
7012,1,1,2,0.4005484750633308,"[0, 0, 1, 1, 1, 1, 1, 0, 0, 1]"
7013,2,2,4,0.008710420388823525,"[0, 1, 0, 1, 1, 0, 0, 1, 0, 0]"
7014,1,1,2,0.6871326298337029,"[0, 1, 1, 1, 1, 1, 0, 0, 1, 1]"
7015,2,2,4,0.07833590539600588,"[0, 1, 0, 1, 1, 0, 0, 0, 0, 1]"
7016,1,1,2,0.7870351521062662,"[0, 0, 0, 0, 0, 0, 1, 1, 0, 1]"
7017,5,5,10,0.31369793017452996,"[0, 1, 1, 1, 1, 0, 1, 0, 0, 1]"
7018,1,1,2,0.45977684715992084,"[0, 1, 1, 0, 0, 1, 0, 0, 1, 0]"
7019,1,1,2,0.7908712471512176,"[1, 0, 0, 0, 1, 1, 1, 0, 0, 0]"
7020,2,2,4,0.7932495365978143,"[0, 0, 1, 0, 1, 1, 0, 0, 0, 0]"
7021,1,1,2,0.3775569553408886,"[0, 1, 1, 0, 0, 0, 1, 0, 0, 0]"
7022,1,1,2,0.3750171359990965,"[1, 1, 0, 0, 1, 1, 0, 1, 1, 0]"
7023,3,3,6,0.35178056210662323,"[1, 0, 1, 0, 1, 0, 1, 0, 1, 0]"
7024,1,1,2,0.43348493716576586,"[0, 0, 0, 0, 1, 0, 1, 0, 1, 1]"
7025,1,1,2,0.9374065786013528,"[1, 1, 0, 0, 0, 0, 1, 0, 1, 0]"
7026,3,3,6,0.28170115468277324,"[0, 0, 0, 0, 1, 1, 0, 0, 0, 1]"
7027,1,1,2,0.6951811826003452,"[1, 0, 1, 1, 1, 1, 1, 1, 0, 1]"
7028,1,1,2,0.07110980824386959,"[1, 0, 1, 0, 1, 0, 0, 0, 0, 1]"
7029,1,1,2,0.2566678833037952,"[1, 0, 1, 1, 0, 0, 0, 0, 1, 0]"
7030,2,2,4,0.3356166473215295,"[1, 1, 0, 1, 0, 0, 1, 1, 0, 1]"
7031,2,2,4,0.40848715987357886,"[0, 1, 1, 1, 1, 0, 0, 1, 1, 1]"
7032,2,2,4,0.9941569861494645,"[0, 1, 1, 0, 1, 1, 0, 1, 1, 0]"
7033,1,1,2,0.7806306521238714,"[1, 0, 1, 0, 0, 1, 0, 1, 1, 0]"
7034,1,1,2,0.3895254236511668,"[0, 0, 1, 1, 0, 1, 1, 0, 1, 0]"
7035,1,1,2,0.6458029498002867,"[0, 0, 1, 1, 1, 0, 1, 0, 0, 0]"
7036,1,1,2,0.11975411404132064,"[0, 0, 0, 0, 0, 1, 0, 0, 0, 0]"
7037,1,1,2,0.27174053924584307,"[1, 0, 1, 1, 0, 1, 0, 0, 1, 0]"
7038,1,1,2,0.10568605008582688,"[1, 1, 1, 0, 1, 1, 1, 0, 0, 1]"
7039,1,1,2,0.20463377923272652,"[1, 1, 1, 1, 1, 0, 0, 1, 1, 0]"
7040,2,2,4,0.5171886446193087,"[1, 0, 0, 0, 1, 0, 0, 1, 0, 1]"
7041,1,1,2,0.5299754411654389,"[1, 0, 1, 0, 0, 1, 0, 0, 1, 0]"
7042,1,1,2,0.5513088348338158,"[0, 0, 0, 1, 1, 0, 0, 0, 0, 1]"
7043,1,1,2,0.8051985189502208,"[1, 1, 1, 0, 1, 0, 0, 0, 1, 1]"
7044,2,2,4,0.1291666594027947,"[1, 1, 1, 0, 1, 1, 0, 0, 0, 0]"
7045,1,1,2,0.7606590610345868,"[1, 0, 0, 1, 1, 1, 1, 1, 1, 1]"
7046,1,1,2,0.7795369946727274,"[1, 0, 0, 1, 0, 1, 0, 0, 1, 1]"
7047,3,3,6,0.8324087509614538,"[0, 1, 1, 1, 1, 1, 1, 0, 1, 0]"
7048,1,1,2,0.3602288830349051,"[1, 0, 0, 1, 0, 0, 0, 0, 1, 1]"
7049,7,7,14,0.7096346886184358,"[0, 0, 1, 0, 0, 1, 1, 1, 1, 1]"
7050,3,3,6,0.21433706197542368,"[0, 1, 1, 0, 0, 0, 0, 0, 1, 0]"
7051,2,2,4,0.4260885166200564,"[1, 1, 1, 0, 0, 0, 0, 1, 1, 1]"
7052,1,1,2,0.6400749096533016,"[0, 0, 0, 1, 0, 0, 1, 0, 1, 0]"
7053,1,1,2,0.48465779945832643,"[1, 1, 0, 0, 1, 1, 1, 1, 1, 0]"
7054,1,1,2,0.41251881010591007,"[0, 1, 0, 0, 1, 1, 0, 1, 0, 0]"
7055,1,1,2,0.1647696210263071,"[1, 1, 1, 0, 0, 1, 1, 1, 0, 0]"
7056,3,3,6,0.8384152949781202,"[0, 1, 1, 0, 1, 0, 1, 1, 0, 0]"
7057,1,1,2,0.43101875696199077,"[0, 0, 1, 1, 1, 1, 1, 0, 0, 0]"
7058,2,2,4,0.802193129858933,"[0, 0, 0, 0, 0, 1, 1, 0, 1, 0]"
7059,1,1,2,0.22720027654378905,"[0, 0, 0, 1, 1, 1, 1, 1, 0, 0]"
7060,1,1,2,0.14841857882258258,"[1, 1, 1, 0, 0, 0, 1, 0, 0, 1]"
7061,1,1,2,0.0926962579014392,"[1, 0, 1, 0, 0, 1, 1, 0, 0, 0]"
7062,1,1,2,0.5909112255056116,"[0, 0, 1, 0, 1, 1, 0, 1, 0, 1]"
7063,1,1,2,0.6770607793716985,"[0, 1, 1, 0, 1, 1, 1, 1, 0, 0]"
7064,2,2,4,0.6827630705481161,"[1, 0, 0, 0, 0, 1, 1, 1, 0, 0]"
7065,3,3,6,0.6474897823129374,"[0, 0, 1, 1, 1, 1, 1, 1, 0, 1]"
7066,2,2,4,0.6491657561780655,"[1, 1, 1, 1, 0, 0, 0, 0, 1, 0]"
7067,1,1,2,0.03582973045241644,"[1, 1, 1, 1, 1, 1, 0, 1, 0, 1]"
7068,2,2,4,0.6212498396975512,"[1, 1, 0, 1, 1, 0, 1, 0, 1, 0]"
7069,1,1,2,0.6330234888716262,"[1, 1, 0, 1, 1, 0, 1, 1, 0, 1]"
7070,1,1,2,0.5654844996138633,"[1, 1, 1, 1, 0, 1, 1, 1, 0, 1]"
7071,1,1,2,0.2354186045697093,"[0, 1, 0, 1, 0, 1, 0, 0, 1, 1]"
7072,1,1,2,0.8926242762621881,"[0, 0, 1, 1, 1, 0, 1, 1, 1, 1]"
7073,1,1,2,0.9469455062824602,"[0, 0, 1, 1, 1, 1, 0, 1, 1, 0]"
7074,1,1,2,0.15539955535194228,"[1, 0, 0, 0, 1, 0, 0, 0, 0, 1]"
7075,1,1,2,0.27647681745695674,"[1, 0, 1, 1, 0, 1, 0, 0, 1, 1]"
7076,1,1,2,0.6815819474281326,"[1, 1, 0, 1, 0, 1, 1, 0, 0, 0]"
7077,1,1,2,0.19532838309793854,"[1, 0, 0, 1, 0, 1, 1, 1, 1, 1]"
7078,2,2,4,0.6055460858909095,"[1, 1, 0, 0, 0, 0, 1, 1, 1, 1]"
7079,3,3,6,0.6100646682024643,"[1, 0, 0, 1, 0, 1, 0, 0, 0, 1]"
7080,4,4,8,0.8702657435824542,"[0, 0, 1, 1, 1, 1, 1, 1, 1, 0]"
7081,1,1,2,0.33480727905167795,"[0, 1, 1, 1, 0, 0, 0, 0, 0, 1]"
7082,1,1,2,0.8901624777768701,"[0, 0, 0, 1, 1, 1, 1, 0, 1, 0]"
7083,1,1,2,0.844500108778613,"[0, 0, 0, 1, 1, 1, 1, 0, 0, 1]"
7084,3,3,6,0.14642932805631126,"[1, 1, 1, 1, 1, 1, 1, 0, 1, 0]"
7085,1,1,2,0.471124044857686,"[1, 0, 1, 0, 1, 1, 0, 1, 0, 1]"
7086,1,1,2,0.052994180888841336,"[1, 0, 0, 1, 0, 0, 0, 1, 1, 1]"
7087,1,1,2,0.03229349134075987,"[1, 1, 1, 0, 1, 1, 1, 1, 0, 1]"
7088,2,2,4,0.2982523742444467,"[1, 0, 0, 0, 0, 1, 0, 0, 1, 1]"
7089,3,3,6,0.8229318484428776,"[1, 0, 0, 0, 0, 0, 0, 0, 0, 0]"
7090,1,1,2,0.37350478237903784,"[1, 1, 0, 1, 0, 0, 0, 1, 1, 0]"
7091,1,1,2,0.7762586377808975,"[0, 1, 1, 1, 0, 1, 1, 1, 1, 0]"
7092,2,2,4,0.6581648037985682,"[0, 1, 0, 0, 1, 1, 0, 1, 1, 1]"
7093,6,6,12,0.8533007039346828,"[1, 0, 0, 1, 1, 1, 0, 1, 1, 0]"
7094,1,1,2,0.5434182837519652,"[1, 0, 1, 1, 0, 0, 0, 0, 0, 1]"
7095,1,1,2,0.7562077557482009,"[1, 0, 0, 0, 0, 1, 1, 0, 0, 1]"
7096,2,2,4,0.6854425064843696,"[1, 0, 1, 0, 1, 1, 0, 1, 0, 0]"
7097,5,5,10,0.5611206828340571,"[1, 1, 0, 1, 1, 1, 1, 1, 1, 0]"
7098,3,3,6,0.5690210371166567,"[0, 1, 0, 0, 0, 1, 1, 1, 1, 1]"
7099,1,1,2,0.5453159422043046,"[1, 1, 0, 0, 0, 1, 1, 1, 0, 0]"
7100,2,2,4,0.062361812483508916,"[0, 1, 0, 1, 1, 0, 1, 1, 1, 0]"
7101,1,1,2,0.8150321190226344,"[0, 0, 1, 1, 1, 0, 0, 1, 1, 0]"
7102,1,1,2,0.5328195946356388,"[0, 0, 1, 0, 1, 0, 1, 1, 0, 0]"
7103,1,1,2,0.06696150462644479,"[1, 0, 1, 0, 1, 1, 1, 1, 0, 1]"
7104,1,1,2,0.8786742644290642,"[1, 1, 0, 1, 0, 1, 0, 0, 1, 1]"
7105,1,1,2,0.630837718075631,"[1, 1, 1, 1, 1, 1, 1, 0, 1, 1]"
7106,2,2,4,0.021394263886852505,"[1, 0, 1, 1, 0, 1, 0, 1, 0, 1]"
7107,1,1,2,0.04442145439891765,"[1, 0, 0, 1, 1, 1, 1, 0, 1, 0]"
7108,1,1,2,0.9034984906656247,"[0, 1, 0, 0, 0, 1, 1, 0, 0, 1]"
7109,1,1,2,0.9839669805027861,"[1, 1, 1, 0, 0, 1, 0, 0, 0, 1]"
7110,1,1,2,0.47759412362441755,"[1, 0, 1, 1, 0, 1, 0, 0, 0, 1]"
7111,1,1,2,0.9223248896796389,"[0, 1, 0, 1, 0, 1, 1, 1, 0, 1]"
7112,1,1,2,0.17114690040986835,"[1, 1, 1, 1, 1, 0, 1, 1, 0, 0]"
7113,4,4,8,0.5470397130898645,"[1, 1, 0, 0, 1, 1, 1, 1, 1, 1]"
7114,1,1,2,0.2694981564337552,"[0, 0, 1, 1, 0, 1, 0, 1, 1, 0]"
7115,2,2,4,0.18789395909965367,"[1, 1, 1, 1, 0, 0, 1, 0, 0, 0]"
7116,2,2,4,0.295261612214879,"[0, 0, 1, 0, 0, 0, 1, 0, 0, 1]"
7117,4,4,8,0.07956054258424061,"[1, 1, 1, 0, 1, 1, 1, 0, 0, 1]"
7118,1,1,2,0.46277411996713635,"[1, 0, 1, 0, 1, 0, 1, 0, 0, 0]"
7119,1,1,2,0.5751211817628201,"[1, 0, 1, 1, 0, 0, 0, 1, 0, 0]"
7120,1,1,2,0.23649273604252719,"[0, 1, 0, 0, 0, 1, 0, 0, 1, 0]"
7121,3,3,6,0.4964254885458447,"[1, 0, 1, 0, 1, 1, 0, 1, 1, 0]"
7122,2,2,4,0.38673447413802076,"[0, 0, 0, 0, 1, 1, 0, 0, 1, 1]"
7123,2,2,4,0.21445972728552687,"[0, 1, 0, 1, 1, 0, 1, 0, 0, 1]"
7124,3,3,6,0.2568561590566497,"[1, 0, 1, 0, 0, 0, 0, 0, 0, 0]"
7125,2,2,4,0.4589900384767459,"[0, 0, 0, 1, 0, 1, 0, 1, 1, 0]"
7126,1,1,2,0.4403362672486064,"[1, 0, 0, 1, 0, 1, 0, 1, 0, 0]"
7127,2,2,4,0.1603305439358289,"[1, 1, 1, 1, 1, 1, 1, 1, 0, 1]"
7128,1,1,2,0.7504860787643891,"[0, 0, 1, 1, 1, 0, 1, 1, 1, 1]"
7129,3,3,6,0.7060691642723378,"[1, 0, 0, 1, 0, 1, 1, 1, 1, 0]"
7130,1,1,2,0.14342234359258044,"[0, 1, 1, 0, 1, 0, 1, 0, 0, 0]"
7131,1,1,2,0.04849516393368902,"[1, 0, 1, 1, 0, 0, 0, 1, 0, 0]"
7132,1,1,2,0.8514407986181076,"[0, 1, 0, 1, 1, 1, 1, 1, 0, 0]"
7133,1,1,2,0.3289774152685935,"[0, 1, 1, 0, 1, 1, 0, 0, 0, 1]"
7134,2,2,4,0.3918740836967681,"[1, 0, 1, 1, 0, 0, 0, 1, 0, 0]"
7135,1,1,2,0.15273861168876957,"[1, 1, 0, 1, 1, 1, 0, 0, 1, 1]"
7136,1,1,2,0.5739841613994533,"[0, 0, 1, 0, 1, 0, 1, 1, 0, 0]"
7137,2,2,4,0.3362969253432887,"[0, 1, 1, 1, 0, 1, 0, 0, 1, 1]"
7138,3,3,6,0.2961882751550652,"[1, 1, 1, 0, 1, 0, 0, 1, 0, 1]"
7139,2,2,4,0.21825709627387846,"[1, 1, 1, 0, 1, 1, 1, 0, 1, 0]"
7140,2,2,4,0.4925423445053555,"[0, 1, 1, 1, 0, 0, 0, 1, 1, 1]"
7141,1,1,2,0.6053518942917593,"[1, 0, 1, 0, 0, 0, 1, 0, 0, 1]"
7142,2,2,4,0.7707141269607919,"[0, 1, 0, 1, 0, 0, 1, 0, 1, 0]"
7143,1,1,2,0.5706688366754448,"[0, 1, 1, 0, 0, 1, 1, 0, 1, 0]"
7144,1,1,2,0.9520491566493801,"[0, 0, 1, 1, 0, 0, 1, 0, 1, 1]"
7145,1,1,2,0.6121685868238532,"[1, 1, 1, 0, 1, 0, 1, 0, 0, 0]"
7146,1,1,2,0.6925061218799303,"[1, 0, 1, 0, 1, 1, 1, 0, 0, 0]"
7147,1,1,2,0.9363813997628976,"[1, 1, 0, 1, 1, 1, 0, 0, 1, 0]"
7148,1,1,2,0.20782906204037344,"[0, 1, 0, 0, 1, 1, 0, 1, 1, 0]"
7149,1,1,2,0.8186814728956396,"[1, 0, 0, 1, 0, 0, 1, 0, 0, 0]"
7150,1,1,2,0.23363341487689615,"[0, 1, 1, 0, 1, 1, 1, 0, 0, 1]"
7151,3,3,6,0.015169569661884652,"[0, 0, 0, 1, 0, 1, 1, 1, 0, 0]"
7152,2,2,4,0.8032160307364149,"[1, 1, 0, 1, 0, 0, 0, 0, 1, 1]"
7153,1,1,2,0.2516765957334808,"[0, 0, 1, 0, 1, 1, 1, 1, 0, 0]"
7154,1,1,2,0.9019867232634895,"[0, 1, 0, 0, 1, 0, 0, 0, 0, 1]"
7155,2,2,4,0.2915803547501018,"[0, 1, 1, 1, 1, 0, 1, 0, 1, 0]"
7156,2,2,4,0.5267375241226743,"[1, 1, 0, 0, 0, 1, 1, 0, 0, 1]"
7157,2,2,4,0.9009233380153995,"[0, 0, 0, 1, 0, 1, 1, 0, 0, 0]"
7158,1,1,2,0.7817408295558068,"[0, 1, 1, 0, 1, 0, 0, 1, 1, 1]"
7159,1,1,2,0.4174290063229178,"[0, 1, 1, 0, 1, 1, 1, 0, 1, 1]"
7160,3,3,6,0.2910168625387801,"[0, 1, 0, 1, 0, 1, 1, 0, 0, 1]"
7161,1,1,2,0.9474161864782777,"[1, 1, 0, 1, 0, 0, 0, 1, 1, 1]"
7162,5,5,10,0.12035213970783265,"[0, 1, 0, 1, 1, 1, 0, 1, 0, 1]"
7163,2,2,4,0.2667314185813807,"[0, 1, 1, 1, 1, 0, 1, 1, 1, 0]"
7164,1,1,2,0.06662029118568435,"[0, 0, 0, 1, 1, 1, 1, 0, 0, 0]"
7165,1,1,2,0.8814843899332319,"[1, 1, 1, 1, 1, 1, 0, 1, 1, 1]"
7166,1,1,2,0.8989679149319024,"[1, 0, 0, 0, 1, 1, 1, 0, 1, 1]"
7167,1,1,2,0.8840569598645175,"[0, 1, 0, 0, 0, 1, 1, 0, 0, 0]"
7168,1,1,2,0.3006757343910501,"[1, 1, 0, 0, 0, 1, 1, 1, 1, 0]"
7169,2,2,4,0.7728229347803844,"[0, 0, 1, 0, 1, 0, 0, 1, 0, 0]"
7170,1,1,2,0.478771037543103,"[1, 0, 1, 0, 1, 1, 0, 1, 1, 0]"
7171,1,1,2,0.5254321178162323,"[1, 1, 1, 0, 0, 0, 0, 0, 1, 1]"
7172,2,2,4,0.5307721510364646,"[0, 0, 0, 0, 1, 1, 1, 1, 0, 1]"
7173,3,3,6,0.3007608860920383,"[1, 1, 1, 0, 0, 1, 1, 0, 1, 0]"
7174,1,1,2,0.5350360143554183,"[0, 1, 1, 0, 0, 1, 0, 1, 1, 1]"
7175,2,2,4,0.1855263159517706,"[1, 0, 0, 1, 0, 1, 0, 0, 0, 0]"
7176,4,4,8,0.5760933997967753,"[1, 1, 0, 0, 1, 0, 0, 0, 1, 1]"
7177,1,1,2,0.5277178635170892,"[1, 0, 0, 1, 1, 0, 1, 0, 0, 1]"
7178,2,2,4,0.5242600876800574,"[1, 0, 1, 0, 1, 1, 1, 0, 1, 1]"
7179,3,3,6,0.5195827547115915,"[1, 1, 0, 1, 0, 1, 1, 1, 0, 1]"
7180,1,1,2,0.36265127154635746,"[0, 1, 1, 0, 0, 0, 0, 0, 1, 1]"
7181,1,1,2,0.3030281674724059,"[1, 1, 1, 0, 1, 0, 1, 0, 0, 1]"
7182,2,2,4,0.024312176881721936,"[0, 0, 1, 0, 1, 0, 1, 0, 0, 1]"
7183,4,4,8,0.2798766538318228,"[0, 1, 1, 0, 1, 0, 0, 0, 0, 1]"
7184,2,2,4,0.2372523803834382,"[1, 1, 1, 0, 0, 0, 0, 1, 1, 0]"
7185,1,1,2,0.5889063555391996,"[0, 1, 1, 0, 1, 1, 0, 1, 1, 0]"
7186,2,2,4,0.07508465398728403,"[0, 0, 0, 0, 0, 1, 0, 1, 0, 1]"
7187,2,2,4,0.5814875538818488,"[0, 1, 0, 0, 1, 0, 0, 1, 1, 1]"
7188,2,2,4,0.9203547457918305,"[0, 1, 0, 1, 0, 0, 0, 0, 0, 0]"
7189,1,1,2,0.7619853284709677,"[0, 1, 0, 1, 1, 1, 0, 1, 0, 0]"
7190,1,1,2,0.6780795628181039,"[1, 0, 0, 0, 0, 0, 1, 0, 1, 1]"
7191,2,2,4,0.6075502138816731,"[0, 0, 0, 0, 0, 1, 1, 0, 1, 0]"
7192,2,2,4,0.9360611959486209,"[0, 0, 1, 1, 1, 0, 1, 1, 0, 1]"
7193,1,1,2,0.48450282346952744,"[0, 1, 0, 0, 0, 0, 1, 1, 0, 1]"
7194,1,1,2,0.8740910027458512,"[0, 0, 1, 1, 1, 0, 0, 1, 1, 1]"
7195,1,1,2,0.29464337347505387,"[1, 0, 0, 0, 1, 0, 0, 0, 0, 1]"
7196,1,1,2,0.22921623322935236,"[1, 0, 1, 1, 1, 0, 1, 0, 0, 1]"
7197,3,3,6,0.45267583815386936,"[1, 1, 1, 1, 1, 0, 1, 1, 0, 0]"
7198,4,4,8,0.41709315831817395,"[1, 0, 0, 1, 1, 1, 1, 1, 0, 0]"
7199,1,1,2,0.2259332767151916,"[1, 1, 1, 1, 0, 0, 0, 0, 1, 0]"
7200,1,1,2,0.875622384049536,"[0, 1, 1, 1, 1, 1, 1, 0, 1, 0]"
7201,1,1,2,0.10509878764310965,"[0, 1, 0, 0, 1, 1, 1, 0, 0, 1]"
7202,1,1,2,0.7092665844423669,"[1, 0, 1, 0, 1, 1, 0, 0, 0, 1]"
7203,1,1,2,0.2325284289469174,"[0, 1, 0, 1, 0, 0, 1, 1, 1, 0]"
7204,1,1,2,0.6344291047330362,"[1, 0, 1, 1, 1, 1, 1, 1, 0, 0]"
7205,1,1,2,0.5055183508181864,"[0, 1, 0, 0, 0, 1, 0, 0, 1, 0]"
7206,1,1,2,0.17554891947388074,"[1, 0, 0, 0, 1, 0, 1, 0, 1, 1]"
7207,2,2,4,0.38781240972624076,"[0, 1, 0, 0, 1, 0, 1, 1, 0, 1]"
7208,5,5,10,0.1723101535713113,"[1, 0, 0, 1, 1, 0, 1, 0, 0, 1]"
7209,1,1,2,0.7541944477382582,"[1, 0, 0, 1, 0, 1, 1, 1, 0, 0]"
7210,1,1,2,0.46532617129481546,"[0, 1, 1, 1, 0, 0, 0, 0, 0, 0]"
7211,1,1,2,0.9785639236113036,"[1, 0, 1, 0, 0, 0, 0, 1, 0, 1]"
7212,1,1,2,0.5367107181759306,"[1, 1, 1, 0, 0, 1, 1, 0, 0, 1]"
7213,1,1,2,0.88512626664312,"[0, 0, 0, 1, 1, 0, 1, 0, 1, 1]"
7214,1,1,2,0.7056637908541037,"[0, 0, 0, 0, 1, 1, 0, 1, 0, 1]"
7215,1,1,2,0.2813723692106861,"[0, 0, 1, 1, 0, 1, 1, 1, 0, 1]"
7216,1,1,2,0.3493353011421061,"[1, 0, 0, 0, 0, 1, 0, 0, 0, 1]"
7217,4,4,8,0.4153870440121753,"[1, 0, 0, 1, 1, 0, 1, 0, 1, 0]"
7218,1,1,2,0.39422299425575835,"[1, 1, 1, 0, 0, 0, 1, 0, 1, 1]"
7219,1,1,2,0.40679684288031615,"[0, 0, 0, 1, 1, 1, 0, 1, 1, 1]"
7220,2,2,4,0.8223497355670714,"[1, 1, 0, 1, 0, 1, 1, 1, 1, 1]"
7221,2,2,4,0.2975799273924834,"[0, 0, 1, 0, 0, 0, 1, 1, 0, 0]"
7222,1,1,2,0.8797824450442144,"[1, 0, 0, 1, 0, 0, 0, 1, 1, 0]"
7223,3,3,6,0.326524896693285,"[0, 1, 1, 0, 1, 0, 1, 0, 0, 1]"
7224,5,5,10,0.8041337157173379,"[1, 1, 0, 0, 0, 1, 1, 1, 1, 1]"
7225,1,1,2,0.5146679364572331,"[0, 1, 1, 0, 0, 0, 1, 1, 0, 1]"
7226,1,1,2,0.11047799529541213,"[0, 0, 0, 0, 1, 1, 0, 0, 1, 1]"
7227,1,1,2,0.6017127922443647,"[1, 1, 0, 0, 1, 0, 0, 0, 0, 1]"
7228,1,1,2,0.6455016808630238,"[0, 1, 0, 0, 0, 1, 1, 1, 0, 0]"
7229,3,3,6,0.29606132652743755,"[0, 1, 1, 1, 1, 0, 0, 1, 0, 0]"
7230,1,1,2,0.42508386527404984,"[1, 1, 1, 0, 0, 1, 1, 0, 1, 0]"
7231,1,1,2,0.5670560619020938,"[0, 1, 0, 1, 1, 1, 1, 0, 0, 0]"
7232,1,1,2,0.642189649800784,"[0, 1, 0, 1, 1, 0, 0, 1, 0, 0]"
7233,1,1,2,0.5784234902359636,"[0, 0, 0, 0, 1, 1, 1, 1, 0, 0]"
7234,1,1,2,0.5471242469748304,"[1, 0, 1, 0, 0, 0, 1, 0, 1, 0]"
7235,1,1,2,0.3142859637925508,"[0, 1, 0, 0, 1, 1, 0, 0, 0, 0]"
7236,1,1,2,0.557233981887382,"[0, 1, 1, 0, 1, 0, 0, 0, 1, 0]"
7237,3,3,6,0.8537853239967162,"[0, 1, 0, 1, 0, 1, 1, 0, 1, 0]"
7238,1,1,2,0.4606203488076266,"[1, 1, 0, 1, 1, 0, 0, 1, 0, 0]"
7239,2,2,4,0.46535366760782326,"[1, 0, 1, 1, 0, 0, 1, 0, 0, 0]"
7240,1,1,2,0.40227925846379287,"[1, 0, 1, 0, 1, 0, 1, 0, 1, 0]"
7241,1,1,2,0.7030772253493226,"[1, 0, 0, 1, 0, 0, 0, 0, 1, 0]"
7242,4,4,8,0.3002734414208147,"[1, 0, 1, 0, 0, 0, 1, 0, 1, 1]"
7243,1,1,2,0.14603321182575457,"[0, 1, 0, 1, 1, 1, 1, 1, 0, 0]"
7244,4,4,8,0.07210812959438895,"[0, 1, 0, 1, 0, 0, 1, 1, 1, 1]"
7245,1,1,2,0.5980450437105748,"[1, 0, 1, 0, 0, 0, 0, 0, 0, 1]"
7246,2,2,4,0.4100099718320498,"[0, 1, 1, 0, 0, 1, 1, 1, 0, 1]"
7247,2,2,4,0.4196925730832549,"[1, 1, 1, 0, 0, 1, 1, 0, 0, 1]"
7248,1,1,2,0.499351449343155,"[0, 1, 1, 1, 1, 0, 1, 1, 0, 1]"
7249,2,2,4,0.5978875146590686,"[1, 0, 0, 0, 1, 1, 0, 1, 0, 1]"
7250,1,1,2,0.13806777268663262,"[1, 1, 0, 1, 1, 1, 1, 0, 0, 1]"
7251,1,1,2,0.3216940305786091,"[0, 0, 1, 0, 0, 0, 0, 1, 0, 0]"
7252,1,1,2,0.7776826262185889,"[0, 0, 1, 0, 0, 1, 0, 1, 1, 0]"
7253,4,4,8,0.9217328980000633,"[0, 0, 0, 0, 0, 1, 0, 1, 1, 0]"
7254,1,1,2,0.40113591117067815,"[1, 0, 1, 1, 1, 0, 0, 0, 1, 1]"
7255,1,1,2,0.0627104305957421,"[1, 0, 0, 0, 0, 1, 0, 0, 0, 0]"
7256,1,1,2,0.19576429371220871,"[0, 1, 1, 0, 0, 0, 0, 1, 1, 0]"
7257,4,4,8,0.3455579106214127,"[0, 1, 0, 1, 1, 1, 1, 1, 0, 1]"
7258,2,2,4,0.8833556563439421,"[1, 0, 1, 1, 1, 1, 0, 0, 0, 1]"
7259,1,1,2,0.8890646178837793,"[0, 0, 0, 1, 0, 0, 1, 1, 0, 0]"
7260,1,1,2,0.5571236421390487,"[1, 0, 1, 0, 1, 0, 1, 0, 0, 1]"
7261,1,1,2,0.1528854076069992,"[1, 0, 1, 0, 1, 1, 0, 0, 0, 0]"
7262,2,2,4,0.04279687856093706,"[1, 0, 1, 1, 1, 0, 1, 0, 1, 0]"
7263,1,1,2,0.3387896724750049,"[1, 1, 0, 1, 1, 1, 1, 0, 0, 0]"
7264,1,1,2,0.4912247363575575,"[0, 0, 1, 0, 0, 1, 1, 0, 0, 0]"
7265,2,2,4,0.025899448159165894,"[0, 1, 1, 1, 0, 1, 1, 1, 1, 1]"
7266,1,1,2,0.8574529277267161,"[0, 1, 0, 1, 0, 1, 1, 0, 0, 0]"
7267,1,1,2,0.6160529750296873,"[0, 1, 0, 0, 1, 1, 1, 0, 1, 0]"
7268,2,2,4,0.10635260701334459,"[1, 0, 1, 1, 1, 0, 1, 1, 1, 0]"
7269,4,4,8,0.22123587850375215,"[1, 1, 1, 1, 0, 0, 1, 1, 0, 0]"
7270,3,3,6,0.49937168947887167,"[1, 1, 0, 1, 0, 0, 0, 1, 1, 0]"
7271,2,2,4,0.9028688038750035,"[1, 0, 0, 1, 0, 1, 1, 0, 1, 0]"
7272,1,1,2,0.5532626873951116,"[1, 1, 1, 1, 0, 0, 1, 0, 0, 0]"
7273,1,1,2,0.18120464677825632,"[1, 1, 0, 1, 1, 0, 0, 1, 1, 1]"
7274,2,2,4,0.45134526979874623,"[0, 1, 0, 0, 1, 1, 0, 1, 0, 1]"
7275,4,4,8,0.4074597416830611,"[0, 0, 1, 0, 1, 1, 1, 1, 1, 1]"
7276,2,2,4,0.019709782384646046,"[0, 1, 1, 0, 1, 1, 1, 0, 0, 1]"
7277,1,1,2,0.11572274208354982,"[0, 1, 0, 1, 0, 1, 1, 1, 1, 1]"
7278,1,1,2,0.12473924111654122,"[0, 1, 0, 0, 0, 0, 1, 1, 0, 0]"
7279,1,1,2,0.1950870870015129,"[1, 0, 1, 1, 0, 0, 0, 1, 0, 0]"
7280,2,2,4,0.26695594618855767,"[1, 0, 0, 1, 0, 0, 1, 1, 1, 0]"
7281,1,1,2,0.540976755629684,"[1, 0, 1, 0, 0, 1, 1, 1, 1, 1]"
7282,3,3,6,0.3736596347160285,"[0, 1, 0, 0, 1, 0, 1, 0, 1, 0]"
7283,3,3,6,0.6327687523817251,"[1, 0, 1, 1, 0, 1, 1, 0, 0, 0]"
7284,1,1,2,0.04055597201826544,"[0, 1, 1, 0, 1, 1, 0, 0, 1, 0]"
7285,2,2,4,0.5784585392738685,"[0, 1, 1, 1, 0, 1, 0, 0, 1, 1]"
7286,2,2,4,0.2342413738428828,"[0, 1, 1, 1, 1, 1, 0, 0, 1, 0]"
7287,1,1,2,0.6378604862870525,"[1, 0, 0, 1, 1, 1, 1, 0, 1, 0]"
7288,2,2,4,0.6800931893152106,"[1, 0, 1, 0, 1, 0, 1, 1, 0, 1]"
7289,1,1,2,0.7499282038511775,"[1, 0, 1, 0, 0, 1, 0, 1, 1, 1]"
7290,1,1,2,0.6567325443908161,"[0, 0, 1, 1, 0, 0, 1, 1, 1, 0]"
7291,2,2,4,0.18347252091777067,"[0, 0, 0, 1, 1, 1, 0, 1, 0, 0]"
7292,2,2,4,0.20051179956119902,"[0, 1, 1, 1, 1, 0, 0, 0, 0, 0]"
7293,3,3,6,0.2689338202167464,"[1, 0, 1, 0, 0, 0, 1, 1, 1, 1]"
7294,1,1,2,0.1013469251996083,"[1, 0, 0, 0, 1, 1, 0, 0, 1, 1]"
7295,1,1,2,0.10720065393250966,"[1, 1, 0, 0, 0, 0, 1, 1, 0, 0]"
7296,1,1,2,0.4484234178007235,"[1, 1, 1, 1, 1, 0, 0, 1, 0, 0]"
7297,1,1,2,0.0761853449451757,"[1, 1, 0, 0, 0, 0, 1, 1, 0, 1]"
7298,1,1,2,0.41806820139505285,"[1, 0, 0, 0, 1, 0, 1, 1, 0, 0]"
7299,2,2,4,0.40156842291595274,"[1, 1, 0, 0, 1, 0, 0, 1, 1, 1]"
7300,1,1,2,0.9637803697218755,"[1, 1, 0, 0, 0, 0, 0, 1, 0, 1]"
7301,2,2,4,0.8528948321395455,"[1, 1, 1, 0, 1, 1, 1, 0, 1, 0]"
7302,3,3,6,0.6900360821386312,"[0, 0, 0, 0, 0, 1, 0, 1, 0, 0]"
7303,1,1,2,0.219823751745716,"[1, 0, 0, 0, 1, 1, 0, 0, 0, 1]"
7304,2,2,4,0.09498690904011964,"[0, 1, 0, 1, 1, 0, 1, 1, 0, 1]"
7305,1,1,2,0.6488637051161484,"[1, 1, 0, 1, 1, 0, 0, 1, 1, 0]"
7306,1,1,2,0.20341182036396044,"[1, 1, 1, 0, 1, 1, 0, 0, 1, 0]"
7307,1,1,2,0.9015684112318967,"[0, 1, 1, 1, 0, 1, 1, 0, 0, 0]"
7308,2,2,4,0.8517073348539593,"[0, 0, 0, 0, 0, 1, 1, 1, 1, 0]"
7309,3,3,6,0.5242461711607639,"[0, 0, 1, 1, 1, 1, 0, 0, 1, 1]"
7310,1,1,2,0.2530558068875126,"[0, 0, 0, 1, 1, 0, 0, 0, 0, 1]"
7311,1,1,2,0.33371975997164227,"[1, 0, 1, 1, 1, 0, 0, 0, 1, 0]"
7312,2,2,4,0.8066091129881534,"[1, 1, 0, 1, 0, 0, 0, 1, 1, 0]"
7313,1,1,2,0.48300168513094555,"[1, 1, 0, 1, 1, 1, 1, 0, 1, 1]"
7314,2,2,4,0.7177849599460898,"[0, 0, 1, 0, 0, 0, 1, 1, 1, 1]"
7315,4,4,8,0.3276819401393486,"[1, 1, 1, 1, 1, 1, 1, 1, 1, 1]"
7316,1,1,2,0.35159108122889904,"[0, 1, 0, 0, 1, 0, 1, 0, 0, 1]"
7317,1,1,2,0.930291590380488,"[1, 0, 0, 0, 1, 0, 0, 0, 0, 0]"
7318,1,1,2,0.7350531822635638,"[0, 0, 0, 0, 0, 0, 0, 1, 1, 1]"
7319,1,1,2,0.5896622685332549,"[1, 0, 1, 0, 0, 0, 1, 1, 1, 0]"
7320,1,1,2,0.353518556683025,"[0, 0, 0, 1, 0, 0, 1, 1, 1, 0]"
7321,1,1,2,0.20674824739168618,"[0, 1, 0, 0, 1, 1, 1, 1, 0, 0]"
7322,3,3,6,0.532250583723708,"[1, 1, 1, 0, 1, 1, 1, 0, 0, 1]"
7323,1,1,2,0.036454722951647756,"[0, 1, 1, 0, 0, 1, 0, 1, 0, 0]"
7324,2,2,4,0.4367987217250514,"[0, 0, 0, 1, 1, 0, 1, 1, 1, 0]"
7325,1,1,2,0.0219396372578311,"[1, 1, 0, 0, 1, 0, 1, 1, 0, 0]"
7326,1,1,2,0.12691798593507475,"[1, 0, 1, 1, 1, 0, 0, 1, 1, 1]"
7327,2,2,4,0.832074958561189,"[1, 1, 1, 0, 1, 1, 0, 1, 0, 1]"
7328,2,2,4,0.1569050540394441,"[1, 0, 1, 0, 0, 1, 1, 1, 1, 1]"
7329,1,1,2,0.09505375309989439,"[0, 0, 1, 0, 1, 0, 1, 0, 1, 1]"
7330,1,1,2,0.2952670443224765,"[0, 1, 1, 0, 1, 1, 1, 0, 0, 0]"
7331,1,1,2,0.07015538869112137,"[0, 1, 0, 1, 0, 0, 0, 0, 1, 0]"
7332,2,2,4,0.08612040167515267,"[1, 0, 0, 0, 1, 1, 1, 1, 1, 0]"
7333,1,1,2,0.15727048933840626,"[1, 1, 0, 1, 1, 1, 1, 0, 0, 0]"
7334,1,1,2,0.7600757418051769,"[0, 0, 0, 1, 1, 1, 0, 0, 0, 1]"
7335,1,1,2,0.6446682581948735,"[0, 0, 0, 1, 1, 1, 1, 1, 1, 0]"
7336,2,2,4,0.37602970348988596,"[0, 0, 0, 1, 1, 0, 1, 0, 1, 0]"
7337,1,1,2,0.3177583292786721,"[1, 0, 0, 1, 1, 1, 1, 1, 0, 1]"
7338,6,6,12,0.6995318183931422,"[1, 1, 0, 0, 1, 1, 1, 0, 1, 1]"
7339,1,1,2,0.5612645936429904,"[1, 1, 1, 1, 0, 0, 0, 1, 1, 1]"
7340,2,2,4,0.47113390256679344,"[1, 0, 0, 0, 1, 1, 1, 0, 0, 1]"
7341,1,1,2,0.508502169787389,"[1, 0, 0, 1, 0, 0, 1, 0, 1, 1]"
7342,1,1,2,0.763410971287981,"[1, 1, 0, 1, 1, 0, 1, 1, 0, 0]"
7343,2,2,4,0.21233404775730436,"[1, 0, 0, 0, 1, 1, 1, 1, 0, 0]"
7344,1,1,2,0.9991545894516028,"[1, 1, 1, 1, 0, 1, 0, 1, 1, 0]"
7345,1,1,2,0.40347515862369987,"[1, 0, 1, 0, 1, 1, 0, 0, 0, 0]"
7346,4,4,8,0.7605623439046947,"[0, 0, 0, 1, 0, 1, 1, 1, 1, 1]"
7347,1,1,2,0.715758174910613,"[0, 1, 0, 0, 0, 1, 0, 1, 1, 1]"
7348,1,1,2,0.9242841194087739,"[0, 1, 0, 1, 0, 0, 1, 1, 0, 0]"
7349,2,2,4,0.5220827191620061,"[1, 1, 0, 0, 0, 1, 0, 0, 0, 0]"
7350,1,1,2,0.23100216174296684,"[0, 0, 0, 1, 0, 0, 1, 1, 0, 1]"
7351,1,1,2,0.35464812810605195,"[1, 0, 1, 0, 0, 1, 0, 1, 1, 1]"
7352,2,2,4,0.8569526280129722,"[1, 1, 0, 1, 0, 1, 1, 1, 1, 0]"
7353,4,4,8,0.01363180346931725,"[1, 1, 1, 1, 1, 0, 0, 0, 1, 0]"
7354,1,1,2,0.16488713937500543,"[0, 1, 1, 0, 0, 0, 1, 1, 0, 1]"
7355,1,1,2,0.06902386928771398,"[0, 0, 0, 1, 0, 1, 1, 0, 0, 0]"
7356,1,1,2,0.6299714414709321,"[0, 0, 1, 1, 1, 1, 1, 1, 1, 1]"
7357,1,1,2,0.7044496196681277,"[1, 0, 1, 1, 1, 0, 0, 1, 0, 1]"
7358,2,2,4,0.4716449264993243,"[0, 1, 1, 0, 0, 1, 0, 0, 1, 1]"
7359,1,1,2,0.7991668946068565,"[0, 1, 1, 1, 0, 1, 0, 0, 1, 1]"
7360,3,3,6,0.9955946419725852,"[1, 1, 1, 0, 0, 0, 1, 0, 1, 0]"
7361,2,2,4,0.39303029116877974,"[1, 0, 1, 0, 0, 1, 0, 0, 0, 1]"
7362,1,1,2,0.33085317587266116,"[0, 1, 0, 1, 1, 1, 1, 1, 0, 0]"
7363,1,1,2,0.017742053898769594,"[0, 1, 0, 1, 0, 1, 1, 1, 1, 1]"
7364,2,2,4,0.7228405407200938,"[1, 0, 1, 1, 1, 1, 0, 0, 0, 0]"
7365,2,2,4,0.09963182107348534,"[1, 1, 1, 1, 0, 0, 1, 0, 1, 1]"
7366,1,1,2,0.647007159177086,"[1, 0, 1, 0, 0, 0, 1, 0, 1, 1]"
7367,1,1,2,0.27161641213534093,"[0, 1, 1, 1, 0, 0, 0, 1, 1, 0]"
7368,1,1,2,0.15528775697246733,"[1, 0, 1, 0, 0, 0, 0, 0, 1, 1]"
7369,3,3,6,0.149767709385774,"[1, 1, 1, 0, 0, 0, 1, 1, 0, 1]"
7370,1,1,2,0.9136287858683002,"[1, 0, 0, 1, 1, 0, 0, 0, 1, 0]"
7371,3,3,6,0.9041279514119996,"[0, 0, 1, 0, 1, 1, 0, 0, 1, 0]"
7372,1,1,2,0.23830781596323924,"[0, 1, 0, 0, 1, 0, 1, 1, 0, 1]"
7373,1,1,2,0.5779282939943038,"[0, 0, 0, 1, 0, 1, 1, 0, 1, 0]"
7374,2,2,4,0.313139620238282,"[0, 0, 0, 1, 1, 0, 1, 1, 1, 1]"
7375,3,3,6,0.24051403627919388,"[1, 0, 0, 1, 0, 0, 0, 0, 1, 1]"
7376,1,1,2,0.4331105859532407,"[1, 0, 0, 0, 0, 0, 1, 1, 0, 1]"
7377,1,1,2,0.0693651198699341,"[0, 1, 0, 0, 1, 0, 1, 1, 0, 1]"
7378,1,1,2,0.721340939288608,"[1, 1, 1, 1, 0, 1, 0, 1, 0, 1]"
7379,1,1,2,0.7925581454264086,"[1, 0, 1, 0, 1, 0, 1, 1, 0, 1]"
7380,1,1,2,0.9369131465854176,"[0, 0, 1, 0, 1, 1, 0, 1, 0, 0]"
7381,1,1,2,0.3998863511374193,"[0, 0, 1, 1, 0, 0, 0, 0, 1, 1]"
7382,1,1,2,0.60270812534337,"[1, 1, 1, 1, 1, 1, 1, 1, 0, 1]"
7383,1,1,2,0.07914693915605564,"[0, 0, 1, 0, 0, 1, 0, 0, 0, 1]"
7384,2,2,4,0.12624282198310444,"[0, 0, 1, 0, 0, 1, 0, 0, 0, 0]"
7385,1,1,2,0.02802801933350796,"[1, 1, 1, 1, 0, 1, 1, 1, 1, 0]"
7386,2,2,4,0.05031756236657625,"[1, 0, 1, 0, 1, 1, 1, 0, 1, 1]"
7387,1,1,2,0.7023918863181848,"[1, 1, 0, 1, 0, 0, 0, 1, 0, 0]"
7388,1,1,2,0.23153772440467335,"[0, 0, 1, 1, 1, 0, 0, 0, 0, 0]"
7389,1,1,2,0.5266374146363753,"[1, 0, 1, 1, 0, 0, 0, 0, 0, 1]"
7390,1,1,2,0.40021841595429664,"[0, 1, 1, 1, 0, 0, 1, 0, 0, 1]"
7391,1,1,2,0.7655273502910721,"[0, 1, 1, 1, 1, 0, 0, 1, 0, 1]"
7392,1,1,2,0.6687634900594941,"[0, 1, 0, 0, 0, 1, 0, 1, 1, 0]"
7393,1,1,2,0.9663387062366705,"[1, 1, 0, 0, 0, 1, 1, 1, 0, 0]"
7394,2,2,4,0.3807987395468604,"[1, 0, 0, 0, 0, 1, 1, 1, 1, 0]"
7395,1,1,2,0.025588564990909113,"[0, 1, 0, 1, 0, 1, 0, 1, 0, 0]"
7396,1,1,2,0.16082926236552264,"[0, 0, 0, 0, 0, 1, 0, 1, 0, 1]"
7397,1,1,2,0.24214587847592584,"[0, 0, 0, 1, 0, 0, 1, 1, 1, 0]"
7398,1,1,2,0.036448228817515305,"[1, 1, 1, 0, 0, 1, 0, 0, 0, 1]"
7399,1,1,2,0.6123656958552661,"[0, 1, 1, 1, 0, 0, 1, 1, 0, 1]"
7400,3,3,6,0.2693226222067646,"[0, 1, 0, 1, 0, 1, 1, 0, 0, 0]"
7401,2,2,4,0.21222085138715652,"[1, 1, 0, 1, 0, 0, 1, 1, 1, 0]"
7402,1,1,2,0.5385524267695188,"[0, 0, 0, 0, 0, 0, 0, 0, 1, 0]"
7403,3,3,6,0.18022412883416838,"[1, 0, 1, 1, 1, 1, 0, 1, 0, 1]"
7404,1,1,2,0.7574628478615224,"[1, 0, 0, 0, 1, 0, 1, 0, 0, 0]"
7405,2,2,4,0.9214496507575889,"[1, 1, 0, 0, 1, 1, 0, 0, 0, 1]"
7406,2,2,4,0.36220176930563197,"[0, 0, 0, 1, 1, 1, 1, 0, 1, 1]"
7407,1,1,2,0.9942879006163876,"[1, 1, 0, 0, 0, 1, 0, 1, 1, 1]"
7408,2,2,4,0.06397468388196481,"[0, 1, 0, 1, 0, 1, 1, 0, 1, 1]"
7409,2,2,4,0.11474564976665835,"[0, 1, 1, 0, 0, 1, 0, 1, 0, 0]"
7410,1,1,2,0.9427898693647444,"[0, 1, 0, 1, 1, 0, 0, 1, 1, 0]"
7411,1,1,2,0.24922938371400138,"[0, 0, 0, 0, 0, 0, 1, 0, 1, 1]"
7412,2,2,4,0.5881126590644992,"[0, 1, 0, 0, 1, 0, 0, 1, 1, 0]"
7413,5,5,10,0.09726298228581765,"[1, 1, 1, 0, 0, 1, 0, 1, 0, 1]"
7414,1,1,2,0.5587891653254149,"[0, 0, 0, 0, 0, 1, 1, 1, 1, 0]"
7415,1,1,2,0.34902505414233687,"[0, 1, 1, 0, 1, 1, 1, 1, 1, 1]"
7416,2,2,4,0.11478973536933745,"[0, 0, 0, 0, 1, 1, 1, 1, 1, 1]"
7417,1,1,2,0.15324155682815344,"[1, 0, 1, 0, 1, 1, 1, 0, 0, 0]"
7418,1,1,2,0.4386975807853344,"[0, 1, 0, 1, 0, 0, 0, 1, 1, 0]"
7419,1,1,2,0.21794689249294086,"[0, 0, 1, 0, 1, 1, 0, 0, 1, 0]"
7420,2,2,4,0.21649712169709667,"[0, 0, 1, 0, 0, 1, 1, 0, 1, 1]"
7421,1,1,2,0.8042290537773784,"[0, 0, 1, 1, 0, 1, 1, 0, 0, 1]"
7422,1,1,2,0.5841226173892143,"[1, 1, 1, 1, 1, 0, 1, 0, 1, 1]"
7423,4,4,8,0.49665053694411687,"[1, 1, 1, 1, 0, 1, 1, 0, 1, 1]"
7424,1,1,2,0.3765194237621722,"[1, 1, 1, 1, 0, 0, 0, 0, 0, 1]"
7425,1,1,2,0.17767119748924964,"[0, 1, 1, 0, 1, 0, 0, 0, 0, 0]"
7426,1,1,2,0.23746552573425783,"[0, 0, 1, 1, 1, 0, 0, 0, 0, 0]"
7427,1,1,2,0.23172950815455917,"[1, 0, 1, 0, 1, 1, 1, 1, 1, 0]"
7428,2,2,4,0.2678611442539164,"[0, 1, 0, 0, 0, 1, 0, 0, 0, 1]"
7429,1,1,2,0.724810012826738,"[1, 0, 0, 0, 0, 0, 1, 1, 0, 0]"
7430,1,1,2,0.8112218896912764,"[1, 0, 0, 0, 0, 1, 0, 0, 1, 0]"
7431,1,1,2,0.24651334063231745,"[0, 0, 1, 1, 1, 0, 0, 0, 0, 0]"
7432,1,1,2,0.29374673094209913,"[0, 1, 0, 0, 1, 1, 0, 1, 0, 1]"
7433,1,1,2,0.1738249355130379,"[1, 1, 1, 1, 1, 0, 1, 1, 0, 1]"
7434,1,1,2,0.391831894042065,"[1, 1, 0, 0, 0, 0, 0, 1, 1, 1]"
7435,3,3,6,0.4047934461177858,"[1, 0, 1, 0, 0, 1, 0, 0, 0, 1]"
7436,1,1,2,0.03568292405983142,"[1, 1, 1, 0, 1, 0, 0, 1, 0, 0]"
7437,1,1,2,0.5083430897960974,"[0, 1, 1, 0, 0, 0, 0, 0, 0, 1]"
7438,1,1,2,0.1857661033693725,"[1, 1, 1, 0, 0, 0, 0, 1, 1, 0]"
7439,1,1,2,0.5044051463682637,"[1, 1, 0, 0, 0, 1, 1, 0, 1, 0]"
7440,2,2,4,0.3732979708521419,"[0, 1, 1, 1, 0, 1, 1, 1, 1, 1]"
7441,3,3,6,0.1355027058282292,"[0, 1, 1, 1, 0, 0, 1, 0, 0, 1]"
7442,2,2,4,0.3683665780120152,"[0, 0, 1, 1, 0, 1, 1, 0, 0, 1]"
7443,1,1,2,0.14134141615245088,"[1, 1, 1, 1, 0, 0, 0, 0, 1, 0]"
7444,5,5,10,0.8716723161059998,"[1, 0, 1, 0, 1, 0, 1, 0, 1, 0]"
7445,1,1,2,0.20319802202061277,"[0, 1, 1, 1, 1, 0, 1, 0, 0, 1]"
7446,3,3,6,0.5966160465763862,"[1, 0, 1, 1, 1, 1, 1, 1, 1, 0]"
7447,1,1,2,0.1734756186701253,"[1, 0, 0, 1, 0, 1, 1, 0, 1, 1]"
7448,1,1,2,0.31946553185013415,"[0, 0, 0, 1, 0, 0, 0, 1, 1, 1]"
7449,3,3,6,0.08759251958813641,"[0, 1, 1, 0, 1, 1, 1, 0, 0, 1]"
7450,3,3,6,0.1517166488550904,"[0, 1, 1, 1, 1, 0, 1, 1, 0, 1]"
7451,1,1,2,0.04449038309466735,"[1, 1, 0, 1, 0, 0, 0, 0, 0, 0]"
7452,2,2,4,0.4124495662239194,"[0, 1, 0, 1, 1, 1, 0, 1, 1, 1]"
7453,1,1,2,0.12499712752641601,"[0, 0, 0, 1, 0, 1, 0, 1, 1, 1]"
7454,1,1,2,0.17991958266867425,"[0, 1, 0, 1, 0, 0, 0, 1, 0, 0]"
7455,1,1,2,0.4059712073148739,"[0, 0, 0, 0, 0, 0, 1, 1, 0, 0]"
7456,1,1,2,0.7592264460160623,"[0, 0, 0, 1, 1, 1, 0, 0, 0, 1]"
7457,1,1,2,0.5645783012532365,"[1, 1, 1, 1, 0, 1, 1, 1, 1, 0]"
7458,1,1,2,0.3752337617224072,"[1, 1, 0, 0, 0, 0, 1, 1, 0, 1]"
7459,1,1,2,0.8829346500463607,"[0, 0, 0, 0, 1, 1, 0, 1, 0, 1]"
7460,2,2,4,0.8202337992559393,"[0, 0, 1, 0, 0, 1, 1, 0, 1, 1]"
7461,1,1,2,0.1624816431910353,"[0, 0, 1, 1, 1, 0, 0, 1, 0, 0]"
7462,3,3,6,0.06658838021116498,"[1, 1, 0, 0, 0, 0, 1, 1, 0, 0]"
7463,3,3,6,0.7478661741670161,"[0, 1, 0, 0, 1, 1, 0, 1, 1, 1]"
7464,1,1,2,0.7437676968066365,"[0, 0, 1, 0, 0, 0, 1, 0, 0, 1]"
7465,1,1,2,0.3631431632719381,"[1, 1, 1, 1, 1, 0, 0, 0, 0, 1]"
7466,1,1,2,0.5971649184170367,"[0, 1, 0, 1, 0, 1, 1, 1, 0, 1]"
7467,5,5,10,0.8505803585374563,"[1, 1, 1, 1, 1, 0, 1, 0, 0, 0]"
7468,1,1,2,0.5274779061114782,"[1, 0, 0, 0, 0, 0, 1, 0, 1, 0]"
7469,1,1,2,0.37065380325148056,"[1, 1, 1, 0, 0, 1, 0, 0, 1, 1]"
7470,1,1,2,0.5856776077478217,"[0, 0, 0, 1, 1, 1, 0, 1, 1, 0]"
7471,1,1,2,0.8382760647408887,"[0, 1, 0, 0, 1, 0, 1, 0, 1, 1]"
7472,1,1,2,0.14888894566920963,"[1, 1, 0, 1, 1, 1, 0, 0, 0, 0]"
7473,1,1,2,0.7608732145147079,"[0, 1, 1, 1, 0, 0, 0, 0, 0, 1]"
7474,1,1,2,0.7943094187268378,"[1, 0, 1, 0, 1, 1, 1, 0, 0, 0]"
7475,3,3,6,0.4420397625416408,"[0, 1, 0, 1, 1, 1, 0, 1, 1, 1]"
7476,3,3,6,0.4555767742949871,"[1, 0, 1, 1, 0, 1, 1, 0, 0, 1]"
7477,1,1,2,0.5017547564528986,"[0, 0, 0, 1, 0, 1, 1, 1, 0, 1]"
7478,1,1,2,0.025148031902207046,"[1, 1, 1, 1, 1, 1, 1, 0, 1, 1]"
7479,3,3,6,0.8627157320400888,"[1, 1, 0, 0, 1, 1, 1, 1, 0, 0]"
7480,1,1,2,0.2171211323125899,"[0, 1, 0, 0, 1, 1, 0, 0, 1, 1]"
7481,1,1,2,0.9345143969952575,"[1, 1, 1, 0, 0, 1, 1, 0, 0, 0]"
7482,1,1,2,0.5572927355616017,"[0, 0, 0, 1, 1, 1, 0, 0, 0, 0]"
7483,1,1,2,0.7562609661339458,"[0, 1, 0, 0, 0, 1, 1, 1, 0, 1]"
7484,1,1,2,0.22663926140613488,"[0, 0, 0, 1, 0, 1, 0, 0, 1, 1]"
7485,1,1,2,0.4131747856426399,"[1, 0, 0, 0, 0, 0, 0, 0, 1, 1]"
7486,1,1,2,0.19469402813551429,"[1, 1, 0, 0, 0, 1, 1, 1, 0, 1]"
7487,1,1,2,0.33612396972802405,"[0, 1, 0, 1, 0, 0, 1, 0, 1, 1]"
7488,1,1,2,0.3669761201826941,"[0, 0, 1, 0, 0, 1, 1, 1, 1, 0]"
7489,2,2,4,0.3288003460256548,"[1, 0, 1, 1, 1, 0, 1, 1, 1, 1]"
7490,3,3,6,0.4476147956207621,"[1, 0, 1, 0, 1, 0, 1, 0, 0, 0]"
7491,1,1,2,0.36266327249117414,"[1, 0, 1, 1, 1, 0, 1, 1, 0, 1]"
7492,2,2,4,0.17378478921664264,"[1, 1, 1, 1, 0, 0, 1, 1, 1, 1]"
7493,1,1,2,0.07166452632539266,"[1, 0, 1, 1, 1, 0, 1, 1, 1, 1]"
7494,1,1,2,0.6502415069793859,"[1, 0, 0, 1, 0, 0, 0, 1, 0, 1]"
7495,2,2,4,0.09547472269080626,"[1, 1, 1, 1, 1, 1, 1, 1, 1, 1]"
7496,1,1,2,0.9191060241538118,"[0, 1, 1, 1, 1, 0, 1, 1, 0, 0]"
7497,1,1,2,0.7425292305610477,"[1, 0, 0, 0, 1, 1, 0, 0, 1, 0]"
7498,1,1,2,0.23215583953985153,"[0, 1, 1, 1, 1, 1, 0, 1, 1, 0]"
7499,2,2,4,0.7318138126617417,"[0, 1, 0, 0, 1, 0, 1, 1, 0, 1]"
7500,1,1,2,0.17832872182981152,"[0, 0, 1, 1, 1, 0, 1, 0, 0, 1]"
7501,1,1,2,0.7870174036131058,"[1, 0, 1, 0, 0, 0, 0, 1, 0, 0]"
7502,1,1,2,0.4173806125492059,"[0, 1, 0, 0, 1, 0, 1, 1, 1, 1]"
7503,1,1,2,0.893674914086885,"[0, 1, 1, 0, 0, 1, 1, 0, 0, 0]"
7504,1,1,2,0.08109109227296707,"[1, 1, 1, 1, 1, 0, 0, 1, 1, 1]"
7505,1,1,2,0.9144937541063054,"[1, 0, 1, 0, 0, 0, 0, 0, 1, 0]"
7506,2,2,4,0.8281544414484866,"[1, 0, 0, 0, 0, 0, 1, 0, 0, 0]"
7507,1,1,2,0.8069651608239349,"[0, 1, 1, 1, 1, 0, 0, 0, 0, 1]"
7508,1,1,2,0.9305001182670407,"[0, 0, 1, 0, 0, 0, 1, 0, 1, 1]"
7509,1,1,2,0.04463116049889859,"[1, 0, 1, 0, 0, 0, 1, 0, 0, 1]"
7510,2,2,4,0.42488590870586396,"[1, 1, 1, 1, 0, 0, 1, 1, 0, 1]"
7511,2,2,4,0.49757404109605907,"[0, 1, 0, 0, 0, 0, 0, 0, 1, 0]"
7512,1,1,2,0.36014888993007743,"[1, 1, 0, 1, 1, 0, 0, 1, 1, 1]"
7513,1,1,2,0.7396666513589462,"[0, 0, 1, 0, 1, 1, 1, 1, 0, 0]"
7514,3,3,6,0.23529399394597617,"[0, 1, 1, 1, 1, 0, 0, 1, 1, 1]"
7515,1,1,2,0.9786764956030857,"[0, 1, 1, 1, 0, 0, 1, 0, 0, 0]"
7516,2,2,4,0.5961670092582934,"[1, 0, 0, 1, 1, 0, 1, 0, 0, 1]"
7517,2,2,4,0.7797224554938774,"[1, 0, 0, 0, 1, 1, 1, 0, 0, 1]"
7518,3,3,6,0.10853069807555715,"[0, 0, 1, 0, 1, 1, 1, 1, 1, 0]"
7519,1,1,2,0.7927899200957291,"[0, 1, 0, 0, 0, 1, 1, 0, 0, 1]"
7520,1,1,2,0.4849529869839949,"[1, 1, 1, 0, 0, 1, 0, 1, 0, 0]"
7521,1,1,2,0.059276858078150085,"[0, 1, 1, 0, 1, 0, 1, 0, 1, 0]"
7522,1,1,2,0.6006594650911585,"[1, 1, 0, 0, 0, 0, 1, 0, 1, 0]"
7523,2,2,4,0.3664068403990647,"[1, 1, 0, 0, 0, 0, 1, 1, 0, 1]"
7524,1,1,2,0.2804561506581855,"[1, 0, 1, 1, 1, 1, 1, 0, 1, 0]"
7525,3,3,6,0.23323859732607666,"[0, 0, 0, 1, 1, 1, 1, 1, 1, 1]"
7526,2,2,4,0.9015427205199849,"[1, 1, 1, 0, 1, 1, 1, 1, 0, 0]"
7527,2,2,4,0.07288087940162236,"[0, 1, 0, 0, 0, 1, 0, 0, 1, 0]"
7528,2,2,4,0.12282141936568924,"[1, 1, 1, 0, 0, 0, 1, 1, 1, 1]"
7529,2,2,4,0.584335724153591,"[0, 0, 1, 1, 0, 1, 1, 1, 1, 1]"
7530,4,4,8,0.18292699091832554,"[0, 1, 0, 1, 0, 1, 1, 1, 1, 1]"
7531,2,2,4,0.7787506075225721,"[0, 0, 0, 0, 0, 0, 1, 1, 1, 0]"
7532,4,4,8,0.9892642619326815,"[1, 0, 1, 1, 0, 1, 1, 0, 0, 0]"
7533,1,1,2,0.7598333814320901,"[1, 0, 0, 0, 1, 1, 1, 1, 1, 0]"
7534,1,1,2,0.257717228840982,"[1, 1, 0, 1, 0, 0, 1, 1, 0, 1]"
7535,1,1,2,0.2684132567502482,"[1, 0, 0, 1, 1, 1, 0, 1, 1, 0]"
7536,2,2,4,0.4873001571019011,"[0, 0, 1, 1, 0, 1, 1, 0, 0, 0]"
7537,2,2,4,0.7326583743188506,"[1, 0, 0, 1, 0, 0, 1, 0, 1, 0]"
7538,1,1,2,0.9158934391266325,"[1, 0, 1, 1, 0, 0, 0, 0, 1, 1]"
7539,1,1,2,0.7130064916600544,"[1, 1, 0, 1, 1, 0, 0, 0, 0, 1]"
7540,1,1,2,0.3787898737167982,"[0, 1, 1, 0, 0, 1, 0, 1, 0, 0]"
7541,1,1,2,0.5773987778253672,"[0, 1, 0, 0, 1, 0, 0, 0, 1, 0]"
7542,1,1,2,0.9444937249193961,"[1, 0, 1, 0, 1, 1, 1, 1, 0, 1]"
7543,1,1,2,0.5949136808806889,"[1, 0, 0, 1, 1, 0, 1, 0, 1, 1]"
7544,1,1,2,0.9478141074816193,"[0, 0, 0, 1, 0, 0, 1, 0, 1, 0]"
7545,2,2,4,0.47406183327875706,"[0, 1, 1, 0, 1, 1, 1, 0, 1, 0]"
7546,1,1,2,0.7799631131740887,"[0, 1, 0, 0, 0, 1, 1, 0, 0, 0]"
7547,1,1,2,0.5131891296091508,"[0, 1, 1, 0, 0, 1, 1, 0, 1, 1]"
7548,1,1,2,0.45737714723646006,"[0, 0, 1, 0, 1, 1, 0, 1, 1, 0]"
7549,1,1,2,0.0007441251364959101,"[1, 1, 0, 0, 0, 0, 0, 0, 0, 1]"
7550,1,1,2,0.7606164145307891,"[0, 0, 0, 1, 0, 1, 0, 0, 1, 1]"
7551,1,1,2,0.6298918343688341,"[0, 0, 0, 1, 1, 1, 1, 0, 0, 0]"
7552,3,3,6,0.1474510164795293,"[0, 0, 0, 0, 1, 0, 1, 0, 1, 1]"
7553,3,3,6,0.4387402829234751,"[1, 1, 1, 0, 0, 1, 0, 1, 1, 0]"
7554,3,3,6,0.14054421133252715,"[0, 0, 1, 0, 1, 0, 1, 1, 0, 1]"
7555,1,1,2,0.9571719196616241,"[1, 1, 0, 0, 1, 1, 1, 0, 1, 1]"
7556,1,1,2,0.7638488790522419,"[0, 0, 0, 0, 0, 1, 1, 1, 1, 1]"
7557,2,2,4,0.3196933705735415,"[0, 1, 0, 1, 0, 1, 0, 0, 1, 1]"
7558,1,1,2,0.6398692072933146,"[1, 1, 1, 1, 0, 0, 1, 0, 1, 1]"
7559,1,1,2,0.8558511900153616,"[1, 0, 1, 1, 1, 1, 0, 1, 1, 0]"
7560,1,1,2,0.31495181510496784,"[1, 1, 1, 0, 1, 0, 1, 1, 0, 0]"
7561,1,1,2,0.24701884445544964,"[1, 0, 0, 0, 1, 0, 0, 0, 0, 1]"
7562,1,1,2,0.7418953116029849,"[0, 0, 0, 0, 1, 0, 1, 1, 0, 1]"
7563,2,2,4,0.11655807485137504,"[0, 0, 1, 1, 1, 0, 0, 0, 0, 1]"
7564,2,2,4,0.26401718933524077,"[0, 0, 0, 1, 1, 1, 1, 1, 1, 0]"
7565,1,1,2,0.5654296435732379,"[0, 0, 0, 0, 1, 0, 0, 1, 1, 0]"
7566,1,1,2,0.7254346250319873,"[0, 0, 0, 1, 0, 1, 1, 1, 0, 0]"
7567,3,3,6,0.2556502157867294,"[1, 0, 1, 0, 1, 1, 1, 1, 0, 1]"
7568,4,4,8,0.8130876266888514,"[1, 1, 0, 1, 0, 1, 0, 1, 1, 0]"
7569,1,1,2,0.7642802548200461,"[1, 0, 0, 1, 1, 1, 0, 1, 1, 1]"
7570,1,1,2,0.17097808548045335,"[0, 1, 0, 0, 1, 0, 0, 1, 0, 0]"
7571,1,1,2,0.9454947823408762,"[1, 1, 0, 0, 1, 0, 0, 1, 1, 0]"
7572,2,2,4,0.9115970233312521,"[1, 1, 1, 0, 0, 1, 1, 0, 0, 0]"
7573,1,1,2,0.0662740934644438,"[0, 1, 0, 1, 0, 0, 0, 1, 1, 1]"
7574,1,1,2,0.32512347790271023,"[1, 0, 1, 1, 1, 1, 1, 1, 0, 1]"
7575,4,4,8,0.17727801818773392,"[1, 0, 0, 0, 1, 1, 1, 0, 1, 1]"
7576,4,4,8,0.5350933023793543,"[0, 0, 1, 0, 1, 0, 1, 0, 0, 1]"
7577,1,1,2,0.5221425859040217,"[1, 1, 1, 0, 0, 0, 0, 1, 1, 1]"
7578,1,1,2,0.264771533650038,"[1, 0, 0, 1, 0, 0, 0, 1, 1, 1]"
7579,1,1,2,0.7933580553136552,"[0, 1, 0, 0, 0, 0, 0, 1, 1, 1]"
7580,1,1,2,0.8368455703004886,"[1, 0, 1, 0, 0, 1, 0, 1, 0, 1]"
7581,1,1,2,0.7798388779553268,"[0, 1, 1, 1, 0, 0, 0, 0, 0, 0]"
7582,1,1,2,0.9179512747230847,"[0, 0, 1, 0, 1, 0, 1, 0, 1, 1]"
7583,1,1,2,0.06432669053129669,"[0, 1, 0, 0, 0, 1, 1, 1, 0, 0]"
7584,2,2,4,0.1463788119120084,"[0, 1, 0, 0, 1, 1, 0, 1, 0, 0]"
7585,2,2,4,0.4604752658457204,"[0, 0, 1, 1, 1, 1, 0, 0, 0, 1]"
7586,1,1,2,0.046337734056749236,"[0, 0, 1, 1, 1, 1, 0, 1, 0, 1]"
7587,1,1,2,0.1153390580629221,"[0, 0, 1, 0, 1, 1, 1, 1, 1, 0]"
7588,3,3,6,0.8727528448478091,"[1, 0, 0, 0, 0, 1, 1, 0, 1, 0]"
7589,3,3,6,0.22533254715648088,"[0, 0, 1, 1, 0, 0, 1, 0, 0, 0]"
7590,1,1,2,0.21882996238993757,"[1, 0, 1, 0, 1, 1, 0, 0, 1, 1]"
7591,1,1,2,0.968980829464008,"[0, 1, 0, 1, 1, 0, 0, 1, 1, 1]"
7592,3,3,6,0.0760946133895396,"[1, 0, 1, 1, 0, 1, 1, 1, 1, 0]"
7593,4,4,8,0.8747231035300097,"[1, 1, 1, 1, 0, 1, 1, 1, 0, 0]"
7594,1,1,2,0.43708869320084676,"[1, 1, 0, 1, 0, 1, 0, 1, 1, 0]"
7595,1,1,2,0.5021314504605645,"[0, 1, 0, 1, 0, 0, 1, 1, 1, 1]"
7596,1,1,2,0.8269975348621719,"[0, 0, 0, 1, 0, 1, 1, 0, 1, 0]"
7597,2,2,4,0.5656218224655203,"[0, 1, 1, 0, 0, 1, 0, 1, 0, 1]"
7598,1,1,2,0.7384397396083199,"[0, 0, 0, 1, 0, 0, 0, 0, 1, 0]"
7599,1,1,2,0.34132116895395437,"[0, 1, 0, 1, 0, 0, 1, 1, 0, 1]"
7600,1,1,2,0.5007544027088826,"[1, 0, 0, 1, 0, 0, 1, 0, 0, 1]"
7601,2,2,4,0.961019130699549,"[0, 1, 1, 1, 1, 1, 0, 0, 0, 1]"
7602,1,1,2,0.21748495789864675,"[0, 1, 1, 0, 1, 0, 0, 1, 0, 1]"
7603,1,1,2,0.5904943946041095,"[0, 1, 0, 0, 0, 0, 1, 1, 0, 0]"
7604,2,2,4,0.5174424439484413,"[0, 0, 1, 0, 1, 1, 1, 1, 0, 1]"
7605,2,2,4,0.6674056165621378,"[1, 1, 1, 1, 0, 1, 0, 0, 0, 1]"
7606,1,1,2,0.5491573162472557,"[1, 0, 1, 1, 0, 0, 0, 0, 1, 1]"
7607,3,3,6,0.45855337881537306,"[0, 0, 0, 0, 1, 1, 0, 1, 0, 0]"
7608,1,1,2,0.052884780345320626,"[1, 1, 1, 1, 1, 0, 1, 1, 0, 1]"
7609,1,1,2,0.6935723337898224,"[1, 0, 0, 0, 0, 1, 1, 1, 1, 1]"
7610,1,1,2,0.37194364678590486,"[0, 0, 0, 1, 1, 1, 0, 1, 0, 0]"
7611,1,1,2,0.25404079762486764,"[0, 0, 1, 1, 0, 1, 1, 1, 0, 1]"
7612,2,2,4,0.7340653603084645,"[0, 1, 0, 0, 0, 0, 1, 0, 0, 1]"
7613,1,1,2,0.8522001479856666,"[0, 0, 0, 0, 1, 1, 1, 0, 0, 0]"
7614,2,2,4,0.5935067664714849,"[0, 0, 0, 1, 0, 0, 0, 1, 1, 1]"
7615,2,2,4,0.5846740689647603,"[1, 0, 0, 0, 1, 0, 1, 1, 1, 1]"
7616,1,1,2,0.16512494585311055,"[1, 0, 0, 1, 1, 0, 1, 0, 1, 1]"
7617,1,1,2,0.9851775351087229,"[0, 0, 1, 0, 0, 1, 1, 1, 1, 1]"
7618,1,1,2,0.7526447732077789,"[1, 1, 1, 0, 0, 0, 1, 0, 1, 0]"
7619,1,1,2,0.11440085274466683,"[1, 0, 0, 0, 0, 1, 0, 1, 0, 1]"
7620,2,2,4,0.9465140855389269,"[0, 0, 0, 0, 0, 0, 0, 1, 0, 1]"
7621,1,1,2,0.7446578759812023,"[0, 0, 0, 0, 0, 0, 0, 0, 1, 1]"
7622,1,1,2,0.701700869886804,"[0, 1, 1, 0, 0, 0, 0, 0, 1, 0]"
7623,2,2,4,0.9864285988029557,"[1, 1, 1, 0, 0, 1, 0, 0, 0, 1]"
7624,1,1,2,0.9652863968668253,"[0, 0, 0, 1, 1, 0, 1, 0, 0, 0]"
7625,1,1,2,0.07027878312343849,"[1, 0, 1, 0, 0, 0, 1, 1, 1, 1]"
7626,1,1,2,0.02789927611038856,"[0, 0, 1, 0, 0, 0, 0, 0, 1, 1]"
7627,1,1,2,0.6289163806716924,"[1, 0, 1, 0, 0, 0, 0, 0, 1, 0]"
7628,2,2,4,0.5364757215925341,"[0, 1, 0, 0, 0, 1, 1, 0, 1, 0]"
7629,1,1,2,0.6763256681398508,"[1, 0, 0, 0, 0, 1, 0, 1, 1, 0]"
7630,2,2,4,0.9193658083300341,"[1, 1, 0, 0, 1, 1, 1, 1, 0, 1]"
7631,1,1,2,0.09302042354758422,"[0, 1, 1, 0, 0, 0, 1, 0, 1, 0]"
7632,3,3,6,0.8923053875353403,"[1, 1, 1, 1, 0, 0, 0, 0, 0, 1]"
7633,2,2,4,0.7239992743211857,"[0, 0, 0, 1, 1, 0, 1, 1, 0, 0]"
7634,2,2,4,0.3671850865280387,"[1, 1, 1, 0, 0, 1, 1, 0, 0, 0]"
7635,1,1,2,0.8774696377622602,"[0, 1, 1, 1, 1, 1, 0, 0, 1, 0]"
7636,1,1,2,0.8234290504463911,"[1, 0, 0, 1, 1, 0, 1, 1, 1, 1]"
7637,2,2,4,0.7544571403202878,"[1, 1, 0, 1, 1, 0, 1, 1, 1, 1]"
7638,1,1,2,0.5368895625888487,"[1, 1, 0, 0, 1, 0, 0, 0, 0, 0]"
7639,1,1,2,0.1257811778048601,"[0, 0, 1, 1, 1, 0, 1, 1, 0, 0]"
7640,1,1,2,0.9816356821698249,"[1, 1, 0, 1, 0, 1, 1, 0, 1, 1]"
7641,1,1,2,0.9392323417591847,"[1, 1, 1, 1, 1, 0, 0, 1, 1, 1]"
7642,1,1,2,0.8315655234002236,"[0, 1, 0, 0, 1, 1, 0, 0, 1, 1]"
7643,3,3,6,0.4630731550566909,"[0, 1, 0, 0, 0, 1, 0, 0, 1, 1]"
7644,1,1,2,0.7098230381170525,"[0, 0, 0, 0, 0, 1, 1, 0, 1, 1]"
7645,3,3,6,0.37068360316740556,"[0, 0, 1, 1, 1, 0, 0, 1, 1, 1]"
7646,1,1,2,0.5208473235574798,"[1, 0, 0, 1, 1, 0, 1, 0, 0, 0]"
7647,2,2,4,0.9288500051179566,"[0, 1, 0, 1, 0, 1, 0, 0, 1, 1]"
7648,3,3,6,0.9190844184363736,"[1, 1, 1, 0, 0, 1, 0, 0, 1, 1]"
7649,2,2,4,0.11374143848752083,"[0, 1, 1, 0, 0, 1, 1, 0, 1, 1]"
7650,6,6,12,0.7681481460998744,"[1, 1, 0, 0, 1, 1, 0, 0, 1, 0]"
7651,1,1,2,0.0032947737513095987,"[0, 1, 1, 1, 0, 1, 1, 0, 1, 0]"
7652,1,1,2,0.9556413645293242,"[0, 1, 0, 0, 0, 1, 1, 0, 1, 0]"
7653,2,2,4,0.36254427597510464,"[1, 1, 0, 0, 0, 0, 1, 0, 0, 1]"
7654,1,1,2,0.8727457716341502,"[1, 1, 0, 0, 1, 1, 0, 1, 1, 0]"
7655,1,1,2,0.5709609114334386,"[0, 0, 1, 1, 1, 0, 1, 0, 1, 1]"
7656,1,1,2,0.20763716978953417,"[0, 1, 0, 0, 0, 0, 0, 1, 1, 1]"
7657,2,2,4,0.4767235945366487,"[1, 1, 1, 0, 0, 0, 0, 0, 1, 1]"
7658,1,1,2,0.5633405822840061,"[1, 0, 0, 0, 0, 0, 1, 0, 1, 1]"
7659,1,1,2,0.4314309203444202,"[1, 1, 1, 1, 0, 0, 1, 0, 1, 0]"
7660,3,3,6,0.7570351240521778,"[1, 0, 1, 0, 1, 0, 1, 1, 0, 0]"
7661,1,1,2,0.5493233054576896,"[1, 1, 0, 0, 1, 0, 1, 0, 1, 0]"
7662,1,1,2,0.9922206116879616,"[1, 1, 1, 1, 1, 1, 1, 1, 1, 1]"
7663,1,1,2,0.9438375539118357,"[1, 0, 1, 1, 0, 0, 1, 1, 0, 0]"
7664,1,1,2,0.6579010213509545,"[1, 1, 1, 1, 0, 0, 1, 0, 0, 0]"
7665,1,1,2,0.20911248379732994,"[1, 0, 1, 0, 0, 1, 0, 1, 1, 1]"
7666,1,1,2,0.48177147020295297,"[1, 0, 0, 0, 0, 1, 0, 0, 0, 0]"
7667,1,1,2,0.786584191323055,"[0, 1, 1, 0, 1, 0, 1, 1, 1, 1]"
7668,1,1,2,0.616089157991139,"[1, 0, 0, 0, 0, 1, 1, 0, 0, 0]"
7669,1,1,2,0.5035987986178913,"[1, 1, 1, 1, 1, 1, 1, 1, 0, 0]"
7670,1,1,2,0.061354624134122626,"[0, 1, 1, 0, 0, 1, 0, 1, 0, 0]"
7671,2,2,4,0.6248391027480894,"[1, 0, 1, 0, 0, 1, 0, 0, 1, 1]"
7672,1,1,2,0.8751561548988978,"[0, 0, 1, 1, 1, 0, 1, 0, 1, 0]"
7673,4,4,8,0.9412642486984817,"[1, 0, 0, 0, 0, 1, 0, 1, 1, 1]"
7674,2,2,4,0.11710034222127463,"[0, 0, 1, 0, 0, 0, 0, 1, 1, 1]"
7675,1,1,2,0.06828345482072629,"[0, 1, 1, 0, 0, 1, 1, 0, 1, 1]"
7676,1,1,2,0.8617765458323283,"[1, 1, 0, 0, 1, 0, 0, 1, 0, 1]"
7677,1,1,2,0.8038950138731907,"[1, 0, 1, 0, 0, 0, 0, 1, 0, 1]"
7678,2,2,4,0.084523869580311,"[1, 1, 0, 1, 1, 1, 1, 1, 1, 0]"
7679,1,1,2,0.9449170657029601,"[1, 1, 1, 1, 0, 0, 0, 0, 0, 1]"
7680,1,1,2,0.6801437057753145,"[1, 1, 0, 1, 0, 0, 0, 0, 1, 0]"
7681,1,1,2,0.6357102841868552,"[1, 1, 0, 0, 0, 1, 1, 0, 1, 1]"
7682,5,5,10,0.6457896658045521,"[0, 0, 1, 1, 1, 1, 0, 1, 1, 1]"
7683,1,1,2,0.02587249887983145,"[0, 0, 0, 0, 1, 1, 0, 1, 0, 0]"
7684,1,1,2,0.6074110874678695,"[1, 0, 1, 0, 0, 0, 0, 1, 1, 1]"
7685,1,1,2,0.030598184043174048,"[1, 1, 0, 1, 1, 1, 0, 0, 0, 0]"
7686,1,1,2,0.9100720570120244,"[1, 0, 1, 1, 0, 0, 0, 1, 1, 1]"
7687,2,2,4,0.008747803884397887,"[1, 0, 0, 0, 1, 1, 0, 0, 1, 1]"
7688,1,1,2,0.3925062531184521,"[0, 1, 0, 0, 0, 1, 1, 1, 0, 0]"
7689,2,2,4,0.7391403685720144,"[1, 0, 0, 0, 0, 1, 1, 1, 0, 0]"
7690,1,1,2,0.35186850646344936,"[0, 1, 1, 0, 0, 1, 0, 0, 0, 1]"
7691,2,2,4,0.8958488779390041,"[1, 1, 0, 1, 1, 1, 1, 0, 1, 1]"
7692,1,1,2,0.32193134657287104,"[0, 0, 1, 0, 0, 0, 1, 1, 1, 0]"
7693,1,1,2,0.38893399524002736,"[1, 1, 0, 1, 1, 1, 0, 1, 0, 0]"
7694,2,2,4,0.6116449369720549,"[0, 1, 1, 1, 0, 0, 1, 0, 0, 1]"
7695,1,1,2,0.7763539940644396,"[0, 1, 0, 1, 0, 0, 0, 1, 0, 0]"
7696,1,1,2,0.21666173145373768,"[0, 0, 1, 0, 0, 0, 1, 1, 1, 0]"
7697,2,2,4,0.8660456650004806,"[1, 0, 1, 0, 0, 1, 1, 0, 0, 1]"
7698,1,1,2,0.29345204818158666,"[0, 0, 1, 0, 0, 0, 1, 1, 0, 1]"
7699,1,1,2,0.6644597419187399,"[0, 0, 0, 1, 0, 0, 0, 0, 0, 1]"
7700,1,1,2,0.6343733898458708,"[0, 1, 1, 1, 1, 0, 1, 0, 0, 0]"
7701,1,1,2,0.8067831287443598,"[1, 0, 0, 0, 0, 0, 0, 0, 1, 1]"
7702,2,2,4,0.4535281942454188,"[0, 1, 1, 0, 0, 1, 1, 0, 1, 1]"
7703,1,1,2,0.7409818723580921,"[0, 0, 0, 1, 1, 0, 1, 1, 0, 0]"
7704,3,3,6,0.9933358845960313,"[1, 1, 1, 1, 1, 0, 0, 1, 1, 0]"
7705,1,1,2,0.36976135817294553,"[1, 0, 0, 0, 0, 1, 0, 0, 1, 0]"
7706,1,1,2,0.892677040670641,"[0, 0, 0, 0, 0, 0, 0, 1, 1, 0]"
7707,1,1,2,0.4343301915523192,"[1, 0, 0, 0, 0, 1, 0, 0, 1, 1]"
7708,1,1,2,0.49361142445047845,"[1, 1, 1, 1, 1, 1, 0, 1, 0, 1]"
7709,1,1,2,0.7188023309657803,"[1, 1, 0, 1, 1, 1, 1, 1, 1, 0]"
7710,2,2,4,0.6937263994474008,"[0, 0, 1, 1, 1, 1, 0, 0, 0, 1]"
7711,1,1,2,0.7809214574877332,"[1, 0, 1, 1, 1, 1, 1, 1, 1, 0]"
7712,1,1,2,0.10468060056009443,"[0, 0, 0, 0, 1, 0, 1, 1, 0, 0]"
7713,1,1,2,0.6096747535707423,"[1, 0, 0, 1, 1, 0, 1, 0, 0, 1]"
7714,1,1,2,0.8125870404461767,"[1, 0, 0, 0, 0, 0, 1, 0, 0, 1]"
7715,1,1,2,0.34580493855627015,"[0, 1, 1, 0, 0, 0, 1, 1, 0, 0]"
7716,1,1,2,0.20120865441061375,"[0, 1, 0, 0, 1, 0, 1, 0, 0, 0]"
7717,1,1,2,0.23549572791512308,"[0, 0, 1, 0, 1, 0, 0, 0, 0, 0]"
7718,1,1,2,0.9537540637904792,"[0, 0, 0, 0, 0, 0, 0, 1, 1, 0]"
7719,1,1,2,0.26781618331079904,"[0, 1, 0, 1, 1, 0, 1, 1, 0, 1]"
7720,1,1,2,0.05161118106481577,"[1, 1, 0, 0, 1, 1, 0, 0, 1, 1]"
7721,1,1,2,0.33265368460589284,"[0, 1, 1, 0, 0, 0, 1, 1, 0, 0]"
7722,3,3,6,0.9021048874627737,"[1, 0, 1, 1, 0, 0, 1, 1, 1, 1]"
7723,1,1,2,0.7450579345609222,"[0, 0, 1, 0, 0, 1, 1, 0, 1, 0]"
7724,1,1,2,0.5319073437125964,"[0, 0, 0, 1, 0, 0, 0, 0, 0, 0]"
7725,4,4,8,0.08490833543078868,"[1, 0, 0, 1, 0, 1, 1, 1, 0, 1]"
7726,1,1,2,0.5600587995470414,"[0, 0, 0, 0, 1, 0, 1, 0, 1, 1]"
7727,1,1,2,0.068474870030237,"[0, 0, 0, 1, 1, 1, 1, 1, 1, 0]"
7728,2,2,4,0.2669857899049489,"[0, 0, 1, 1, 0, 0, 1, 0, 1, 1]"
7729,2,2,4,0.4335422084263192,"[1, 0, 0, 1, 1, 1, 1, 1, 1, 0]"
7730,2,2,4,0.6326193467605343,"[1, 0, 1, 0, 0, 1, 0, 1, 1, 1]"
7731,1,1,2,0.8344522327410525,"[1, 0, 1, 0, 0, 1, 0, 0, 0, 0]"
7732,1,1,2,0.48553081532090425,"[1, 1, 1, 0, 1, 1, 1, 1, 1, 1]"
7733,2,2,4,0.5489002823274359,"[1, 1, 1, 0, 0, 1, 0, 0, 1, 1]"
7734,1,1,2,0.5456035167001161,"[1, 0, 1, 1, 1, 1, 1, 1, 0, 0]"
7735,1,1,2,0.24774757206739206,"[0, 0, 0, 1, 0, 0, 0, 1, 1, 1]"
7736,1,1,2,0.5830864241862587,"[0, 1, 0, 1, 0, 0, 1, 1, 1, 1]"
7737,3,3,6,0.5213123759960013,"[0, 1, 0, 1, 1, 1, 0, 0, 1, 1]"
7738,1,1,2,0.2992126962882805,"[1, 0, 0, 1, 1, 0, 1, 1, 0, 1]"
7739,4,4,8,0.17345280606253666,"[1, 0, 0, 1, 1, 0, 1, 0, 0, 0]"
7740,3,3,6,0.3574577087326364,"[1, 1, 1, 1, 0, 0, 0, 1, 1, 0]"
7741,4,4,8,0.5885141494132465,"[1, 1, 1, 0, 1, 0, 1, 1, 0, 1]"
7742,1,1,2,0.2432250016284604,"[1, 0, 1, 0, 0, 0, 1, 0, 0, 1]"
7743,1,1,2,0.8987773408938068,"[0, 0, 0, 0, 0, 1, 0, 1, 0, 0]"
7744,1,1,2,0.7271708629141621,"[0, 0, 1, 1, 1, 0, 0, 1, 1, 1]"
7745,1,1,2,0.9833145044984084,"[0, 1, 0, 1, 0, 1, 0, 0, 1, 1]"
7746,2,2,4,0.24817114740692292,"[1, 1, 1, 0, 0, 1, 1, 0, 0, 0]"
7747,2,2,4,0.6606882111860437,"[1, 0, 1, 1, 0, 0, 0, 0, 1, 1]"
7748,1,1,2,0.38252860908357145,"[1, 1, 0, 0, 0, 1, 0, 0, 0, 0]"
7749,1,1,2,0.8779584586529634,"[1, 0, 1, 0, 1, 1, 0, 0, 0, 1]"
7750,1,1,2,0.9052229613368777,"[1, 1, 1, 0, 0, 0, 1, 1, 0, 0]"
7751,1,1,2,0.4053502169765203,"[0, 0, 0, 1, 0, 0, 0, 1, 1, 1]"
7752,1,1,2,0.40878653691161737,"[1, 0, 0, 0, 1, 0, 0, 1, 0, 0]"
7753,2,2,4,0.9163292255630714,"[1, 1, 1, 1, 0, 0, 0, 0, 0, 0]"
7754,2,2,4,0.11636237365199731,"[1, 1, 0, 0, 1, 0, 0, 0, 0, 1]"
7755,2,2,4,0.5143362672383643,"[1, 1, 1, 1, 1, 1, 0, 1, 0, 0]"
7756,2,2,4,0.5171117048859839,"[1, 0, 1, 0, 1, 0, 1, 1, 0, 0]"
7757,2,2,4,0.5639871392084586,"[1, 0, 1, 1, 0, 1, 1, 0, 0, 0]"
7758,1,1,2,0.7835977075467979,"[0, 1, 1, 1, 0, 0, 1, 0, 0, 1]"
7759,1,1,2,0.28516355991634856,"[0, 0, 1, 0, 0, 0, 0, 0, 1, 0]"
7760,1,1,2,0.3428288153017852,"[1, 0, 1, 0, 0, 1, 0, 0, 1, 1]"
7761,3,3,6,0.5453382009531462,"[0, 0, 0, 1, 1, 1, 0, 1, 0, 1]"
7762,1,1,2,0.9206555899121581,"[1, 0, 1, 1, 0, 1, 1, 0, 0, 1]"
7763,1,1,2,0.45038499781871455,"[0, 1, 0, 0, 1, 0, 1, 0, 0, 1]"
7764,2,2,4,0.10175107239885406,"[0, 0, 0, 0, 1, 1, 0, 0, 0, 1]"
7765,4,4,8,0.7854822997574745,"[0, 1, 1, 0, 0, 1, 0, 1, 1, 1]"
7766,1,1,2,0.2941590282372465,"[0, 1, 0, 0, 0, 1, 1, 1, 0, 1]"
7767,2,2,4,0.13975864464073262,"[1, 0, 0, 1, 1, 1, 1, 0, 0, 0]"
7768,1,1,2,0.3100930575450366,"[0, 0, 1, 1, 0, 0, 0, 1, 0, 0]"
7769,1,1,2,0.15692660176689877,"[1, 1, 0, 1, 0, 0, 0, 1, 1, 1]"
7770,1,1,2,0.5557048288121882,"[0, 0, 0, 0, 1, 1, 1, 1, 1, 1]"
7771,1,1,2,0.033478995722056704,"[0, 1, 0, 1, 1, 0, 0, 0, 1, 1]"
7772,2,2,4,0.25624405410228,"[1, 1, 0, 0, 0, 1, 0, 1, 1, 1]"
7773,1,1,2,0.7122162431482837,"[0, 0, 0, 1, 1, 0, 0, 0, 0, 0]"
7774,2,2,4,0.8120484030207324,"[1, 0, 0, 1, 1, 0, 1, 0, 1, 1]"
7775,3,3,6,0.7020827923460804,"[1, 1, 1, 1, 0, 0, 1, 1, 0, 1]"
7776,1,1,2,0.9333729492220773,"[1, 0, 1, 1, 1, 1, 1, 0, 0, 0]"
7777,4,4,8,0.9019570508225453,"[1, 1, 1, 0, 1, 0, 1, 1, 1, 0]"
7778,2,2,4,0.3363782219039839,"[1, 1, 1, 1, 1, 0, 1, 0, 1, 0]"
7779,1,1,2,0.776269959472329,"[0, 1, 0, 0, 0, 1, 0, 0, 1, 1]"
7780,2,2,4,0.5181092325349812,"[0, 0, 0, 0, 0, 0, 0, 1, 0, 1]"
7781,1,1,2,0.8096119454194376,"[1, 1, 0, 0, 0, 1, 0, 1, 0, 1]"
7782,2,2,4,0.13042737465157817,"[1, 1, 1, 0, 0, 0, 0, 1, 1, 0]"
7783,1,1,2,0.17743233753873755,"[0, 0, 0, 0, 1, 0, 0, 0, 1, 1]"
7784,1,1,2,0.08183696737004142,"[1, 0, 0, 0, 0, 0, 0, 1, 1, 0]"
7785,1,1,2,0.6728766849021629,"[1, 0, 0, 0, 1, 0, 1, 0, 1, 0]"
7786,2,2,4,0.2155963991591321,"[1, 0, 0, 1, 0, 1, 1, 0, 0, 0]"
7787,1,1,2,0.9374133961360037,"[1, 1, 1, 0, 1, 0, 1, 0, 1, 1]"
7788,1,1,2,0.8502186465011767,"[1, 0, 1, 0, 1, 0, 0, 1, 0, 0]"
7789,2,2,4,0.24644639596359197,"[1, 1, 0, 1, 0, 1, 1, 1, 0, 0]"
7790,2,2,4,0.9627592114482341,"[1, 0, 1, 0, 1, 0, 0, 0, 0, 0]"
7791,1,1,2,0.7537023375108884,"[0, 0, 1, 1, 0, 0, 1, 1, 1, 0]"
7792,2,2,4,0.8838711238138134,"[0, 0, 0, 1, 1, 1, 0, 1, 0, 1]"
7793,1,1,2,0.21156011445574807,"[1, 1, 1, 0, 1, 1, 0, 0, 0, 0]"
7794,1,1,2,0.9902472298387575,"[1, 1, 1, 0, 1, 1, 1, 0, 1, 0]"
7795,1,1,2,0.13856652907023248,"[1, 0, 0, 1, 1, 1, 1, 0, 1, 0]"
7796,1,1,2,0.9042834074642679,"[0, 1, 0, 1, 0, 1, 0, 0, 1, 0]"
7797,2,2,4,0.5246443374030837,"[1, 1, 0, 0, 0, 0, 0, 0, 0, 0]"
7798,1,1,2,0.8447976721470166,"[1, 0, 0, 1, 0, 0, 0, 1, 0, 0]"
7799,1,1,2,0.17710868372965693,"[1, 1, 0, 1, 0, 0, 1, 1, 0, 0]"
7800,1,1,2,0.6633660627237573,"[0, 0, 0, 1, 1, 1, 1, 1, 0, 0]"
7801,1,1,2,0.19657701623577495,"[0, 1, 1, 0, 0, 1, 1, 1, 0, 0]"
7802,1,1,2,0.5917055037998046,"[0, 1, 0, 1, 0, 1, 1, 1, 1, 0]"
7803,2,2,4,0.3594641300556026,"[1, 0, 1, 0, 1, 1, 1, 1, 0, 1]"
7804,1,1,2,0.26407935590778864,"[1, 0, 1, 1, 1, 0, 0, 1, 0, 0]"
7805,1,1,2,0.09992221293750725,"[0, 0, 0, 0, 0, 1, 0, 1, 0, 1]"
7806,2,2,4,0.6682368576485703,"[1, 0, 0, 0, 0, 1, 0, 1, 1, 1]"
7807,1,1,2,0.7092697121900872,"[0, 0, 1, 1, 0, 1, 0, 1, 0, 1]"
7808,1,1,2,0.6646466849457149,"[1, 1, 0, 0, 0, 0, 0, 1, 0, 0]"
7809,3,3,6,0.22041208982865323,"[0, 1, 0, 0, 1, 1, 0, 0, 1, 0]"
7810,1,1,2,0.7682061101112873,"[0, 0, 0, 0, 1, 1, 1, 1, 1, 0]"
7811,1,1,2,0.21256656207463642,"[1, 0, 1, 0, 0, 1, 1, 0, 0, 1]"
7812,1,1,2,0.47424190844874614,"[0, 0, 1, 0, 0, 0, 0, 0, 1, 0]"
7813,1,1,2,0.6335974289747187,"[1, 0, 0, 1, 0, 1, 0, 0, 0, 1]"
7814,1,1,2,0.844713407392504,"[0, 1, 0, 1, 0, 0, 0, 0, 1, 0]"
7815,1,1,2,0.36480302383453145,"[1, 1, 0, 1, 1, 0, 0, 1, 0, 1]"
7816,1,1,2,0.5966883974512894,"[1, 1, 1, 1, 1, 0, 0, 1, 1, 1]"
7817,2,2,4,0.3796942447445414,"[1, 1, 1, 1, 0, 0, 0, 0, 1, 1]"
7818,2,2,4,0.4882713737607237,"[1, 1, 1, 0, 0, 1, 0, 1, 1, 0]"
7819,1,1,2,0.48922828077939784,"[1, 1, 1, 1, 0, 0, 1, 1, 1, 1]"
7820,1,1,2,0.42380566778669226,"[0, 0, 0, 1, 0, 1, 0, 0, 0, 1]"
7821,1,1,2,0.049341420747476494,"[1, 0, 1, 0, 0, 0, 1, 1, 0, 0]"
7822,2,2,4,0.43915064451677355,"[0, 0, 1, 1, 0, 1, 0, 0, 1, 1]"
7823,3,3,6,0.6201370010473878,"[0, 0, 0, 0, 0, 1, 1, 1, 1, 1]"
7824,1,1,2,0.7532003854901056,"[1, 0, 1, 0, 1, 1, 0, 1, 0, 1]"
7825,1,1,2,0.0038273882265436043,"[1, 1, 1, 0, 1, 1, 1, 0, 0, 0]"
7826,2,2,4,0.5412060687368575,"[0, 0, 0, 0, 0, 1, 1, 1, 1, 0]"
7827,2,2,4,0.3818262919941571,"[1, 1, 1, 0, 0, 1, 1, 0, 0, 1]"
7828,1,1,2,0.8865608983995946,"[0, 1, 0, 0, 0, 0, 0, 0, 1, 1]"
7829,1,1,2,0.5903929371079196,"[1, 1, 0, 0, 0, 0, 1, 0, 0, 1]"
7830,1,1,2,0.37013569810060765,"[0, 1, 0, 1, 1, 1, 1, 0, 0, 1]"
7831,1,1,2,0.6432626531967892,"[1, 0, 1, 0, 1, 1, 0, 0, 1, 1]"
7832,2,2,4,0.10387901034155533,"[1, 1, 0, 1, 1, 1, 1, 0, 1, 0]"
7833,1,1,2,0.0487234637666879,"[1, 0, 1, 1, 0, 1, 1, 0, 0, 0]"
7834,1,1,2,0.8767309197526048,"[0, 1, 0, 1, 1, 0, 1, 0, 1, 1]"
7835,1,1,2,0.8859376796136155,"[0, 0, 0, 1, 0, 1, 0, 1, 0, 1]"
7836,2,2,4,0.5236989204426996,"[0, 0, 1, 1, 1, 0, 0, 1, 1, 0]"
7837,2,2,4,0.5076294357501846,"[1, 1, 1, 0, 0, 0, 0, 0, 0, 1]"
7838,1,1,2,0.3758327522179312,"[1, 1, 1, 1, 1, 1, 0, 0, 1, 0]"
7839,1,1,2,0.8983298139081627,"[0, 1, 1, 1, 1, 0, 0, 0, 0, 0]"
7840,1,1,2,0.7461965067685496,"[0, 1, 1, 0, 0, 0, 1, 1, 1, 0]"
7841,5,5,10,0.7374899538686913,"[1, 0, 1, 0, 1, 0, 0, 1, 1, 1]"
7842,1,1,2,0.5013894072450746,"[0, 0, 0, 1, 1, 0, 0, 0, 1, 0]"
7843,1,1,2,0.7058729557259825,"[0, 0, 0, 0, 0, 0, 0, 1, 0, 0]"
7844,2,2,4,0.40168384165937887,"[0, 0, 0, 1, 1, 0, 1, 0, 1, 1]"
7845,1,1,2,0.6781969385189565,"[0, 0, 1, 1, 1, 1, 0, 0, 1, 0]"
7846,1,1,2,0.7794061271632641,"[0, 1, 1, 0, 0, 0, 0, 0, 1, 0]"
7847,4,4,8,0.17090277347424565,"[0, 0, 1, 0, 1, 1, 0, 0, 1, 1]"
7848,1,1,2,0.18887766044844567,"[0, 1, 1, 0, 0, 0, 1, 1, 1, 0]"
7849,1,1,2,0.9971586883871818,"[1, 1, 0, 0, 1, 1, 0, 1, 0, 1]"
7850,2,2,4,0.055251365526164276,"[0, 1, 1, 0, 1, 0, 1, 0, 1, 1]"
7851,2,2,4,0.10130067486167527,"[0, 0, 0, 1, 1, 0, 0, 0, 0, 1]"
7852,1,1,2,0.24182015316541117,"[0, 0, 0, 0, 0, 0, 0, 0, 1, 0]"
7853,1,1,2,0.5802841512053009,"[0, 0, 1, 1, 1, 0, 0, 0, 0, 1]"
7854,1,1,2,0.7331332964799265,"[1, 0, 1, 0, 1, 1, 0, 0, 0, 0]"
7855,2,2,4,0.9677805652015117,"[1, 0, 0, 1, 1, 0, 0, 1, 1, 1]"
7856,1,1,2,0.5824633737747978,"[0, 1, 1, 0, 0, 1, 0, 0, 1, 1]"
7857,1,1,2,0.4022753036892034,"[0, 1, 0, 0, 0, 1, 1, 0, 1, 0]"
7858,1,1,2,0.9364099821177829,"[1, 0, 0, 1, 1, 1, 0, 0, 1, 0]"
7859,2,2,4,0.904987935122809,"[0, 1, 0, 1, 1, 0, 0, 1, 0, 0]"
7860,1,1,2,0.7604966679491276,"[0, 1, 0, 0, 0, 0, 1, 0, 1, 0]"
7861,3,3,6,0.09296335145487555,"[0, 1, 1, 0, 1, 0, 1, 0, 1, 1]"
7862,1,1,2,0.7735469372125091,"[1, 1, 0, 0, 0, 1, 1, 1, 0, 0]"
7863,1,1,2,0.2815772542453664,"[1, 1, 0, 1, 1, 1, 0, 1, 1, 1]"
7864,2,2,4,0.49437221105170326,"[1, 1, 1, 1, 0, 0, 0, 0, 1, 1]"
7865,1,1,2,0.6941905917285911,"[0, 1, 1, 1, 1, 0, 0, 1, 0, 1]"
7866,1,1,2,0.5124664547628498,"[0, 0, 0, 0, 0, 1, 0, 1, 1, 1]"
7867,1,1,2,0.2694180279236904,"[1, 0, 1, 1, 1, 1, 0, 1, 1, 0]"
7868,1,1,2,0.5975379024510341,"[0, 1, 1, 0, 0, 0, 0, 1, 0, 1]"
7869,3,3,6,0.9928772379803872,"[1, 0, 1, 0, 0, 0, 0, 1, 1, 1]"
7870,1,1,2,0.7717978729222554,"[0, 1, 0, 1, 1, 0, 0, 0, 0, 0]"
7871,5,5,10,0.3433054357685563,"[1, 0, 1, 1, 1, 1, 0, 1, 0, 1]"
7872,1,1,2,0.14044421639184146,"[0, 1, 1, 1, 0, 0, 1, 1, 0, 0]"
7873,3,3,6,0.9298599420638225,"[0, 0, 0, 0, 1, 1, 1, 1, 0, 1]"
7874,1,1,2,0.06961537218585123,"[1, 0, 1, 1, 1, 1, 0, 1, 1, 0]"
7875,1,1,2,0.7992660789871073,"[1, 1, 0, 0, 1, 1, 1, 1, 0, 1]"
7876,2,2,4,0.8561919362298426,"[1, 1, 1, 1, 1, 0, 0, 1, 0, 1]"
7877,1,1,2,0.921664388137617,"[0, 0, 1, 1, 0, 0, 1, 1, 1, 1]"
7878,1,1,2,0.5983503158142227,"[1, 1, 0, 0, 0, 0, 1, 1, 1, 1]"
7879,2,2,4,0.6296012597884401,"[1, 0, 1, 0, 1, 1, 0, 0, 1, 0]"
7880,2,2,4,0.03493159211958374,"[1, 0, 0, 1, 0, 1, 1, 0, 1, 1]"
7881,1,1,2,0.22021895680289316,"[1, 0, 1, 1, 1, 0, 1, 1, 1, 0]"
7882,2,2,4,0.2711521860142794,"[0, 1, 1, 0, 1, 0, 1, 1, 0, 1]"
7883,1,1,2,0.5039472383486863,"[1, 0, 0, 0, 0, 0, 1, 1, 1, 1]"
7884,1,1,2,0.2146224435028159,"[1, 0, 0, 0, 1, 0, 0, 0, 0, 0]"
7885,1,1,2,0.7373067405859814,"[0, 1, 0, 1, 0, 0, 1, 1, 1, 0]"
7886,1,1,2,0.4682599209102618,"[0, 0, 1, 1, 0, 0, 0, 0, 1, 0]"
7887,2,2,4,0.04347008994585122,"[0, 0, 1, 1, 0, 1, 0, 1, 1, 0]"
7888,1,1,2,0.05501894173743216,"[0, 1, 0, 0, 1, 0, 0, 0, 1, 1]"
7889,2,2,4,0.2717909111815743,"[1, 0, 0, 1, 1, 0, 1, 1, 0, 0]"
7890,1,1,2,0.8857146322818148,"[1, 1, 0, 1, 1, 0, 0, 0, 0, 0]"
7891,2,2,4,0.4485552141110246,"[0, 1, 0, 1, 0, 0, 1, 0, 0, 1]"
7892,1,1,2,0.6999579131571627,"[1, 0, 0, 0, 0, 1, 1, 0, 0, 1]"
7893,1,1,2,0.8125480758518403,"[0, 0, 1, 1, 0, 0, 1, 1, 0, 0]"
7894,1,1,2,0.34198568811249064,"[1, 1, 0, 0, 0, 1, 0, 1, 1, 0]"
7895,1,1,2,0.9918420577117427,"[1, 0, 1, 0, 1, 1, 1, 0, 1, 0]"
7896,3,3,6,0.8896419840612566,"[0, 1, 0, 0, 0, 1, 0, 0, 0, 1]"
7897,2,2,4,0.08622900791780208,"[0, 0, 0, 1, 0, 1, 0, 0, 0, 1]"
7898,1,1,2,0.6275373570403883,"[1, 1, 1, 1, 0, 1, 1, 0, 1, 1]"
7899,1,1,2,0.7781374764841471,"[0, 1, 1, 0, 0, 0, 0, 1, 1, 0]"
7900,2,2,4,0.5158883091925084,"[1, 1, 1, 0, 0, 0, 0, 0, 1, 1]"
7901,2,2,4,0.41572150705319955,"[1, 0, 0, 1, 1, 0, 0, 1, 1, 1]"
7902,1,1,2,0.03367789219583839,"[1, 0, 1, 0, 1, 1, 0, 1, 1, 1]"
7903,1,1,2,0.4943685356519305,"[0, 1, 0, 1, 1, 1, 0, 1, 1, 0]"
7904,2,2,4,0.9639242452219036,"[0, 1, 0, 1, 0, 1, 1, 1, 1, 0]"
7905,1,1,2,0.5211626640793814,"[0, 1, 0, 1, 1, 0, 0, 1, 0, 1]"
7906,1,1,2,0.6812518378642912,"[1, 0, 1, 1, 0, 1, 1, 1, 0, 0]"
7907,1,1,2,0.5029300298737605,"[0, 0, 0, 0, 0, 1, 1, 0, 1, 0]"
7908,1,1,2,0.49505528561872303,"[1, 1, 1, 1, 0, 1, 0, 0, 1, 1]"
7909,1,1,2,0.3651525881354266,"[1, 1, 0, 0, 0, 0, 1, 1, 0, 0]"
7910,2,2,4,0.826267538611363,"[1, 1, 1, 0, 1, 0, 1, 0, 0, 0]"
7911,1,1,2,0.7115140493426274,"[0, 1, 1, 1, 0, 0, 1, 0, 0, 0]"
7912,1,1,2,0.9223375607961507,"[0, 0, 0, 0, 1, 1, 1, 0, 1, 1]"
7913,1,1,2,0.12328672381277284,"[1, 0, 1, 0, 0, 0, 1, 1, 1, 0]"
7914,1,1,2,0.12314502924998405,"[0, 0, 0, 1, 0, 1, 0, 1, 1, 0]"
7915,1,1,2,0.5553434280593031,"[1, 1, 0, 1, 1, 1, 0, 0, 0, 1]"
7916,2,2,4,0.5488412749506203,"[1, 1, 0, 1, 0, 0, 1, 0, 1, 0]"
7917,7,7,14,0.5620376073057922,"[1, 0, 0, 1, 0, 1, 1, 1, 1, 1]"
7918,2,2,4,0.27801853446149327,"[1, 1, 0, 0, 0, 0, 0, 0, 0, 1]"
7919,1,1,2,0.3554095826138677,"[0, 0, 0, 1, 0, 0, 1, 0, 0, 1]"
7920,1,1,2,0.20739312223005368,"[0, 0, 0, 0, 0, 1, 0, 0, 1, 0]"
7921,1,1,2,0.32440523486343065,"[1, 0, 0, 1, 1, 1, 1, 0, 0, 0]"
7922,1,1,2,0.20454006529348,"[0, 1, 0, 1, 0, 0, 1, 1, 1, 0]"
7923,2,2,4,0.7329256814636261,"[0, 1, 1, 1, 1, 1, 1, 0, 1, 1]"
7924,3,3,6,0.7769211613610014,"[0, 0, 1, 1, 1, 0, 1, 1, 1, 0]"
7925,1,1,2,0.9993710821667177,"[1, 0, 1, 1, 0, 0, 0, 0, 1, 1]"
7926,2,2,4,0.36522720362157957,"[0, 0, 1, 0, 0, 1, 0, 0, 0, 0]"
7927,3,3,6,0.6980344400670068,"[0, 0, 1, 0, 1, 0, 0, 0, 1, 0]"
7928,1,1,2,0.2524724360963361,"[1, 1, 1, 1, 1, 1, 1, 0, 1, 0]"
7929,2,2,4,0.206978334312511,"[0, 1, 0, 1, 0, 0, 0, 1, 1, 1]"
7930,1,1,2,0.35640295879740536,"[1, 0, 1, 0, 0, 1, 0, 1, 1, 0]"
7931,3,3,6,0.5014356055762104,"[1, 0, 1, 0, 0, 1, 0, 0, 1, 0]"
7932,2,2,4,0.9941799281566954,"[1, 1, 1, 0, 1, 0, 0, 1, 1, 1]"
7933,1,1,2,0.0509467220601193,"[0, 1, 1, 1, 1, 0, 1, 1, 1, 1]"
7934,1,1,2,0.07592641483785212,"[1, 1, 1, 1, 0, 0, 0, 0, 1, 0]"
7935,2,2,4,0.8093846706342148,"[0, 0, 0, 1, 1, 1, 1, 0, 1, 1]"
7936,1,1,2,0.27142235384463786,"[1, 0, 0, 0, 0, 1, 1, 0, 1, 0]"
7937,1,1,2,0.5954067266264392,"[1, 1, 0, 1, 0, 0, 0, 1, 0, 0]"
7938,1,1,2,0.21629931379030776,"[0, 0, 1, 0, 1, 1, 1, 0, 0, 1]"
7939,1,1,2,0.17888710000878427,"[1, 0, 0, 0, 0, 0, 1, 1, 1, 1]"
7940,1,1,2,0.07810316811630003,"[1, 1, 0, 1, 0, 0, 1, 0, 0, 0]"
7941,1,1,2,0.1935999713961174,"[0, 0, 0, 0, 0, 0, 1, 0, 0, 1]"
7942,1,1,2,0.6892255668924205,"[0, 0, 0, 1, 1, 0, 0, 0, 0, 0]"
7943,1,1,2,0.7609273600527465,"[1, 0, 1, 0, 1, 0, 0, 1, 1, 1]"
7944,2,2,4,0.3411210455033795,"[1, 1, 0, 1, 1, 0, 1, 0, 1, 0]"
7945,1,1,2,0.4879786051458499,"[0, 0, 0, 1, 0, 0, 0, 0, 0, 0]"
7946,2,2,4,0.5368235654322402,"[1, 1, 0, 1, 0, 1, 1, 1, 0, 0]"
7947,2,2,4,0.6030909787166124,"[0, 1, 0, 1, 0, 1, 1, 1, 1, 0]"
7948,1,1,2,0.5178380347036977,"[1, 0, 0, 1, 0, 0, 0, 0, 0, 1]"
7949,2,2,4,0.199650983513871,"[1, 0, 1, 1, 1, 0, 0, 1, 0, 0]"
7950,1,1,2,0.49618505966645887,"[0, 1, 0, 1, 0, 1, 0, 0, 1, 0]"
7951,1,1,2,0.07898409977794685,"[1, 0, 0, 1, 1, 0, 1, 0, 0, 0]"
7952,2,2,4,0.6782994307614676,"[1, 1, 1, 1, 1, 1, 1, 1, 0, 0]"
7953,1,1,2,0.5435300104409945,"[1, 0, 1, 0, 0, 1, 1, 0, 1, 0]"
7954,1,1,2,0.8183500036865495,"[1, 0, 0, 0, 0, 0, 1, 0, 0, 1]"
7955,2,2,4,0.39553241752437296,"[0, 1, 0, 1, 1, 1, 1, 0, 0, 1]"
7956,3,3,6,0.14543239558880294,"[0, 1, 1, 1, 0, 1, 1, 0, 1, 0]"
7957,1,1,2,0.5381806721759129,"[1, 1, 0, 1, 1, 0, 0, 0, 1, 1]"
7958,1,1,2,0.7646637751204077,"[1, 0, 1, 0, 0, 1, 0, 0, 0, 0]"
7959,1,1,2,0.0894517683937801,"[1, 1, 1, 1, 1, 0, 0, 0, 0, 1]"
7960,4,4,8,0.272581923856849,"[0, 1, 0, 1, 1, 1, 0, 1, 1, 0]"
7961,2,2,4,0.7530589043855592,"[1, 0, 0, 1, 1, 0, 1, 1, 0, 0]"
7962,2,2,4,0.11237467144877544,"[1, 0, 1, 1, 0, 0, 1, 0, 0, 1]"
7963,1,1,2,0.7326732528759372,"[0, 0, 0, 1, 0, 1, 0, 1, 0, 0]"
7964,1,1,2,0.7802038125157302,"[1, 1, 0, 0, 0, 0, 1, 0, 0, 0]"
7965,1,1,2,0.23964580913858968,"[0, 1, 1, 0, 0, 1, 1, 1, 1, 0]"
7966,2,2,4,0.7649487314090382,"[1, 1, 1, 0, 0, 0, 0, 0, 1, 1]"
7967,2,2,4,0.711183379569094,"[0, 0, 0, 1, 0, 1, 0, 0, 1, 1]"
7968,1,1,2,0.3266905996175522,"[0, 1, 0, 0, 1, 0, 1, 1, 1, 1]"
7969,1,1,2,0.007607976676011874,"[0, 0, 0, 0, 0, 1, 0, 1, 0, 1]"
7970,1,1,2,0.7347997616377002,"[0, 0, 1, 1, 0, 0, 0, 1, 0, 1]"
7971,1,1,2,0.5707006167154374,"[1, 0, 0, 0, 0, 0, 0, 1, 0, 0]"
7972,1,1,2,0.05754133095368841,"[1, 1, 1, 0, 1, 0, 0, 1, 1, 1]"
7973,1,1,2,0.3228844237663381,"[0, 1, 0, 1, 1, 0, 1, 1, 0, 1]"
7974,2,2,4,0.7195763399779228,"[1, 0, 1, 0, 0, 1, 1, 0, 1, 0]"
7975,1,1,2,0.10460838673160089,"[0, 1, 0, 1, 1, 1, 0, 0, 0, 0]"
7976,1,1,2,0.95642869378178,"[0, 0, 1, 0, 1, 1, 0, 1, 1, 1]"
7977,1,1,2,0.6220277081521263,"[1, 1, 0, 1, 0, 0, 1, 0, 0, 0]"
7978,1,1,2,0.5296824742930445,"[0, 0, 1, 0, 0, 0, 1, 1, 0, 1]"
7979,1,1,2,0.2292559420828908,"[0, 1, 1, 1, 0, 1, 1, 0, 1, 0]"
7980,8,8,16,0.21202927578157926,"[1, 1, 1, 1, 1, 1, 0, 1, 1, 1]"
7981,1,1,2,0.5348975164548734,"[1, 1, 0, 0, 0, 0, 1, 1, 1, 1]"
7982,1,1,2,0.29843282833112006,"[1, 1, 0, 0, 1, 0, 1, 0, 0, 0]"
7983,5,5,10,0.033834490282586116,"[0, 0, 1, 0, 0, 1, 1, 1, 1, 0]"
7984,1,1,2,0.10666629536832828,"[0, 1, 1, 0, 0, 0, 0, 1, 1, 0]"
7985,1,1,2,0.1647409575518225,"[1, 0, 1, 1, 0, 0, 0, 1, 1, 0]"
7986,1,1,2,0.621887034223625,"[1, 1, 1, 1, 1, 1, 1, 1, 1, 1]"
7987,1,1,2,0.36670759404209785,"[1, 1, 1, 0, 1, 1, 1, 0, 1, 1]"
7988,1,1,2,0.9611394360423575,"[0, 1, 1, 1, 1, 0, 0, 1, 0, 1]"
7989,1,1,2,0.0929368013466021,"[0, 0, 1, 0, 0, 0, 0, 1, 1, 1]"
7990,1,1,2,0.1309908226598676,"[1, 0, 0, 0, 0, 1, 0, 1, 1, 0]"
7991,1,1,2,0.8599955362033298,"[1, 1, 1, 0, 0, 1, 1, 0, 0, 0]"
7992,1,1,2,0.7124199023543153,"[0, 1, 1, 1, 1, 1, 0, 0, 0, 1]"
7993,1,1,2,0.19880437875919021,"[1, 0, 1, 0, 1, 0, 1, 0, 1, 1]"
7994,1,1,2,0.11331198207346571,"[0, 0, 0, 1, 0, 0, 0, 1, 1, 0]"
7995,1,1,2,0.017991235926918536,"[1, 1, 0, 1, 0, 0, 1, 1, 0, 0]"
7996,1,1,2,0.7205381834536208,"[1, 1, 1, 0, 0, 1, 1, 0, 1, 1]"
7997,1,1,2,0.5645020133828365,"[1, 1, 0, 1, 0, 0, 1, 0, 1, 0]"
7998,1,1,2,0.7198319012150185,"[1, 0, 0, 1, 0, 0, 0, 0, 0, 1]"
7999,1,1,2,0.2228539639586793,"[1, 1, 1, 1, 0, 1, 1, 1, 0, 0]"
8000,2,2,4,0.7063835508539559,"[1, 1, 0, 0, 1, 0, 0, 1, 0, 1]"
8001,1,1,2,0.9907961322883041,"[0, 1, 1, 1, 0, 0, 1, 0, 1, 0]"
8002,1,1,2,0.10138366071014626,"[1, 0, 1, 0, 1, 1, 1, 1, 0, 0]"
8003,1,1,2,0.30310928067402676,"[1, 1, 0, 0, 0, 0, 1, 0, 1, 0]"
8004,1,1,2,0.25993461903316584,"[0, 1, 1, 1, 0, 0, 0, 1, 1, 0]"
8005,1,1,2,0.2658385595711168,"[0, 1, 0, 0, 0, 1, 1, 0, 0, 1]"
8006,1,1,2,0.46680045055894737,"[0, 1, 0, 0, 0, 0, 0, 0, 0, 1]"
8007,2,2,4,0.6942397658337124,"[1, 1, 1, 1, 1, 1, 1, 1, 0, 0]"
8008,2,2,4,0.25691187591788356,"[0, 0, 0, 1, 0, 1, 0, 0, 1, 1]"
8009,3,3,6,0.8930477604356235,"[0, 1, 0, 0, 1, 0, 0, 1, 1, 0]"
8010,1,1,2,0.781028003792097,"[1, 0, 1, 1, 0, 1, 0, 1, 0, 1]"
8011,1,1,2,0.5820576417130652,"[1, 0, 1, 1, 1, 0, 1, 1, 1, 1]"
8012,1,1,2,0.24089279550792075,"[1, 1, 0, 1, 0, 1, 1, 0, 0, 1]"
8013,1,1,2,0.745321897373108,"[1, 0, 0, 0, 1, 1, 0, 0, 1, 0]"
8014,1,1,2,0.9789294119935965,"[0, 0, 0, 0, 0, 1, 0, 0, 1, 1]"
8015,1,1,2,0.9584186527740826,"[1, 1, 0, 1, 1, 0, 0, 0, 1, 1]"
8016,1,1,2,0.3410221810296016,"[1, 0, 0, 1, 0, 0, 1, 0, 0, 0]"
8017,1,1,2,0.225932458988519,"[0, 0, 1, 0, 0, 1, 0, 0, 1, 1]"
8018,2,2,4,0.09512003205077868,"[0, 1, 0, 1, 1, 0, 0, 0, 1, 0]"
8019,1,1,2,0.09451016148136693,"[1, 1, 0, 1, 1, 0, 1, 1, 1, 0]"
8020,1,1,2,0.8241775677777449,"[0, 0, 1, 0, 0, 1, 1, 1, 1, 1]"
8021,1,1,2,0.5464816475940194,"[0, 0, 0, 0, 0, 0, 0, 0, 1, 0]"
8022,2,2,4,0.6731357591319592,"[1, 0, 0, 0, 0, 0, 1, 1, 0, 1]"
8023,1,1,2,0.7132384798903694,"[1, 1, 0, 0, 1, 0, 0, 0, 0, 0]"
8024,1,1,2,0.8063300135051152,"[0, 1, 1, 1, 0, 1, 1, 0, 0, 0]"
8025,1,1,2,0.3780434558063548,"[0, 1, 0, 0, 0, 0, 0, 0, 1, 1]"
8026,1,1,2,0.04365134345955002,"[1, 1, 1, 1, 1, 0, 0, 0, 1, 0]"
8027,1,1,2,0.7151901301723299,"[0, 1, 0, 0, 0, 1, 0, 0, 1, 0]"
8028,1,1,2,0.5464386314848187,"[1, 0, 1, 0, 1, 1, 0, 0, 1, 0]"
8029,1,1,2,0.29128217936490697,"[0, 1, 0, 1, 1, 0, 0, 0, 1, 0]"
8030,2,2,4,0.8872885229664195,"[1, 1, 1, 0, 1, 0, 0, 0, 0, 1]"
8031,1,1,2,0.6070852310181947,"[0, 0, 1, 1, 0, 1, 1, 0, 0, 1]"
8032,1,1,2,0.510371789247702,"[0, 0, 0, 0, 0, 1, 0, 1, 1, 0]"
8033,1,1,2,0.79195525500163,"[1, 1, 1, 0, 0, 1, 1, 1, 0, 1]"
8034,1,1,2,0.12835480157711732,"[1, 0, 0, 1, 1, 1, 0, 1, 0, 0]"
8035,1,1,2,0.9288344000227801,"[1, 0, 0, 0, 0, 1, 1, 0, 1, 1]"
8036,1,1,2,0.8281051003773519,"[0, 1, 1, 1, 0, 0, 0, 0, 1, 0]"
8037,2,2,4,0.48581175857193015,"[0, 0, 0, 0, 1, 1, 1, 0, 0, 1]"
8038,1,1,2,0.684562344920504,"[1, 0, 1, 1, 0, 1, 0, 0, 0, 0]"
8039,4,4,8,0.9388486878907677,"[1, 0, 1, 1, 1, 1, 0, 1, 0, 1]"
8040,1,1,2,0.16447308655683535,"[1, 0, 1, 0, 0, 1, 0, 0, 1, 1]"
8041,1,1,2,0.9262233439331219,"[1, 1, 0, 0, 1, 1, 0, 1, 1, 0]"
8042,1,1,2,0.008541975053775408,"[0, 0, 0, 0, 1, 0, 1, 0, 1, 0]"
8043,1,1,2,0.2815091165913701,"[1, 1, 0, 0, 0, 0, 0, 1, 1, 0]"
8044,1,1,2,0.568503891824839,"[0, 1, 1, 0, 0, 1, 1, 1, 0, 1]"
8045,2,2,4,0.08290108416451603,"[1, 1, 0, 0, 0, 0, 1, 0, 0, 0]"
8046,2,2,4,0.30367414764237266,"[1, 1, 1, 1, 0, 1, 0, 1, 1, 0]"
8047,1,1,2,0.5289955270099834,"[0, 1, 0, 1, 1, 0, 0, 1, 1, 1]"
8048,1,1,2,0.3216205381584043,"[1, 0, 0, 1, 1, 0, 1, 1, 0, 0]"
8049,2,2,4,0.9894939008229161,"[0, 1, 1, 1, 1, 1, 1, 1, 0, 1]"
8050,1,1,2,0.9678657546408624,"[0, 1, 1, 1, 1, 0, 1, 1, 0, 1]"
8051,1,1,2,0.4233894731362924,"[0, 1, 0, 1, 0, 0, 0, 0, 1, 0]"
8052,1,1,2,0.45313826452575123,"[0, 0, 1, 1, 1, 1, 0, 1, 1, 1]"
8053,2,2,4,0.5754301678740132,"[0, 0, 0, 0, 0, 1, 0, 1, 0, 0]"
8054,1,1,2,0.9608751779197795,"[1, 1, 0, 1, 1, 0, 1, 0, 1, 1]"
8055,4,4,8,0.2364796760036958,"[1, 1, 0, 1, 0, 1, 0, 1, 0, 0]"
8056,1,1,2,0.8423181125055957,"[0, 0, 0, 1, 0, 0, 0, 0, 0, 0]"
8057,3,3,6,0.0915044964718138,"[1, 0, 0, 1, 1, 0, 0, 1, 1, 0]"
8058,1,1,2,0.3186136864137197,"[1, 1, 1, 1, 1, 0, 0, 0, 0, 0]"
8059,1,1,2,0.6054343286886231,"[1, 0, 1, 0, 1, 1, 0, 0, 0, 0]"
8060,1,1,2,0.16871987626163132,"[1, 1, 0, 0, 0, 0, 0, 1, 0, 0]"
8061,1,1,2,0.20899521895918993,"[0, 0, 0, 0, 1, 0, 1, 1, 0, 0]"
8062,1,1,2,0.2899160702417731,"[1, 0, 1, 1, 0, 1, 1, 1, 0, 0]"
8063,1,1,2,0.8145058405230261,"[0, 1, 1, 0, 0, 0, 0, 0, 1, 0]"
8064,1,1,2,0.9619581124697842,"[0, 1, 0, 0, 0, 0, 0, 0, 0, 1]"
8065,2,2,4,0.6832501197275302,"[1, 0, 1, 0, 0, 0, 0, 1, 1, 1]"
8066,1,1,2,0.7134115525958598,"[1, 0, 0, 1, 0, 0, 0, 1, 1, 0]"
8067,1,1,2,0.05201497935601007,"[0, 0, 1, 0, 1, 0, 1, 0, 0, 1]"
8068,1,1,2,0.9116919651549306,"[1, 1, 0, 0, 1, 0, 0, 1, 1, 0]"
8069,1,1,2,0.8910047057767424,"[0, 0, 0, 0, 0, 1, 0, 1, 0, 1]"
8070,1,1,2,0.12276302697423125,"[1, 0, 1, 0, 1, 1, 1, 0, 0, 1]"
8071,1,1,2,0.3076958138257251,"[0, 0, 1, 1, 1, 1, 1, 0, 1, 0]"
8072,2,2,4,0.2653364398440985,"[0, 0, 1, 1, 0, 1, 0, 1, 0, 0]"
8073,1,1,2,0.2288248218498985,"[0, 1, 0, 0, 1, 1, 0, 0, 0, 0]"
8074,1,1,2,0.18504551509684464,"[1, 0, 1, 1, 0, 0, 0, 1, 0, 1]"
8075,1,1,2,0.9879131758885935,"[0, 0, 0, 0, 1, 1, 0, 1, 0, 0]"
8076,1,1,2,0.01738008780337319,"[0, 1, 0, 1, 0, 1, 1, 0, 0, 0]"
8077,1,1,2,0.04198833462259699,"[1, 1, 1, 0, 0, 1, 0, 0, 1, 1]"
8078,2,2,4,0.6865021943122227,"[0, 0, 0, 0, 1, 0, 1, 0, 0, 0]"
8079,1,1,2,0.2737616017855462,"[1, 0, 0, 0, 1, 0, 1, 0, 1, 1]"
8080,1,1,2,0.5191384889749787,"[0, 1, 0, 1, 0, 1, 0, 0, 1, 1]"
8081,1,1,2,0.7321826704181812,"[0, 1, 1, 0, 0, 1, 0, 1, 1, 0]"
8082,1,1,2,0.018474622876497593,"[1, 0, 0, 1, 0, 0, 1, 1, 0, 1]"
8083,1,1,2,0.4378934916630932,"[1, 1, 1, 0, 1, 1, 1, 1, 0, 0]"
8084,1,1,2,0.7414287545296393,"[0, 0, 0, 0, 0, 0, 0, 0, 0, 1]"
8085,1,1,2,0.5141110945904391,"[0, 0, 0, 1, 0, 1, 0, 1, 0, 0]"
8086,1,1,2,0.3381799379234791,"[0, 1, 1, 0, 1, 1, 0, 1, 1, 0]"
8087,1,1,2,0.0052084255683738645,"[0, 1, 1, 0, 0, 1, 1, 0, 0, 0]"
8088,4,4,8,0.9042690801806277,"[0, 1, 1, 1, 0, 0, 0, 1, 1, 1]"
8089,1,1,2,0.2741898164623652,"[0, 1, 1, 1, 0, 0, 0, 1, 1, 0]"
8090,1,1,2,0.9082118143699118,"[0, 0, 1, 0, 1, 1, 0, 0, 0, 0]"
8091,3,3,6,0.5986411111594655,"[1, 1, 1, 1, 0, 0, 1, 1, 0, 0]"
8092,2,2,4,0.7555558443373893,"[1, 1, 1, 0, 1, 1, 0, 1, 0, 0]"
8093,1,1,2,0.9860944934082527,"[1, 1, 1, 0, 1, 1, 1, 1, 0, 1]"
8094,1,1,2,0.9923181450969768,"[0, 0, 0, 0, 0, 0, 0, 1, 0, 0]"
8095,2,2,4,0.8132946811431746,"[0, 1, 1, 0, 1, 1, 0, 1, 0, 1]"
8096,1,1,2,0.07601044900392806,"[1, 0, 1, 0, 0, 0, 1, 1, 0, 0]"
8097,3,3,6,0.32288612137885353,"[1, 0, 1, 1, 0, 0, 1, 1, 1, 0]"
8098,1,1,2,0.8699285033646643,"[0, 0, 1, 0, 0, 0, 1, 1, 0, 0]"
8099,1,1,2,0.5546263209366527,"[0, 1, 0, 0, 1, 0, 1, 0, 0, 1]"
8100,2,2,4,0.25814008298204405,"[0, 1, 0, 1, 1, 1, 0, 1, 1, 1]"
8101,3,3,6,0.5387802608896511,"[0, 0, 1, 1, 0, 0, 0, 1, 0, 0]"
8102,1,1,2,0.6618455007309062,"[1, 0, 1, 1, 1, 0, 0, 1, 0, 0]"
8103,2,2,4,0.39405950774509524,"[0, 1, 0, 0, 0, 0, 1, 0, 1, 1]"
8104,3,3,6,0.1635936712313485,"[0, 1, 1, 0, 1, 0, 0, 1, 1, 1]"
8105,1,1,2,0.3372416275696637,"[0, 1, 0, 0, 1, 1, 0, 0, 0, 0]"
8106,1,1,2,0.9107153470277785,"[1, 0, 1, 1, 0, 0, 1, 0, 0, 0]"
8107,1,1,2,0.39764452318152854,"[1, 1, 1, 1, 1, 1, 1, 1, 0, 0]"
8108,1,1,2,0.20106024722593596,"[1, 1, 1, 0, 1, 1, 1, 0, 0, 0]"
8109,1,1,2,0.6908456395904794,"[0, 0, 1, 1, 1, 0, 0, 0, 1, 0]"
8110,3,3,6,0.6822568214213557,"[0, 1, 1, 0, 1, 1, 0, 1, 0, 1]"
8111,1,1,2,0.4588002320253335,"[0, 0, 0, 0, 0, 0, 1, 0, 1, 0]"
8112,1,1,2,0.9642253530925667,"[0, 0, 1, 0, 1, 1, 0, 0, 0, 0]"
8113,1,1,2,0.5286729201037753,"[0, 0, 0, 0, 1, 1, 1, 0, 0, 0]"
8114,1,1,2,0.532835899001652,"[0, 0, 0, 1, 0, 0, 1, 1, 0, 1]"
8115,1,1,2,0.7837746993987931,"[1, 0, 1, 1, 0, 1, 0, 1, 1, 1]"
8116,3,3,6,0.9098011996181953,"[1, 1, 0, 1, 0, 0, 1, 1, 0, 1]"
8117,4,4,8,0.4942241254625228,"[1, 0, 1, 1, 0, 1, 0, 1, 1, 1]"
8118,1,1,2,0.5910340597292847,"[0, 0, 0, 0, 0, 0, 0, 1, 1, 0]"
8119,5,5,10,0.9770837302095932,"[0, 0, 1, 0, 0, 1, 0, 0, 1, 1]"
8120,1,1,2,0.05941214540253004,"[1, 1, 1, 1, 0, 1, 0, 1, 0, 1]"
8121,1,1,2,0.1803400919486584,"[1, 1, 1, 0, 1, 0, 1, 1, 1, 1]"
8122,2,2,4,0.03299320153994889,"[0, 0, 1, 0, 1, 1, 1, 0, 1, 0]"
8123,1,1,2,0.10346845469460986,"[0, 1, 0, 1, 0, 1, 1, 0, 0, 0]"
8124,2,2,4,0.9250450088677453,"[0, 1, 1, 1, 1, 1, 1, 0, 1, 1]"
8125,1,1,2,0.7869738107222922,"[1, 0, 0, 1, 1, 0, 1, 0, 0, 1]"
8126,1,1,2,0.7401433634498733,"[1, 1, 0, 0, 1, 1, 0, 0, 1, 0]"
8127,1,1,2,0.10018956540721913,"[0, 1, 1, 0, 1, 0, 1, 1, 0, 0]"
8128,1,1,2,0.733122006529821,"[1, 1, 1, 0, 1, 0, 0, 1, 0, 1]"
8129,2,2,4,0.920703959756467,"[0, 1, 1, 1, 0, 0, 1, 1, 0, 0]"
8130,2,2,4,0.5309730503566785,"[0, 0, 1, 1, 1, 0, 0, 1, 0, 1]"
8131,2,2,4,0.29298540231554115,"[1, 0, 0, 1, 1, 0, 1, 0, 1, 0]"
8132,3,3,6,0.17514791680747965,"[1, 0, 0, 1, 0, 0, 1, 0, 1, 1]"
8133,2,2,4,0.8537755781726778,"[1, 1, 0, 0, 1, 1, 1, 1, 1, 1]"
8134,1,1,2,0.4253746734207613,"[0, 1, 1, 1, 0, 0, 0, 1, 0, 0]"
8135,2,2,4,0.9201388558157172,"[0, 0, 0, 1, 1, 0, 1, 0, 1, 1]"
8136,1,1,2,0.8923234099396397,"[0, 1, 0, 0, 1, 0, 1, 1, 0, 0]"
8137,1,1,2,0.7062846860459603,"[1, 0, 0, 0, 0, 0, 0, 0, 1, 0]"
8138,1,1,2,0.32128111519721436,"[1, 0, 1, 0, 1, 0, 0, 0, 1, 0]"
8139,1,1,2,0.22147119578954422,"[0, 1, 0, 0, 0, 0, 1, 1, 0, 0]"
8140,1,1,2,0.7119539947098146,"[0, 1, 1, 1, 0, 0, 0, 1, 1, 0]"
8141,2,2,4,0.11309512949761424,"[1, 1, 1, 1, 0, 1, 0, 1, 1, 0]"
8142,1,1,2,0.19200753575342777,"[1, 0, 1, 1, 0, 0, 0, 1, 0, 1]"
8143,1,1,2,0.06278208778903371,"[1, 0, 1, 1, 0, 0, 0, 0, 1, 0]"
8144,2,2,4,0.327418140479528,"[0, 0, 1, 1, 1, 0, 1, 1, 0, 0]"
8145,2,2,4,0.4934758094582238,"[1, 0, 0, 1, 0, 1, 1, 1, 1, 1]"
8146,3,3,6,0.6436116289745301,"[1, 1, 0, 1, 1, 0, 1, 1, 1, 1]"
8147,6,6,12,0.6116523483486672,"[1, 1, 0, 0, 1, 1, 1, 1, 0, 1]"
8148,1,1,2,0.5870910093889371,"[0, 0, 1, 0, 1, 0, 1, 0, 1, 0]"
8149,1,1,2,0.2582973343360002,"[0, 0, 1, 0, 0, 1, 1, 1, 0, 0]"
8150,3,3,6,0.7235199964558614,"[1, 1, 1, 0, 0, 1, 0, 0, 1, 1]"
8151,1,1,2,0.8445918488669252,"[1, 1, 0, 1, 1, 0, 1, 1, 0, 0]"
8152,1,1,2,0.5328728732924616,"[0, 1, 1, 1, 1, 0, 1, 0, 1, 1]"
8153,3,3,6,0.1975107206046134,"[0, 1, 0, 1, 0, 1, 1, 1, 1, 0]"
8154,3,3,6,0.23745984823050237,"[0, 1, 1, 0, 1, 1, 1, 1, 1, 0]"
8155,3,3,6,0.0378447603127845,"[1, 1, 1, 0, 1, 0, 0, 1, 1, 1]"
8156,1,1,2,0.15019337844105518,"[0, 0, 0, 0, 1, 0, 0, 1, 0, 0]"
8157,1,1,2,0.8174997177920371,"[0, 1, 0, 0, 0, 0, 0, 1, 0, 0]"
8158,1,1,2,0.5326367293330747,"[1, 1, 0, 0, 1, 0, 0, 0, 0, 0]"
8159,1,1,2,0.7566107903583725,"[1, 0, 0, 1, 0, 0, 1, 1, 0, 0]"
8160,1,1,2,0.07054948366264835,"[0, 1, 0, 1, 0, 1, 1, 0, 1, 0]"
8161,1,1,2,0.2618791322025962,"[1, 0, 1, 0, 1, 1, 0, 0, 0, 0]"
8162,1,1,2,0.5862996612789639,"[0, 0, 1, 1, 0, 0, 1, 1, 0, 1]"
8163,1,1,2,0.3317060097431608,"[1, 0, 1, 1, 0, 1, 0, 1, 1, 0]"
8164,2,2,4,0.976621529354406,"[1, 1, 1, 1, 0, 0, 0, 0, 1, 0]"
8165,1,1,2,0.48784434932802734,"[1, 1, 1, 1, 1, 1, 1, 1, 0, 0]"
8166,1,1,2,0.914570368132845,"[0, 0, 1, 0, 0, 1, 1, 1, 1, 0]"
8167,1,1,2,0.4196664129155765,"[1, 0, 0, 1, 1, 1, 1, 0, 0, 1]"
8168,1,1,2,0.9445557564950541,"[1, 0, 0, 0, 0, 1, 1, 0, 1, 1]"
8169,1,1,2,0.5384944882644166,"[0, 1, 1, 0, 0, 0, 0, 0, 1, 1]"
8170,2,2,4,0.3073800321820688,"[1, 0, 1, 0, 0, 1, 0, 1, 0, 0]"
8171,3,3,6,0.4956640069680026,"[0, 1, 1, 0, 1, 1, 0, 0, 1, 0]"
8172,1,1,2,0.8764742224435287,"[0, 0, 1, 0, 1, 1, 0, 0, 1, 0]"
8173,1,1,2,0.2794396333261713,"[0, 0, 0, 0, 1, 0, 1, 0, 0, 0]"
8174,2,2,4,0.684091350436913,"[0, 1, 1, 1, 1, 1, 0, 0, 1, 0]"
8175,3,3,6,0.41402514571481064,"[1, 0, 0, 1, 1, 0, 1, 1, 0, 1]"
8176,1,1,2,0.9985621017860058,"[0, 1, 1, 1, 0, 0, 1, 0, 1, 1]"
8177,1,1,2,0.5534358448045638,"[0, 0, 0, 1, 0, 0, 0, 0, 1, 0]"
8178,2,2,4,0.009030826850521922,"[1, 1, 0, 1, 1, 1, 0, 1, 0, 1]"
8179,1,1,2,0.2063734991118079,"[0, 0, 1, 1, 1, 0, 0, 0, 0, 1]"
8180,1,1,2,0.19755139064865468,"[0, 0, 0, 0, 1, 1, 0, 1, 1, 1]"
8181,3,3,6,0.64743680632523,"[1, 0, 1, 1, 0, 0, 0, 0, 1, 1]"
8182,2,2,4,0.3066141360464286,"[0, 0, 0, 0, 1, 0, 0, 1, 0, 0]"
8183,3,3,6,0.09916026678168999,"[0, 1, 1, 1, 1, 1, 0, 1, 0, 1]"
8184,1,1,2,0.8659224260762848,"[1, 1, 1, 1, 0, 1, 0, 0, 0, 1]"
8185,3,3,6,0.7402768263547567,"[1, 0, 0, 0, 0, 0, 1, 1, 0, 0]"
8186,1,1,2,0.3053934404223403,"[0, 1, 1, 0, 0, 1, 1, 0, 1, 1]"
8187,1,1,2,0.28259772632524705,"[0, 1, 1, 1, 0, 0, 1, 0, 1, 1]"
8188,2,2,4,0.41299137715148304,"[1, 0, 0, 1, 1, 0, 0, 1, 1, 0]"
8189,1,1,2,0.04681655836949561,"[0, 0, 0, 0, 1, 1, 1, 0, 0, 0]"
8190,2,2,4,0.10624544426230631,"[0, 0, 1, 0, 1, 1, 0, 1, 0, 1]"
8191,2,2,4,0.9837266559345033,"[0, 1, 1, 1, 0, 0, 0, 1, 0, 1]"
8192,3,3,6,0.3602453593795827,"[0, 1, 0, 1, 1, 0, 1, 1, 1, 1]"
8193,2,2,4,0.8190300413582905,"[1, 1, 1, 1, 0, 0, 1, 0, 1, 0]"
8194,2,2,4,0.19068945024041561,"[0, 1, 1, 1, 1, 1, 0, 0, 1, 1]"
8195,1,1,2,0.8776167520631888,"[1, 0, 1, 0, 1, 1, 1, 0, 0, 0]"
8196,3,3,6,0.9136434788354775,"[0, 1, 1, 0, 1, 1, 1, 1, 1, 1]"
8197,1,1,2,0.7090355831073676,"[0, 0, 1, 0, 0, 0, 1, 0, 0, 1]"
8198,1,1,2,0.7087423723023154,"[0, 1, 0, 0, 1, 1, 0, 1, 1, 1]"
8199,1,1,2,0.4048983044378912,"[1, 1, 0, 1, 1, 0, 0, 1, 0, 1]"
8200,2,2,4,0.28382201812905083,"[1, 0, 0, 0, 0, 1, 1, 1, 1, 1]"
8201,3,3,6,0.7960643687356348,"[0, 1, 0, 0, 1, 0, 1, 1, 0, 1]"
8202,1,1,2,0.7921014350209776,"[0, 1, 1, 0, 0, 1, 1, 0, 0, 1]"
8203,1,1,2,0.7653502473193569,"[0, 1, 1, 0, 1, 0, 1, 1, 1, 1]"
8204,3,3,6,0.12568081878802562,"[0, 1, 1, 0, 1, 0, 1, 0, 1, 0]"
8205,3,3,6,0.9747526569973597,"[1, 1, 0, 0, 1, 0, 1, 1, 0, 1]"
8206,1,1,2,0.12365369413589478,"[1, 0, 1, 1, 0, 0, 1, 1, 1, 0]"
8207,1,1,2,0.5876993666073117,"[1, 0, 1, 0, 0, 1, 0, 0, 0, 1]"
8208,1,1,2,0.06060831550425527,"[1, 1, 1, 0, 0, 0, 1, 1, 1, 0]"
8209,1,1,2,0.4108295999225283,"[0, 0, 0, 0, 0, 1, 1, 0, 0, 0]"
8210,1,1,2,0.8381318339745948,"[1, 1, 1, 0, 0, 1, 0, 0, 0, 1]"
8211,2,2,4,0.8999329855235555,"[1, 1, 0, 0, 0, 1, 1, 1, 0, 1]"
8212,1,1,2,0.23804141370895948,"[1, 1, 1, 0, 1, 1, 0, 1, 1, 1]"
8213,1,1,2,0.34504609065077285,"[0, 1, 1, 1, 0, 1, 0, 0, 1, 1]"
8214,1,1,2,0.8973642950351799,"[1, 1, 1, 0, 0, 1, 0, 0, 1, 1]"
8215,1,1,2,0.3256545774438653,"[1, 1, 0, 0, 1, 1, 1, 1, 0, 0]"
8216,1,1,2,0.34124257153098303,"[0, 0, 0, 1, 1, 1, 1, 0, 1, 0]"
8217,1,1,2,0.7582933123476182,"[1, 0, 1, 1, 0, 0, 1, 0, 0, 1]"
8218,1,1,2,0.42452425779685776,"[0, 0, 1, 1, 0, 0, 0, 0, 1, 1]"
8219,1,1,2,0.504871530188953,"[1, 0, 0, 1, 0, 0, 1, 0, 1, 1]"
8220,3,3,6,0.943083349399016,"[1, 1, 0, 0, 0, 0, 1, 1, 1, 1]"
8221,1,1,2,0.11056840304558868,"[0, 0, 1, 0, 1, 0, 0, 0, 0, 0]"
8222,1,1,2,0.7325904800563906,"[0, 1, 0, 0, 0, 0, 0, 1, 0, 0]"
8223,1,1,2,0.6809981807176722,"[1, 0, 1, 0, 1, 1, 1, 0, 0, 0]"
8224,1,1,2,0.9763907824489483,"[0, 1, 0, 1, 0, 1, 1, 0, 0, 1]"
8225,1,1,2,0.0461399439898299,"[0, 0, 0, 0, 0, 0, 1, 0, 1, 0]"
8226,1,1,2,0.2563560627945517,"[0, 1, 0, 1, 1, 1, 0, 0, 0, 1]"
8227,1,1,2,0.5507552800676229,"[0, 0, 0, 0, 0, 0, 0, 0, 1, 0]"
8228,4,4,8,0.18594083010973794,"[1, 0, 0, 1, 1, 1, 1, 1, 1, 1]"
8229,1,1,2,0.08313053044333496,"[0, 0, 1, 0, 0, 1, 0, 1, 1, 0]"
8230,1,1,2,0.6141013808480381,"[1, 1, 1, 1, 0, 1, 1, 0, 1, 0]"
8231,1,1,2,0.7464648743287613,"[0, 1, 1, 0, 1, 0, 0, 1, 1, 0]"
8232,1,1,2,0.8413499797876821,"[1, 0, 0, 0, 0, 1, 1, 1, 1, 1]"
8233,1,1,2,0.7223110212290509,"[1, 1, 1, 0, 0, 0, 1, 0, 0, 1]"
8234,1,1,2,0.18237065330348967,"[0, 0, 1, 1, 1, 0, 1, 1, 0, 1]"
8235,2,2,4,0.4784866304665961,"[1, 0, 0, 1, 0, 1, 0, 1, 1, 1]"
8236,2,2,4,0.8837934722992695,"[1, 1, 1, 1, 1, 1, 1, 1, 0, 1]"
8237,1,1,2,0.5989334027230031,"[1, 0, 0, 1, 1, 0, 0, 1, 0, 0]"
8238,1,1,2,0.4256724485439517,"[1, 0, 0, 1, 1, 0, 1, 1, 1, 1]"
8239,1,1,2,0.1710460764149342,"[1, 1, 1, 0, 1, 0, 1, 0, 1, 1]"
8240,2,2,4,0.4938737168192181,"[0, 1, 0, 1, 1, 0, 1, 0, 1, 0]"
8241,3,3,6,0.42202248114439245,"[1, 1, 1, 1, 1, 0, 1, 1, 1, 1]"
8242,1,1,2,0.9312212826395225,"[0, 0, 1, 1, 1, 0, 0, 1, 0, 0]"
8243,1,1,2,0.0010824156950051123,"[0, 0, 0, 1, 0, 1, 0, 1, 0, 1]"
8244,2,2,4,0.3436161697039797,"[0, 1, 1, 0, 0, 1, 1, 0, 0, 0]"
8245,3,3,6,0.8755154242069052,"[1, 0, 1, 1, 1, 0, 1, 1, 0, 1]"
8246,1,1,2,0.10842093124302687,"[0, 1, 1, 1, 1, 0, 1, 0, 0, 1]"
8247,1,1,2,0.18035825748711842,"[0, 1, 0, 0, 0, 1, 0, 0, 1, 0]"
8248,1,1,2,0.5976037949442988,"[0, 1, 0, 1, 1, 0, 0, 1, 1, 0]"
8249,3,3,6,0.26670669651183954,"[1, 0, 1, 0, 1, 1, 1, 1, 0, 1]"
8250,2,2,4,0.5631275518429651,"[0, 0, 0, 1, 1, 1, 1, 1, 0, 0]"
8251,3,3,6,0.18332277575608324,"[0, 0, 0, 0, 0, 1, 1, 0, 0, 1]"
8252,2,2,4,0.5664097176312128,"[1, 1, 0, 0, 1, 1, 1, 1, 0, 0]"
8253,2,2,4,0.7969393369822675,"[0, 1, 1, 0, 0, 1, 0, 0, 1, 0]"
8254,1,1,2,0.061471298459524815,"[0, 1, 0, 1, 0, 1, 0, 1, 0, 0]"
8255,1,1,2,0.31212162100924723,"[1, 0, 1, 0, 1, 0, 1, 0, 0, 0]"
8256,1,1,2,0.8130320323332259,"[1, 1, 1, 0, 1, 0, 0, 1, 0, 1]"
8257,1,1,2,0.7906852233151308,"[0, 1, 0, 1, 1, 1, 1, 1, 1, 1]"
8258,2,2,4,0.5253486777505147,"[1, 1, 1, 1, 0, 0, 0, 0, 0, 0]"
8259,1,1,2,0.3932764015322542,"[0, 1, 0, 1, 0, 0, 1, 1, 1, 0]"
8260,1,1,2,0.9347054514637253,"[0, 1, 0, 0, 1, 0, 1, 1, 0, 0]"
8261,1,1,2,0.49296005875832827,"[0, 0, 0, 1, 0, 1, 1, 0, 0, 0]"
8262,2,2,4,0.5434025798422817,"[0, 0, 1, 1, 0, 0, 0, 1, 1, 0]"
8263,1,1,2,0.16305555433480912,"[0, 1, 0, 1, 1, 1, 0, 1, 0, 0]"
8264,1,1,2,0.17667100678709413,"[0, 0, 0, 0, 1, 1, 1, 0, 1, 0]"
8265,1,1,2,0.8575975852956076,"[1, 0, 0, 1, 0, 0, 0, 0, 0, 1]"
8266,1,1,2,0.6945786697421654,"[1, 0, 1, 0, 0, 1, 0, 1, 0, 0]"
8267,1,1,2,0.17462472370088877,"[0, 1, 0, 0, 0, 0, 1, 0, 0, 1]"
8268,1,1,2,0.5901878766146695,"[1, 1, 0, 1, 0, 1, 0, 0, 0, 1]"
8269,1,1,2,0.022749622981829476,"[0, 0, 1, 1, 1, 1, 0, 0, 1, 0]"
8270,1,1,2,0.1863669619942444,"[1, 0, 0, 1, 1, 1, 1, 0, 1, 0]"
8271,1,1,2,0.716292118423142,"[1, 0, 0, 1, 1, 0, 1, 1, 0, 0]"
8272,2,2,4,0.01789775252924697,"[1, 0, 1, 1, 1, 0, 0, 1, 1, 0]"
8273,1,1,2,0.2655526104880396,"[0, 0, 1, 1, 1, 0, 1, 0, 0, 0]"
8274,1,1,2,0.07424430121814007,"[0, 0, 0, 0, 0, 1, 0, 0, 0, 0]"
8275,2,2,4,0.686496806043561,"[1, 0, 1, 1, 0, 0, 0, 0, 1, 1]"
8276,1,1,2,0.40521202774860154,"[0, 0, 1, 1, 1, 0, 0, 0, 0, 1]"
8277,1,1,2,0.5797402647788616,"[0, 0, 1, 0, 0, 0, 0, 1, 1, 0]"
8278,1,1,2,0.6567324617017385,"[0, 1, 0, 0, 1, 1, 1, 0, 1, 0]"
8279,1,1,2,0.16781593453859023,"[1, 1, 1, 1, 0, 0, 1, 1, 0, 0]"
8280,2,2,4,0.7296003023150506,"[0, 1, 1, 0, 0, 1, 0, 1, 1, 1]"
8281,2,2,4,0.8749463262173779,"[1, 1, 0, 1, 0, 1, 1, 0, 0, 0]"
8282,1,1,2,0.5581339928214142,"[0, 0, 0, 1, 0, 1, 0, 0, 0, 1]"
8283,1,1,2,0.755771720290932,"[1, 0, 0, 1, 1, 0, 1, 1, 0, 0]"
8284,1,1,2,0.19010354082024095,"[0, 0, 0, 1, 1, 0, 1, 1, 0, 1]"
8285,1,1,2,0.7778531887718169,"[0, 1, 1, 0, 1, 1, 0, 1, 0, 1]"
8286,5,5,10,0.9151833957874367,"[1, 0, 1, 0, 1, 0, 0, 1, 1, 1]"
8287,1,1,2,0.5339948854690258,"[1, 0, 0, 0, 0, 1, 1, 1, 0, 1]"
8288,3,3,6,0.3873826949986958,"[1, 1, 1, 1, 0, 0, 1, 1, 0, 1]"
8289,1,1,2,0.26119804999852814,"[0, 0, 0, 1, 1, 1, 1, 0, 1, 0]"
8290,1,1,2,0.8625589499540879,"[1, 0, 0, 1, 0, 0, 0, 0, 0, 0]"
8291,1,1,2,0.9491094686145694,"[0, 0, 1, 0, 0, 1, 0, 1, 0, 0]"
8292,1,1,2,0.44223611964011356,"[0, 1, 1, 1, 1, 0, 0, 1, 0, 0]"
8293,1,1,2,0.6780900532077153,"[1, 0, 0, 0, 1, 0, 0, 1, 0, 0]"
8294,3,3,6,0.23374235657756026,"[0, 1, 0, 0, 1, 0, 1, 1, 1, 0]"
8295,2,2,4,0.03538906934658392,"[0, 1, 1, 1, 0, 1, 1, 1, 1, 1]"
8296,1,1,2,0.8333672380160704,"[1, 0, 0, 0, 1, 1, 1, 0, 1, 0]"
8297,1,1,2,0.37692229901035257,"[1, 0, 0, 0, 1, 1, 0, 1, 0, 0]"
8298,1,1,2,0.15713137976040847,"[0, 0, 1, 1, 0, 0, 1, 0, 0, 1]"
8299,1,1,2,0.43591981337270624,"[1, 1, 0, 0, 1, 1, 1, 0, 1, 1]"
8300,1,1,2,0.5981138892121891,"[1, 0, 0, 0, 1, 0, 0, 0, 0, 0]"
8301,1,1,2,0.44456579426867715,"[0, 0, 1, 0, 0, 0, 0, 0, 1, 0]"
8302,1,1,2,0.39173258354876384,"[1, 0, 1, 0, 1, 1, 0, 0, 1, 0]"
8303,4,4,8,0.15786263061436123,"[0, 1, 0, 0, 1, 0, 1, 1, 1, 1]"
8304,1,1,2,0.1099491956259796,"[1, 1, 0, 1, 1, 1, 1, 0, 1, 0]"
8305,1,1,2,0.26540080435681246,"[1, 0, 1, 0, 0, 1, 1, 1, 1, 0]"
8306,1,1,2,0.28262350165202166,"[1, 1, 1, 0, 1, 0, 0, 0, 1, 0]"
8307,2,2,4,0.5264046000406051,"[0, 0, 1, 1, 1, 1, 0, 1, 1, 0]"
8308,1,1,2,0.679496964307644,"[1, 1, 0, 0, 0, 1, 1, 1, 1, 0]"
8309,1,1,2,0.004352933482813626,"[0, 0, 0, 1, 1, 0, 0, 0, 0, 0]"
8310,1,1,2,0.3680528003366835,"[0, 1, 0, 1, 1, 0, 0, 0, 0, 0]"
8311,1,1,2,0.6294217225410798,"[0, 0, 0, 1, 0, 0, 0, 1, 1, 0]"
8312,3,3,6,0.4895974366030702,"[1, 0, 1, 1, 0, 1, 1, 1, 1, 0]"
8313,1,1,2,0.6875491878611912,"[1, 1, 1, 0, 0, 0, 0, 1, 1, 1]"
8314,1,1,2,0.7614140424959235,"[0, 0, 0, 1, 0, 1, 1, 1, 0, 0]"
8315,3,3,6,0.33342516429835,"[0, 0, 1, 1, 0, 1, 1, 1, 0, 0]"
8316,1,1,2,0.053246014920442675,"[0, 0, 1, 0, 0, 1, 0, 1, 0, 0]"
8317,3,3,6,0.6772011108914054,"[0, 1, 0, 0, 0, 0, 0, 1, 0, 1]"
8318,1,1,2,0.8795463807848093,"[1, 0, 1, 1, 0, 1, 0, 1, 0, 0]"
8319,3,3,6,0.355111007325945,"[0, 1, 0, 1, 1, 1, 1, 1, 0, 0]"
8320,1,1,2,0.8419588701749434,"[1, 1, 1, 0, 1, 0, 1, 0, 1, 0]"
8321,1,1,2,0.8154072174238207,"[0, 1, 0, 1, 0, 0, 0, 0, 1, 1]"
8322,1,1,2,0.522329016165291,"[0, 0, 1, 1, 1, 1, 0, 1, 0, 1]"
8323,1,1,2,0.9688165473692962,"[0, 1, 1, 1, 1, 0, 1, 0, 1, 0]"
8324,2,2,4,0.6842160248174736,"[1, 1, 0, 1, 0, 0, 1, 1, 1, 1]"
8325,1,1,2,0.3698359488777009,"[1, 0, 0, 0, 0, 0, 1, 0, 0, 0]"
8326,1,1,2,0.8486410421035715,"[1, 0, 1, 0, 0, 1, 0, 1, 0, 1]"
8327,1,1,2,0.8344342494649418,"[1, 1, 0, 0, 0, 0, 0, 0, 1, 0]"
8328,1,1,2,0.1959084127523607,"[0, 1, 1, 0, 1, 1, 0, 0, 1, 1]"
8329,1,1,2,0.7303598657962896,"[0, 0, 0, 1, 0, 0, 1, 1, 0, 1]"
8330,1,1,2,0.367357846736188,"[1, 0, 1, 0, 1, 0, 1, 0, 1, 1]"
8331,1,1,2,0.28230549078446754,"[1, 1, 0, 0, 0, 1, 1, 1, 1, 0]"
8332,1,1,2,0.5348396230227191,"[0, 0, 1, 0, 0, 0, 0, 0, 1, 0]"
8333,1,1,2,0.9840223651731527,"[1, 0, 1, 0, 0, 1, 0, 0, 1, 1]"
8334,1,1,2,0.80164281181333,"[1, 1, 0, 1, 1, 0, 1, 0, 1, 0]"
8335,2,2,4,0.7827743564827057,"[0, 1, 0, 1, 1, 0, 1, 1, 0, 0]"
8336,1,1,2,0.572942433170485,"[0, 0, 1, 0, 1, 1, 1, 0, 1, 1]"
8337,1,1,2,0.9657465284537278,"[0, 1, 1, 0, 0, 1, 0, 0, 1, 0]"
8338,1,1,2,0.21724126250086473,"[0, 1, 1, 1, 1, 0, 0, 1, 1, 0]"
8339,2,2,4,0.3296904019698128,"[1, 0, 0, 0, 1, 1, 1, 0, 1, 1]"
8340,3,3,6,0.6415782944646601,"[1, 0, 0, 0, 0, 1, 0, 1, 0, 0]"
8341,3,3,6,0.8779455892995938,"[1, 0, 0, 0, 1, 0, 0, 0, 1, 0]"
8342,1,1,2,0.7129610106210292,"[1, 0, 0, 0, 0, 0, 0, 0, 0, 1]"
8343,1,1,2,0.3004215559384643,"[0, 0, 0, 0, 0, 1, 0, 0, 1, 0]"
8344,1,1,2,0.7913492214976796,"[1, 0, 1, 1, 1, 1, 1, 1, 1, 0]"
8345,2,2,4,0.8209969952699789,"[0, 0, 0, 1, 0, 1, 0, 1, 0, 0]"
8346,2,2,4,0.68851181556892,"[0, 0, 1, 1, 0, 1, 0, 1, 1, 0]"
8347,4,4,8,0.7977172888844036,"[1, 1, 0, 0, 0, 0, 1, 1, 1, 0]"
8348,3,3,6,0.8957816438330592,"[0, 0, 1, 0, 1, 0, 1, 1, 0, 1]"
8349,2,2,4,0.40206444545370257,"[1, 0, 1, 0, 1, 1, 1, 0, 1, 0]"
8350,2,2,4,0.5299634304538562,"[1, 1, 1, 1, 0, 0, 1, 0, 1, 1]"
8351,1,1,2,0.3301386604890497,"[1, 1, 1, 0, 0, 0, 1, 1, 1, 0]"
8352,2,2,4,0.3633163206301958,"[0, 1, 1, 1, 1, 1, 0, 0, 0, 1]"
8353,2,2,4,0.4878619727575484,"[1, 1, 1, 0, 1, 1, 1, 0, 1, 1]"
8354,3,3,6,0.6745428187824138,"[1, 0, 0, 1, 1, 1, 0, 0, 1, 1]"
8355,1,1,2,0.8770688028270123,"[0, 0, 0, 0, 1, 0, 0, 1, 0, 1]"
8356,1,1,2,0.8558003190902133,"[0, 1, 1, 0, 1, 1, 0, 1, 0, 0]"
8357,4,4,8,0.9305443205947954,"[0, 1, 0, 1, 1, 1, 0, 1, 1, 1]"
8358,1,1,2,0.03515047591576892,"[0, 1, 1, 1, 1, 1, 0, 1, 1, 0]"
8359,1,1,2,0.7871834643120323,"[1, 1, 1, 0, 1, 0, 0, 0, 0, 1]"
8360,2,2,4,0.4772342539961437,"[1, 1, 1, 1, 0, 1, 0, 0, 0, 1]"
8361,1,1,2,0.43778158962450797,"[0, 0, 1, 0, 0, 0, 1, 0, 1, 1]"
8362,1,1,2,0.44005891778436423,"[1, 0, 0, 0, 1, 1, 1, 1, 0, 0]"
8363,1,1,2,0.6525641416150586,"[1, 1, 1, 0, 0, 1, 0, 0, 1, 1]"
8364,1,1,2,0.9408828620605462,"[1, 0, 1, 1, 1, 0, 0, 1, 0, 1]"
8365,1,1,2,0.9951028129418192,"[0, 1, 1, 1, 0, 1, 1, 1, 1, 1]"
8366,1,1,2,0.4291139251791902,"[1, 1, 0, 1, 1, 1, 0, 1, 0, 0]"
8367,1,1,2,0.7204013038427178,"[0, 0, 1, 1, 1, 1, 1, 0, 0, 0]"
8368,1,1,2,0.09679349584693497,"[1, 0, 0, 0, 0, 1, 0, 1, 1, 1]"
8369,1,1,2,0.36823156053027084,"[1, 0, 1, 0, 1, 0, 0, 0, 0, 1]"
8370,1,1,2,0.08480301622296538,"[0, 0, 0, 1, 0, 0, 1, 0, 1, 1]"
8371,1,1,2,0.9213570465149202,"[0, 1, 0, 1, 1, 0, 1, 1, 0, 1]"
8372,3,3,6,0.08787563910407525,"[0, 1, 0, 1, 0, 0, 1, 0, 0, 1]"
8373,1,1,2,0.37256924850620265,"[1, 0, 1, 0, 1, 0, 1, 1, 0, 0]"
8374,3,3,6,0.15934263001111448,"[1, 1, 1, 1, 0, 1, 1, 1, 0, 1]"
8375,2,2,4,0.940237477325913,"[0, 1, 1, 1, 1, 1, 0, 1, 0, 1]"
8376,1,1,2,0.6143754146950584,"[1, 1, 1, 1, 1, 1, 1, 0, 0, 0]"
8377,1,1,2,0.7836835693870154,"[0, 0, 0, 1, 0, 1, 0, 0, 0, 0]"
8378,1,1,2,0.4919489612594862,"[0, 1, 0, 1, 1, 0, 0, 0, 0, 0]"
8379,1,1,2,0.866488162505315,"[0, 1, 0, 1, 0, 0, 1, 1, 1, 1]"
8380,3,3,6,0.48377771997538177,"[1, 0, 0, 1, 0, 1, 0, 0, 1, 1]"
8381,1,1,2,0.9436749374393925,"[1, 1, 0, 1, 0, 0, 1, 1, 1, 0]"
8382,3,3,6,0.7255586841631816,"[1, 0, 1, 0, 1, 0, 1, 1, 0, 0]"
8383,1,1,2,0.08775016384218948,"[1, 0, 1, 1, 0, 0, 0, 0, 0, 1]"
8384,1,1,2,0.46617909001123714,"[0, 0, 0, 1, 1, 1, 1, 0, 0, 0]"
8385,2,2,4,0.9145686556444078,"[1, 1, 0, 1, 0, 0, 0, 1, 1, 1]"
8386,1,1,2,0.6731276464571452,"[0, 1, 1, 1, 0, 0, 0, 0, 1, 1]"
8387,3,3,6,0.7770002856034856,"[1, 1, 1, 0, 1, 1, 1, 1, 0, 0]"
8388,1,1,2,0.4273971973490387,"[1, 0, 0, 0, 0, 1, 1, 1, 0, 1]"
8389,1,1,2,0.8081595464751904,"[0, 1, 1, 1, 1, 1, 1, 1, 1, 1]"
8390,2,2,4,0.33468361498529886,"[1, 0, 1, 1, 1, 1, 1, 1, 0, 1]"
8391,1,1,2,0.5051812889050344,"[0, 0, 1, 0, 0, 0, 1, 0, 0, 1]"
8392,1,1,2,0.9332483050134986,"[1, 1, 1, 0, 1, 1, 0, 0, 0, 1]"
8393,1,1,2,0.25770776939227946,"[0, 0, 1, 0, 0, 1, 0, 1, 1, 1]"
8394,1,1,2,0.7186797184922262,"[0, 0, 1, 1, 0, 0, 1, 0, 1, 1]"
8395,2,2,4,0.31335451438321915,"[1, 0, 0, 0, 0, 0, 0, 1, 0, 1]"
8396,1,1,2,0.6958711792279425,"[1, 1, 0, 1, 1, 1, 1, 1, 1, 0]"
8397,1,1,2,0.07002136058342312,"[0, 1, 0, 0, 0, 1, 1, 1, 0, 1]"
8398,1,1,2,0.534055098896112,"[1, 1, 0, 0, 1, 1, 1, 1, 1, 0]"
8399,1,1,2,0.6006869083275388,"[1, 1, 0, 1, 0, 1, 1, 0, 1, 1]"
8400,1,1,2,0.4534449048199367,"[1, 0, 0, 0, 0, 1, 0, 0, 1, 0]"
8401,2,2,4,0.266688168498209,"[1, 1, 1, 1, 1, 1, 0, 1, 0, 0]"
8402,1,1,2,0.5686570895732779,"[0, 0, 0, 0, 1, 0, 0, 1, 0, 0]"
8403,1,1,2,0.12381243367159533,"[0, 1, 0, 0, 1, 0, 0, 0, 0, 0]"
8404,3,3,6,0.8611272930649533,"[1, 1, 0, 1, 1, 1, 1, 0, 0, 1]"
8405,1,1,2,0.019022195269952746,"[0, 1, 1, 1, 1, 0, 1, 1, 1, 0]"
8406,5,5,10,0.2996310175989999,"[0, 1, 1, 1, 0, 0, 1, 0, 1, 1]"
8407,1,1,2,0.9018751097481558,"[1, 1, 1, 0, 0, 1, 0, 1, 1, 0]"
8408,1,1,2,0.7880257684525541,"[0, 0, 1, 0, 1, 0, 0, 0, 1, 1]"
8409,1,1,2,0.264656897066328,"[0, 0, 0, 0, 1, 1, 0, 1, 0, 1]"
8410,1,1,2,0.20174731918789668,"[0, 0, 0, 0, 0, 0, 0, 1, 1, 1]"
8411,2,2,4,0.546309862632817,"[0, 1, 0, 0, 0, 0, 0, 1, 0, 0]"
8412,2,2,4,0.181710307474104,"[0, 1, 0, 0, 1, 0, 0, 0, 1, 0]"
8413,1,1,2,0.1320334438355879,"[0, 0, 0, 0, 0, 1, 0, 0, 1, 1]"
8414,1,1,2,0.4713411629079959,"[1, 1, 0, 1, 0, 0, 0, 0, 1, 0]"
8415,3,3,6,0.029598593905625026,"[1, 1, 1, 0, 0, 1, 0, 1, 1, 1]"
8416,1,1,2,0.3997970623609147,"[1, 1, 1, 1, 1, 0, 1, 1, 0, 0]"
8417,1,1,2,0.7374024782468742,"[0, 0, 0, 1, 1, 1, 1, 1, 0, 0]"
8418,1,1,2,0.6849732648981555,"[0, 1, 1, 1, 0, 0, 0, 1, 0, 1]"
8419,2,2,4,0.08484348835417177,"[0, 0, 1, 0, 1, 0, 1, 1, 1, 1]"
8420,1,1,2,0.8830750659619396,"[1, 1, 0, 0, 1, 1, 1, 1, 1, 0]"
8421,2,2,4,0.5114379637526962,"[0, 0, 0, 1, 1, 0, 1, 0, 1, 1]"
8422,4,4,8,0.7079832815753948,"[0, 0, 0, 0, 0, 0, 1, 1, 0, 1]"
8423,7,7,14,0.37931539353915444,"[1, 0, 1, 1, 1, 1, 1, 1, 0, 1]"
8424,2,2,4,0.9854807327785675,"[1, 1, 0, 1, 0, 1, 1, 1, 1, 1]"
8425,1,1,2,0.7213487016282182,"[1, 0, 1, 0, 1, 0, 1, 0, 1, 0]"
8426,2,2,4,0.15289406319885668,"[1, 1, 1, 0, 0, 1, 0, 1, 1, 1]"
8427,2,2,4,0.8942620806386764,"[0, 0, 0, 0, 1, 1, 1, 1, 1, 1]"
8428,1,1,2,0.7685253455420872,"[1, 0, 1, 1, 0, 0, 0, 1, 1, 1]"
8429,2,2,4,0.14773281714470998,"[1, 0, 1, 0, 1, 1, 0, 1, 1, 1]"
8430,2,2,4,0.824949832882548,"[1, 0, 1, 1, 1, 1, 0, 0, 1, 0]"
8431,1,1,2,0.13305210098026854,"[0, 1, 1, 1, 1, 1, 0, 1, 1, 1]"
8432,2,2,4,0.6429306049976065,"[0, 0, 1, 1, 1, 1, 1, 1, 0, 0]"
8433,1,1,2,0.8169912819384404,"[1, 0, 1, 1, 0, 0, 1, 0, 1, 1]"
8434,1,1,2,0.8987293043190003,"[0, 0, 1, 1, 1, 1, 1, 0, 0, 0]"
8435,1,1,2,0.6953145043288252,"[0, 1, 1, 0, 1, 1, 1, 1, 0, 0]"
8436,1,1,2,0.7221199361033743,"[1, 1, 1, 1, 0, 1, 0, 1, 0, 0]"
8437,1,1,2,0.5030029553164624,"[1, 0, 1, 0, 0, 0, 0, 0, 1, 0]"
8438,1,1,2,0.2698876820233205,"[0, 1, 1, 1, 0, 1, 0, 0, 1, 1]"
8439,3,3,6,0.7568559116210294,"[1, 0, 1, 0, 0, 1, 1, 0, 0, 1]"
8440,1,1,2,0.466375236464713,"[1, 1, 1, 0, 0, 0, 0, 1, 0, 0]"
8441,1,1,2,0.07581332447108302,"[0, 1, 0, 1, 1, 0, 0, 1, 0, 0]"
8442,1,1,2,0.7206722556606201,"[1, 0, 0, 1, 1, 0, 1, 1, 0, 1]"
8443,3,3,6,0.7936443497865902,"[0, 1, 1, 1, 0, 0, 0, 0, 1, 0]"
8444,1,1,2,0.06822236427078299,"[0, 1, 0, 1, 0, 1, 1, 1, 0, 0]"
8445,1,1,2,0.04593018843316332,"[1, 0, 1, 0, 1, 1, 0, 1, 0, 0]"
8446,1,1,2,0.43502844023609166,"[0, 1, 0, 1, 1, 0, 0, 1, 1, 0]"
8447,1,1,2,0.06499352426672955,"[1, 1, 1, 0, 0, 0, 1, 1, 1, 0]"
8448,2,2,4,0.32439830482190146,"[0, 1, 0, 0, 1, 1, 1, 0, 1, 0]"
8449,1,1,2,0.276852834544831,"[0, 1, 1, 0, 1, 1, 0, 0, 1, 0]"
8450,1,1,2,0.07620733800826007,"[1, 1, 0, 0, 1, 1, 1, 0, 1, 1]"
8451,1,1,2,0.5646392288612333,"[1, 1, 1, 1, 0, 0, 0, 0, 0, 1]"
8452,1,1,2,0.32700289462837584,"[1, 0, 0, 1, 1, 1, 1, 0, 0, 1]"
8453,1,1,2,0.8543113750814565,"[0, 0, 1, 1, 1, 0, 1, 1, 1, 1]"
8454,1,1,2,0.03262329333080727,"[0, 1, 0, 1, 1, 0, 1, 1, 1, 1]"
8455,1,1,2,0.20667416109559766,"[0, 0, 0, 1, 1, 0, 1, 0, 0, 1]"
8456,1,1,2,0.6563209672724898,"[1, 1, 1, 1, 0, 0, 1, 1, 0, 1]"
8457,3,3,6,0.3112140145515804,"[0, 1, 1, 1, 1, 1, 1, 1, 0, 1]"
8458,1,1,2,0.6862120722567984,"[0, 1, 0, 1, 0, 0, 1, 1, 0, 0]"
8459,1,1,2,0.7190893052629758,"[1, 0, 1, 0, 0, 1, 1, 1, 1, 1]"
8460,1,1,2,0.35265947638174044,"[0, 0, 0, 1, 0, 1, 1, 0, 0, 1]"
8461,1,1,2,0.9948460453277203,"[1, 1, 1, 0, 1, 1, 0, 1, 1, 0]"
8462,1,1,2,0.2239479312889231,"[0, 1, 0, 1, 0, 0, 1, 0, 1, 1]"
8463,4,4,8,0.9941441829362473,"[1, 1, 0, 0, 0, 1, 1, 1, 0, 1]"
8464,1,1,2,0.16919972278898765,"[1, 0, 0, 1, 0, 0, 0, 1, 0, 1]"
8465,2,2,4,0.7400512327836145,"[1, 1, 0, 0, 0, 0, 0, 1, 1, 0]"
8466,1,1,2,0.24333627568147642,"[0, 0, 0, 1, 1, 0, 0, 0, 1, 0]"
8467,1,1,2,0.5304500023580645,"[0, 1, 1, 1, 0, 1, 0, 1, 1, 1]"
8468,1,1,2,0.8486436814916165,"[1, 1, 1, 0, 0, 0, 0, 1, 0, 0]"
8469,1,1,2,0.4850415662985471,"[0, 0, 0, 1, 0, 1, 0, 1, 0, 0]"
8470,1,1,2,0.9529697000328612,"[1, 1, 0, 1, 0, 1, 0, 0, 0, 1]"
8471,1,1,2,0.49561250513320165,"[1, 0, 1, 1, 0, 1, 0, 0, 1, 0]"
8472,3,3,6,0.4957920490049388,"[1, 0, 1, 0, 0, 1, 1, 1, 1, 1]"
8473,1,1,2,0.34404810699264576,"[0, 0, 1, 0, 0, 1, 0, 1, 1, 1]"
8474,1,1,2,0.7927924531341549,"[1, 0, 0, 0, 1, 0, 0, 1, 1, 0]"
8475,1,1,2,0.28318238406553753,"[1, 1, 1, 1, 0, 0, 1, 1, 0, 1]"
8476,1,1,2,0.39478362700199,"[0, 1, 0, 1, 1, 0, 0, 0, 0, 1]"
8477,1,1,2,0.607012744916053,"[0, 1, 1, 0, 0, 0, 0, 0, 0, 0]"
8478,1,1,2,0.6209422020046932,"[0, 0, 1, 1, 0, 1, 1, 0, 1, 1]"
8479,1,1,2,0.7034051825745059,"[0, 1, 0, 0, 1, 1, 1, 1, 0, 1]"
8480,1,1,2,0.3072390006774324,"[1, 0, 0, 1, 0, 1, 1, 0, 0, 1]"
8481,1,1,2,0.27865606944257804,"[0, 1, 0, 0, 0, 0, 1, 1, 1, 0]"
8482,2,2,4,0.2281296265852657,"[1, 1, 0, 0, 0, 1, 0, 0, 0, 1]"
8483,1,1,2,0.03901346075565493,"[1, 0, 1, 0, 0, 1, 0, 1, 1, 1]"
8484,1,1,2,0.5680822081101868,"[1, 0, 1, 1, 1, 0, 0, 1, 1, 0]"
8485,1,1,2,0.45223501416654477,"[1, 1, 1, 1, 0, 1, 0, 1, 1, 1]"
8486,1,1,2,0.34663015025662136,"[1, 0, 0, 0, 0, 0, 0, 1, 0, 1]"
8487,1,1,2,0.06871691409663427,"[1, 0, 1, 1, 0, 1, 0, 0, 0, 0]"
8488,4,4,8,0.6259457683023688,"[1, 1, 1, 0, 0, 0, 0, 0, 1, 1]"
8489,1,1,2,0.40991350441273156,"[1, 1, 1, 1, 1, 0, 0, 1, 1, 0]"
8490,1,1,2,0.23881270271121224,"[0, 0, 1, 0, 0, 1, 1, 1, 1, 1]"
8491,2,2,4,0.07942130503473877,"[1, 1, 0, 1, 1, 1, 1, 1, 0, 1]"
8492,2,2,4,0.21699400685084147,"[0, 1, 1, 1, 1, 0, 0, 0, 0, 0]"
8493,1,1,2,0.84110572914926,"[0, 0, 1, 1, 1, 0, 0, 0, 0, 0]"
8494,2,2,4,0.26968112562383517,"[1, 0, 0, 0, 0, 0, 0, 1, 0, 0]"
8495,1,1,2,0.04693894391025988,"[1, 1, 1, 1, 1, 1, 1, 1, 1, 1]"
8496,1,1,2,0.2571834963888959,"[1, 0, 1, 0, 0, 1, 1, 1, 0, 0]"
8497,1,1,2,0.603488525118113,"[1, 1, 1, 0, 1, 0, 1, 1, 0, 1]"
8498,1,1,2,0.5037421090088353,"[1, 1, 0, 1, 0, 0, 1, 1, 1, 1]"
8499,4,4,8,0.7725918567218345,"[0, 0, 0, 1, 0, 1, 1, 1, 1, 0]"
8500,1,1,2,0.47136415962330613,"[1, 1, 0, 0, 0, 0, 1, 0, 1, 1]"
8501,1,1,2,0.8248187284277926,"[0, 1, 1, 0, 0, 0, 0, 0, 0, 1]"
8502,1,1,2,0.8180950810993127,"[0, 1, 1, 1, 1, 0, 0, 0, 1, 0]"
8503,1,1,2,0.902779278762872,"[0, 1, 1, 0, 0, 0, 1, 1, 0, 1]"
8504,2,2,4,0.4025870236066592,"[0, 0, 0, 1, 0, 0, 0, 0, 0, 0]"
8505,1,1,2,0.3515387939919117,"[1, 0, 0, 1, 1, 1, 1, 1, 0, 1]"
8506,1,1,2,0.7940735115303131,"[0, 1, 0, 1, 1, 1, 0, 0, 0, 0]"
8507,1,1,2,0.8848349728429163,"[1, 0, 0, 0, 1, 0, 0, 1, 0, 1]"
8508,1,1,2,0.20943626120063852,"[1, 0, 1, 1, 0, 1, 1, 0, 0, 1]"
8509,1,1,2,0.8916889552468207,"[1, 0, 1, 1, 1, 0, 0, 0, 0, 0]"
8510,1,1,2,0.054440565002778496,"[1, 0, 1, 0, 0, 0, 1, 1, 1, 0]"
8511,2,2,4,0.7359728824448745,"[0, 1, 0, 1, 1, 1, 1, 0, 0, 1]"
8512,2,2,4,0.3862541798271172,"[1, 0, 0, 1, 1, 0, 0, 1, 0, 0]"
8513,1,1,2,0.28713649792403595,"[0, 1, 0, 1, 1, 0, 0, 1, 1, 1]"
8514,2,2,4,0.38127480154765736,"[0, 0, 0, 1, 0, 0, 0, 0, 1, 1]"
8515,1,1,2,0.4063201859098867,"[1, 1, 1, 1, 1, 0, 1, 0, 1, 0]"
8516,2,2,4,0.9995251002352898,"[0, 0, 0, 1, 0, 0, 1, 1, 1, 0]"
8517,1,1,2,0.6836823084321598,"[1, 0, 0, 0, 1, 0, 1, 1, 0, 0]"
8518,1,1,2,0.3536352090611907,"[1, 1, 0, 0, 0, 1, 0, 0, 0, 1]"
8519,1,1,2,0.9861998163105596,"[0, 0, 1, 1, 1, 1, 0, 1, 0, 1]"
8520,1,1,2,0.36004534235120045,"[1, 0, 0, 0, 1, 1, 1, 1, 0, 1]"
8521,1,1,2,0.34326814178851395,"[1, 1, 0, 1, 0, 0, 0, 1, 1, 0]"
8522,1,1,2,0.504618871571948,"[0, 1, 0, 0, 1, 1, 0, 1, 1, 1]"
8523,1,1,2,0.1939405019970487,"[0, 1, 1, 0, 0, 0, 0, 0, 1, 1]"
8524,1,1,2,0.8015522631963571,"[0, 0, 1, 0, 1, 0, 1, 0, 0, 0]"
8525,2,2,4,0.2964957528742026,"[1, 1, 1, 1, 1, 0, 1, 0, 0, 1]"
8526,2,2,4,0.22623241836388974,"[1, 1, 0, 0, 1, 1, 0, 0, 0, 1]"
8527,1,1,2,0.3693074544803593,"[1, 0, 0, 1, 1, 0, 0, 0, 1, 1]"
8528,1,1,2,0.6858652231106177,"[1, 1, 1, 0, 0, 1, 1, 0, 0, 0]"
8529,2,2,4,0.38423600400380975,"[0, 0, 1, 0, 1, 0, 1, 0, 0, 0]"
8530,2,2,4,0.8400046695736976,"[1, 0, 1, 1, 1, 0, 1, 0, 1, 0]"
8531,1,1,2,0.06088469254829221,"[0, 0, 1, 0, 1, 0, 1, 1, 0, 1]"
8532,1,1,2,0.46241369182445613,"[1, 1, 1, 1, 1, 1, 1, 0, 1, 0]"
8533,1,1,2,0.1250778076536483,"[1, 1, 0, 0, 1, 0, 1, 0, 1, 1]"
8534,1,1,2,0.370490444997398,"[1, 0, 0, 0, 1, 0, 1, 0, 0, 0]"
8535,1,1,2,0.8953872727408563,"[1, 1, 0, 0, 0, 1, 1, 0, 1, 1]"
8536,5,5,10,0.8806166949081148,"[0, 0, 0, 1, 0, 1, 0, 0, 1, 1]"
8537,1,1,2,0.3431684617120242,"[0, 1, 0, 1, 1, 0, 0, 1, 0, 0]"
8538,1,1,2,0.7543239634439686,"[0, 1, 1, 0, 0, 1, 1, 0, 1, 0]"
8539,2,2,4,0.6011076651493296,"[1, 1, 1, 0, 0, 1, 1, 1, 1, 0]"
8540,1,1,2,0.9277617309185746,"[0, 1, 1, 0, 1, 1, 0, 1, 1, 1]"
8541,2,2,4,0.11300000774210639,"[1, 0, 0, 1, 1, 1, 1, 0, 1, 0]"
8542,1,1,2,0.416326982823214,"[1, 1, 1, 0, 0, 1, 0, 0, 1, 0]"
8543,2,2,4,0.257845502384324,"[0, 0, 1, 1, 0, 1, 0, 0, 1, 1]"
8544,1,1,2,0.36927784784507445,"[1, 1, 0, 1, 1, 1, 0, 0, 0, 1]"
8545,2,2,4,0.542777824909585,"[0, 1, 0, 0, 1, 1, 0, 0, 1, 1]"
8546,1,1,2,0.2869542520856584,"[1, 0, 1, 0, 0, 1, 0, 1, 1, 1]"
8547,3,3,6,0.5582271547759444,"[0, 0, 0, 0, 0, 1, 1, 1, 0, 1]"
8548,1,1,2,0.7121572950544248,"[0, 1, 1, 0, 1, 1, 1, 1, 0, 1]"
8549,1,1,2,0.11608519835261544,"[1, 0, 0, 0, 1, 0, 1, 0, 0, 1]"
8550,1,1,2,0.08142220057892491,"[1, 0, 1, 1, 1, 1, 0, 1, 0, 0]"
8551,1,1,2,0.48087877141503854,"[1, 1, 0, 1, 1, 1, 1, 0, 1, 1]"
8552,1,1,2,0.9768983083320246,"[1, 0, 0, 1, 0, 0, 1, 1, 1, 0]"
8553,4,4,8,0.5483750490693068,"[0, 1, 0, 1, 0, 1, 1, 1, 1, 0]"
8554,1,1,2,0.30546204027420976,"[0, 0, 1, 0, 1, 1, 0, 0, 1, 0]"
8555,2,2,4,0.6151531504356545,"[0, 1, 0, 0, 0, 1, 1, 1, 1, 1]"
8556,1,1,2,0.9945344293460067,"[0, 1, 1, 0, 0, 1, 1, 0, 0, 1]"
8557,1,1,2,0.7478588626495664,"[0, 0, 1, 1, 0, 1, 1, 1, 1, 0]"
8558,1,1,2,0.15758421374880893,"[1, 0, 0, 1, 0, 0, 0, 1, 1, 0]"
8559,1,1,2,0.044707880112285214,"[1, 0, 1, 1, 1, 0, 1, 0, 0, 1]"
8560,1,1,2,0.3084474525134894,"[0, 1, 0, 1, 0, 1, 0, 1, 0, 1]"
8561,1,1,2,0.9809148255786863,"[0, 1, 0, 1, 1, 0, 0, 0, 0, 0]"
8562,1,1,2,0.6343148582649086,"[1, 0, 1, 0, 1, 1, 1, 1, 1, 0]"
8563,1,1,2,0.5499701537272776,"[1, 1, 1, 1, 1, 0, 1, 0, 0, 0]"
8564,1,1,2,0.8851138096015745,"[0, 1, 0, 0, 0, 0, 0, 0, 1, 1]"
8565,1,1,2,0.16897773795006965,"[0, 1, 0, 0, 0, 1, 1, 0, 1, 0]"
8566,2,2,4,0.4873830157291893,"[1, 1, 1, 1, 1, 1, 0, 1, 1, 1]"
8567,1,1,2,0.8026329152562066,"[1, 0, 0, 1, 1, 0, 1, 0, 1, 1]"
8568,2,2,4,0.051157947921318114,"[1, 0, 1, 0, 1, 1, 0, 1, 0, 0]"
8569,1,1,2,0.32718909158184195,"[1, 0, 0, 1, 1, 0, 1, 0, 0, 0]"
8570,1,1,2,0.9155398347990463,"[0, 1, 0, 0, 0, 0, 0, 0, 1, 1]"
8571,1,1,2,0.6175797794687505,"[0, 1, 1, 0, 0, 1, 0, 1, 1, 0]"
8572,1,1,2,0.13768584933206596,"[0, 1, 1, 0, 0, 0, 1, 1, 1, 1]"
8573,1,1,2,0.07224116352090104,"[1, 0, 0, 1, 1, 1, 0, 1, 1, 0]"
8574,1,1,2,0.9963582766435259,"[1, 1, 0, 0, 0, 0, 1, 1, 1, 1]"
8575,1,1,2,0.18388407934373419,"[1, 0, 1, 1, 1, 0, 0, 1, 1, 1]"
8576,1,1,2,0.06643866464760284,"[1, 1, 0, 0, 1, 0, 0, 1, 0, 1]"
8577,1,1,2,0.552597324199833,"[0, 1, 1, 1, 1, 0, 0, 0, 1, 0]"
8578,2,2,4,0.34892062544766544,"[0, 0, 1, 0, 1, 0, 1, 0, 1, 1]"
8579,1,1,2,0.07767420621817411,"[0, 1, 0, 1, 1, 1, 0, 1, 0, 1]"
8580,1,1,2,0.2022846337566815,"[0, 1, 1, 0, 0, 0, 1, 0, 1, 1]"
8581,2,2,4,0.08619303358002073,"[1, 1, 1, 1, 1, 0, 0, 0, 1, 0]"
8582,4,4,8,0.31851082818883814,"[1, 1, 1, 0, 1, 1, 1, 1, 1, 0]"
8583,2,2,4,0.27729676628652977,"[0, 1, 0, 0, 0, 1, 0, 1, 1, 1]"
8584,1,1,2,0.536405952735876,"[0, 0, 0, 0, 0, 0, 1, 0, 1, 1]"
8585,1,1,2,0.04302224239216035,"[1, 0, 1, 1, 1, 0, 1, 0, 0, 1]"
8586,3,3,6,0.7913763680051912,"[0, 1, 0, 1, 1, 1, 1, 1, 1, 0]"
8587,1,1,2,0.1676540932939128,"[1, 1, 1, 0, 1, 1, 1, 1, 0, 0]"
8588,2,2,4,0.506944132208158,"[1, 1, 0, 1, 0, 0, 1, 0, 0, 0]"
8589,4,4,8,0.22684947473622752,"[0, 0, 0, 0, 1, 1, 0, 0, 1, 1]"
8590,3,3,6,0.7873930038217848,"[0, 0, 0, 1, 1, 0, 1, 1, 1, 1]"
8591,1,1,2,0.023277280885706575,"[1, 0, 1, 1, 1, 1, 0, 0, 1, 1]"
8592,1,1,2,0.0020219720202422353,"[0, 1, 1, 0, 0, 0, 1, 0, 0, 1]"
8593,1,1,2,0.8629793355249127,"[0, 0, 1, 1, 1, 0, 0, 1, 1, 1]"
8594,1,1,2,0.6220248430382718,"[1, 0, 0, 0, 0, 0, 0, 0, 1, 1]"
8595,1,1,2,0.17317632000639605,"[0, 1, 1, 1, 1, 1, 1, 1, 0, 1]"
8596,2,2,4,0.3210422527708914,"[0, 0, 0, 0, 1, 1, 1, 0, 1, 1]"
8597,1,1,2,0.043174097222237307,"[0, 1, 1, 1, 1, 1, 0, 1, 1, 1]"
8598,1,1,2,0.45868709613328673,"[1, 0, 1, 1, 0, 1, 1, 1, 1, 0]"
8599,1,1,2,0.09625525509977528,"[0, 0, 1, 0, 0, 1, 1, 1, 1, 1]"
8600,1,1,2,0.386506436764117,"[1, 1, 0, 0, 1, 0, 1, 0, 0, 0]"
8601,1,1,2,0.23448019406844756,"[1, 1, 0, 1, 1, 0, 0, 1, 0, 0]"
8602,1,1,2,0.40132791849606586,"[1, 1, 0, 1, 0, 0, 0, 1, 0, 1]"
8603,1,1,2,0.5841774205394622,"[0, 1, 0, 1, 0, 0, 0, 1, 1, 1]"
8604,3,3,6,0.3337543915368809,"[0, 1, 0, 1, 1, 1, 0, 1, 1, 0]"
8605,1,1,2,0.7790907691195634,"[1, 0, 0, 0, 0, 0, 0, 0, 0, 0]"
8606,2,2,4,0.9852238085629175,"[1, 0, 1, 1, 0, 0, 0, 0, 0, 1]"
8607,1,1,2,0.8159703152360781,"[0, 1, 0, 1, 1, 1, 0, 0, 1, 0]"
8608,1,1,2,0.5610410393248618,"[1, 1, 0, 1, 1, 1, 0, 1, 1, 0]"
8609,1,1,2,0.5210486924349729,"[1, 0, 1, 1, 1, 0, 0, 1, 0, 1]"
8610,1,1,2,0.01888576421731014,"[1, 1, 1, 1, 1, 0, 0, 1, 0, 1]"
8611,1,1,2,0.009693468011422568,"[1, 1, 0, 1, 0, 0, 0, 0, 0, 1]"
8612,1,1,2,0.2357620180884712,"[1, 1, 1, 1, 1, 0, 0, 1, 1, 1]"
8613,1,1,2,0.9234860399203744,"[1, 0, 1, 0, 0, 0, 0, 0, 0, 0]"
8614,1,1,2,0.38769917011959765,"[0, 1, 1, 1, 0, 1, 1, 0, 0, 0]"
8615,1,1,2,0.03258730646087227,"[0, 1, 0, 0, 1, 1, 0, 1, 0, 0]"
8616,1,1,2,0.3869186387118455,"[0, 0, 1, 0, 0, 1, 0, 1, 1, 0]"
8617,1,1,2,0.8758184453565758,"[1, 1, 1, 1, 0, 1, 1, 1, 0, 0]"
8618,3,3,6,0.5107954688870032,"[1, 0, 1, 1, 1, 1, 0, 1, 1, 0]"
8619,3,3,6,0.2851161932739231,"[0, 0, 1, 1, 1, 0, 0, 1, 0, 0]"
8620,1,1,2,0.7965062891232573,"[1, 0, 0, 1, 1, 0, 0, 0, 0, 0]"
8621,1,1,2,0.7806840698478636,"[0, 0, 0, 0, 1, 0, 0, 0, 0, 1]"
8622,1,1,2,0.1947114262806976,"[0, 1, 1, 0, 1, 0, 0, 0, 0, 0]"
8623,2,2,4,0.36430167054360774,"[0, 0, 1, 0, 0, 0, 0, 1, 0, 1]"
8624,1,1,2,0.663337286596222,"[1, 1, 1, 0, 0, 0, 0, 1, 1, 1]"
8625,3,3,6,0.9514792680515529,"[0, 1, 1, 1, 0, 1, 1, 1, 1, 0]"
8626,3,3,6,0.42101434284869665,"[0, 0, 0, 0, 0, 0, 0, 1, 0, 0]"
8627,2,2,4,0.7883314266095504,"[0, 0, 1, 1, 0, 1, 0, 1, 1, 1]"
8628,1,1,2,0.7899870774016622,"[0, 0, 1, 0, 1, 1, 0, 0, 0, 0]"
8629,1,1,2,0.3595400724895611,"[1, 0, 1, 1, 1, 0, 0, 0, 1, 1]"
8630,1,1,2,0.6805548627809986,"[1, 1, 1, 1, 0, 1, 0, 0, 1, 1]"
8631,1,1,2,0.8978293530162933,"[0, 0, 0, 0, 0, 1, 0, 1, 1, 1]"
8632,1,1,2,0.3317039973651671,"[1, 0, 0, 1, 1, 0, 1, 1, 0, 0]"
8633,2,2,4,0.41183505174256796,"[0, 0, 1, 0, 0, 1, 1, 1, 1, 0]"
8634,1,1,2,0.40235773137355957,"[1, 1, 1, 0, 0, 0, 1, 1, 1, 0]"
8635,1,1,2,0.46718582915872464,"[0, 1, 1, 1, 1, 0, 0, 0, 1, 1]"
8636,1,1,2,0.3420102983673333,"[0, 1, 1, 0, 0, 0, 1, 0, 0, 0]"
8637,1,1,2,0.7750829412040691,"[1, 1, 1, 1, 0, 1, 0, 0, 0, 0]"
8638,2,2,4,0.35546506078779516,"[1, 1, 0, 1, 1, 1, 1, 0, 1, 1]"
8639,1,1,2,0.5195251091964155,"[0, 0, 1, 0, 0, 1, 0, 1, 1, 0]"
8640,1,1,2,0.3741142480509657,"[0, 0, 1, 0, 0, 1, 0, 0, 0, 0]"
8641,2,2,4,0.9329046611169657,"[1, 1, 1, 1, 1, 0, 1, 1, 0, 1]"
8642,1,1,2,0.28446013657876235,"[1, 0, 1, 1, 0, 1, 1, 0, 1, 1]"
8643,1,1,2,0.8333542551838241,"[0, 0, 0, 0, 0, 1, 0, 1, 0, 1]"
8644,1,1,2,0.035489706044688485,"[1, 1, 0, 1, 0, 0, 0, 0, 0, 0]"
8645,1,1,2,0.9028187467070332,"[0, 1, 1, 1, 1, 1, 1, 1, 1, 1]"
8646,1,1,2,0.49018805618089345,"[1, 1, 0, 0, 1, 0, 0, 0, 0, 0]"
8647,1,1,2,0.3466100341113987,"[0, 0, 1, 1, 0, 1, 0, 0, 0, 1]"
8648,2,2,4,0.8076210514709169,"[1, 1, 1, 1, 1, 0, 0, 1, 1, 0]"
8649,1,1,2,0.5858195121908766,"[1, 0, 1, 0, 0, 0, 1, 0, 1, 1]"
8650,2,2,4,0.13494574817394434,"[1, 0, 1, 0, 1, 0, 1, 0, 1, 1]"
8651,1,1,2,0.1302212540969131,"[1, 0, 1, 1, 1, 0, 1, 0, 0, 1]"
8652,2,2,4,0.18404023582689844,"[0, 0, 1, 1, 1, 1, 1, 1, 1, 1]"
8653,1,1,2,0.5663997457476283,"[0, 0, 1, 0, 0, 0, 1, 1, 0, 1]"
8654,1,1,2,0.15237282718169665,"[0, 0, 1, 1, 1, 1, 0, 1, 1, 1]"
8655,1,1,2,0.8968165469336048,"[0, 0, 0, 0, 0, 0, 0, 0, 1, 1]"
8656,1,1,2,0.12336765066464572,"[1, 0, 1, 1, 0, 0, 0, 1, 1, 1]"
8657,1,1,2,0.03358455446748887,"[0, 1, 0, 0, 1, 0, 0, 0, 0, 1]"
8658,1,1,2,0.8181793933312562,"[0, 1, 1, 0, 1, 0, 1, 0, 1, 0]"
8659,2,2,4,0.9277859124853564,"[0, 0, 0, 1, 1, 0, 0, 1, 1, 1]"
8660,1,1,2,0.7849529621792424,"[1, 0, 0, 0, 1, 1, 1, 1, 1, 1]"
8661,2,2,4,0.11050324441124426,"[1, 0, 0, 0, 1, 1, 0, 0, 1, 0]"
8662,1,1,2,0.4162184159224388,"[0, 0, 1, 1, 1, 1, 0, 0, 1, 1]"
8663,2,2,4,0.7428110647471938,"[0, 0, 1, 0, 1, 1, 1, 1, 0, 0]"
8664,1,1,2,0.3107998043342294,"[0, 0, 0, 1, 0, 1, 1, 0, 0, 0]"
8665,1,1,2,0.8845842636908716,"[1, 0, 0, 0, 0, 0, 1, 1, 0, 0]"
8666,1,1,2,0.6876384765815572,"[1, 1, 0, 1, 0, 0, 1, 1, 0, 0]"
8667,1,1,2,0.8120718395338239,"[1, 1, 0, 0, 1, 0, 1, 0, 0, 1]"
8668,1,1,2,0.0707399294781621,"[1, 0, 0, 0, 1, 0, 1, 1, 0, 1]"
8669,1,1,2,0.9269791884289308,"[0, 0, 0, 0, 1, 1, 1, 0, 0, 1]"
8670,1,1,2,0.9306269956472527,"[0, 0, 1, 1, 0, 1, 1, 0, 1, 1]"
8671,2,2,4,0.2941589756367736,"[1, 1, 1, 0, 1, 0, 1, 1, 1, 1]"
8672,2,2,4,0.4284492718464046,"[1, 1, 1, 0, 1, 1, 1, 1, 1, 1]"
8673,1,1,2,0.008066916517794898,"[1, 1, 0, 0, 1, 0, 0, 1, 0, 1]"
8674,1,1,2,0.06313041765941318,"[1, 0, 0, 1, 0, 1, 0, 1, 0, 0]"
8675,1,1,2,0.7983610025641821,"[1, 1, 1, 1, 0, 1, 0, 1, 1, 1]"
8676,1,1,2,0.9628748153927082,"[0, 0, 0, 0, 0, 0, 1, 0, 1, 0]"
8677,2,2,4,0.542390046264675,"[0, 0, 1, 0, 0, 1, 0, 0, 1, 1]"
8678,1,1,2,0.7869666260645691,"[1, 1, 1, 1, 0, 1, 0, 0, 1, 0]"
8679,1,1,2,0.18736720175032662,"[1, 1, 0, 1, 1, 1, 0, 1, 1, 1]"
8680,1,1,2,0.39503013414811994,"[0, 1, 0, 1, 1, 1, 0, 0, 0, 1]"
8681,1,1,2,0.22386173055306813,"[1, 1, 1, 1, 0, 0, 0, 1, 0, 1]"
8682,1,1,2,0.1134543908596094,"[1, 0, 0, 1, 0, 1, 1, 0, 0, 0]"
8683,3,3,6,0.26071098225140066,"[0, 1, 1, 0, 0, 1, 1, 0, 0, 1]"
8684,1,1,2,0.42777907037659046,"[1, 1, 0, 0, 0, 1, 0, 1, 0, 0]"
8685,1,1,2,0.5676297163575681,"[1, 1, 1, 0, 0, 1, 0, 0, 0, 0]"
8686,1,1,2,0.787628763930448,"[0, 0, 1, 1, 0, 1, 1, 0, 1, 0]"
8687,1,1,2,0.8797320246810311,"[1, 1, 1, 1, 1, 1, 0, 0, 1, 0]"
8688,1,1,2,0.17303900474326506,"[1, 0, 1, 0, 0, 0, 1, 0, 1, 1]"
8689,1,1,2,0.37229157263878976,"[0, 0, 1, 0, 0, 1, 1, 0, 1, 0]"
8690,4,4,8,0.48526492059708415,"[0, 1, 1, 0, 0, 1, 1, 0, 1, 1]"
8691,2,2,4,0.9536816427863762,"[1, 0, 1, 0, 0, 1, 1, 1, 0, 1]"
8692,1,1,2,0.7265579895658971,"[1, 1, 1, 0, 1, 0, 0, 0, 0, 0]"
8693,1,1,2,0.384079604676138,"[1, 1, 0, 1, 0, 0, 1, 0, 1, 1]"
8694,1,1,2,0.8596274193508731,"[0, 1, 1, 0, 0, 0, 1, 0, 0, 0]"
8695,1,1,2,0.197391183631473,"[1, 0, 1, 1, 1, 1, 1, 1, 0, 0]"
8696,1,1,2,0.23641082959027748,"[0, 1, 1, 0, 1, 1, 1, 1, 1, 1]"
8697,1,1,2,0.7881942343744118,"[1, 1, 0, 1, 0, 0, 1, 0, 0, 1]"
8698,4,4,8,0.4324269027503893,"[0, 1, 0, 0, 1, 0, 1, 0, 1, 0]"
8699,1,1,2,0.6141544884028048,"[0, 0, 0, 1, 1, 1, 0, 1, 1, 0]"
8700,1,1,2,0.2778894645621277,"[1, 0, 1, 0, 1, 1, 1, 0, 0, 1]"
8701,2,2,4,0.8074797171615452,"[0, 0, 0, 0, 0, 1, 1, 1, 1, 0]"
8702,1,1,2,0.08169598973507541,"[0, 0, 1, 1, 0, 1, 0, 0, 1, 1]"
8703,1,1,2,0.9448976196854812,"[0, 1, 1, 1, 0, 0, 1, 0, 0, 1]"
8704,1,1,2,0.9363462697444749,"[0, 0, 0, 0, 1, 0, 0, 0, 0, 1]"
8705,1,1,2,0.15216060236849227,"[0, 0, 1, 0, 1, 1, 0, 0, 1, 1]"
8706,1,1,2,0.9376048187756304,"[1, 0, 0, 1, 0, 1, 0, 1, 0, 1]"
8707,1,1,2,0.11088884939039656,"[1, 1, 1, 0, 0, 1, 1, 1, 1, 1]"
8708,1,1,2,0.09634466745337611,"[0, 1, 1, 1, 1, 0, 1, 1, 0, 1]"
8709,1,1,2,0.5849014549457177,"[1, 1, 1, 0, 0, 1, 1, 0, 1, 0]"
8710,1,1,2,0.7442503672909302,"[0, 0, 1, 1, 0, 0, 1, 0, 0, 1]"
8711,1,1,2,0.25587612882882793,"[0, 0, 0, 0, 0, 0, 1, 0, 0, 1]"
8712,1,1,2,0.1774619218435618,"[1, 0, 1, 1, 1, 0, 1, 1, 1, 0]"
8713,3,3,6,0.4364565366020611,"[1, 0, 0, 1, 1, 0, 1, 0, 0, 0]"
8714,4,4,8,0.0891876923091467,"[1, 1, 0, 0, 0, 1, 1, 1, 0, 1]"
8715,1,1,2,0.21221732525466908,"[0, 0, 1, 0, 0, 1, 0, 0, 0, 1]"
8716,2,2,4,0.1967539987219422,"[0, 0, 1, 1, 0, 1, 1, 1, 1, 0]"
8717,5,5,10,0.6803742774766783,"[1, 1, 0, 0, 1, 1, 0, 1, 1, 0]"
8718,1,1,2,0.7746989139824795,"[1, 1, 1, 1, 0, 0, 1, 1, 0, 1]"
8719,2,2,4,0.04424904776667504,"[1, 0, 1, 0, 1, 0, 0, 0, 0, 0]"
8720,1,1,2,0.20227724194874852,"[0, 1, 1, 1, 1, 0, 0, 0, 1, 0]"
8721,1,1,2,0.7630682493186419,"[0, 0, 0, 1, 1, 0, 0, 1, 1, 0]"
8722,1,1,2,0.3312486783459925,"[1, 0, 1, 1, 1, 1, 1, 0, 0, 1]"
8723,1,1,2,0.17304624960598436,"[1, 0, 1, 0, 0, 0, 0, 1, 1, 0]"
8724,1,1,2,0.3286761229004138,"[0, 0, 0, 1, 0, 1, 0, 0, 1, 1]"
8725,1,1,2,0.9988067668296929,"[1, 0, 1, 0, 1, 1, 0, 1, 0, 0]"
8726,1,1,2,0.80324628067901,"[0, 0, 0, 1, 1, 1, 0, 0, 1, 1]"
8727,1,1,2,0.04555293203200805,"[1, 0, 0, 1, 1, 0, 0, 1, 0, 1]"
8728,3,3,6,0.05268954788627578,"[0, 1, 0, 1, 1, 0, 1, 0, 0, 1]"
8729,1,1,2,0.2260344425155254,"[1, 1, 1, 0, 1, 1, 1, 0, 1, 0]"
8730,1,1,2,0.7816895156677113,"[1, 0, 0, 0, 0, 1, 0, 0, 1, 1]"
8731,1,1,2,0.3785077368751609,"[0, 0, 1, 0, 0, 0, 1, 0, 1, 1]"
8732,1,1,2,0.7825504408524686,"[0, 0, 0, 0, 1, 0, 1, 1, 0, 0]"
8733,2,2,4,0.11645320696775252,"[0, 1, 1, 0, 1, 1, 1, 1, 0, 0]"
8734,1,1,2,0.3250836423668084,"[0, 1, 1, 1, 1, 1, 0, 0, 0, 0]"
8735,1,1,2,0.40195334310530295,"[0, 1, 1, 0, 0, 0, 0, 0, 1, 1]"
8736,1,1,2,0.6077073564753989,"[1, 1, 0, 0, 1, 1, 0, 1, 1, 0]"
8737,1,1,2,0.3576428903968486,"[0, 1, 1, 1, 1, 0, 1, 1, 1, 0]"
8738,3,3,6,0.6645463993993251,"[1, 1, 1, 1, 1, 1, 1, 1, 0, 1]"
8739,1,1,2,0.4024863578968585,"[1, 1, 0, 1, 1, 0, 1, 0, 1, 0]"
8740,1,1,2,0.43553075213182046,"[1, 0, 1, 0, 1, 0, 0, 1, 1, 1]"
8741,1,1,2,0.6240241090357727,"[0, 0, 0, 0, 0, 1, 0, 1, 1, 1]"
8742,1,1,2,0.10465033392440526,"[1, 0, 0, 1, 1, 0, 0, 0, 0, 0]"
8743,1,1,2,0.8100474578656125,"[0, 0, 0, 1, 0, 0, 1, 1, 0, 0]"
8744,2,2,4,0.044859922051214696,"[1, 1, 1, 0, 1, 0, 1, 1, 0, 1]"
8745,2,2,4,0.6968641130136213,"[1, 1, 0, 1, 0, 0, 0, 1, 0, 1]"
8746,1,1,2,0.3274871916007369,"[0, 1, 1, 0, 0, 0, 0, 0, 1, 0]"
8747,1,1,2,0.8190425919299432,"[1, 0, 0, 0, 1, 1, 1, 0, 0, 1]"
8748,2,2,4,0.38837205466361324,"[0, 0, 1, 1, 0, 1, 0, 1, 1, 1]"
8749,2,2,4,0.03480001414291345,"[0, 0, 1, 1, 1, 1, 0, 1, 0, 1]"
8750,1,1,2,0.6953505694076134,"[1, 1, 0, 0, 1, 0, 0, 0, 0, 0]"
8751,2,2,4,0.2473692643687796,"[0, 1, 0, 1, 1, 1, 1, 0, 0, 0]"
8752,1,1,2,0.8724312543697138,"[0, 1, 1, 1, 1, 1, 0, 0, 0, 0]"
8753,1,1,2,0.5905437503464649,"[0, 0, 0, 0, 0, 1, 0, 0, 1, 0]"
8754,1,1,2,0.007017947985775597,"[1, 0, 1, 0, 0, 1, 1, 0, 0, 0]"
8755,1,1,2,0.9811728896189988,"[1, 0, 0, 0, 0, 1, 1, 1, 1, 0]"
8756,1,1,2,0.22929702538493169,"[1, 1, 0, 0, 0, 1, 0, 0, 1, 0]"
8757,1,1,2,0.6209050812014232,"[0, 1, 0, 0, 0, 0, 1, 1, 1, 0]"
8758,1,1,2,0.8003845916816399,"[0, 0, 1, 0, 0, 1, 0, 0, 1, 1]"
8759,1,1,2,0.7058789654144698,"[0, 0, 1, 0, 1, 1, 0, 0, 0, 0]"
8760,1,1,2,0.9294155221992009,"[1, 1, 0, 1, 0, 1, 1, 0, 1, 0]"
8761,1,1,2,0.9660171305166678,"[0, 1, 1, 0, 1, 0, 0, 0, 0, 1]"
8762,1,1,2,0.6767845795030139,"[0, 0, 1, 0, 1, 1, 0, 1, 1, 1]"
8763,2,2,4,0.5223356329882484,"[1, 0, 1, 1, 1, 0, 0, 1, 0, 1]"
8764,2,2,4,0.8740036088787266,"[1, 1, 1, 0, 0, 0, 1, 1, 1, 0]"
8765,1,1,2,0.6816362139494503,"[0, 0, 0, 1, 0, 0, 0, 0, 0, 1]"
8766,1,1,2,0.04047448937449882,"[0, 0, 1, 0, 0, 1, 0, 1, 1, 1]"
8767,1,1,2,0.8932047866260007,"[0, 0, 0, 1, 1, 0, 0, 1, 1, 0]"
8768,1,1,2,0.31912101009607075,"[1, 0, 0, 1, 0, 0, 0, 0, 0, 0]"
8769,1,1,2,0.6355854895071192,"[0, 0, 1, 0, 0, 1, 0, 1, 0, 0]"
8770,1,1,2,0.1714876744517827,"[1, 0, 0, 0, 1, 0, 1, 1, 1, 0]"
8771,1,1,2,0.14120607721049927,"[0, 0, 0, 1, 0, 0, 1, 1, 0, 0]"
8772,1,1,2,0.5082901358684854,"[1, 1, 0, 0, 0, 1, 0, 1, 1, 1]"
8773,2,2,4,0.15491128492183714,"[0, 1, 0, 1, 1, 1, 1, 1, 0, 0]"
8774,2,2,4,0.7119415112299771,"[0, 1, 1, 1, 0, 1, 1, 0, 1, 0]"
8775,1,1,2,0.7057803757181049,"[1, 0, 0, 1, 0, 1, 1, 0, 0, 1]"
8776,2,2,4,0.7065939386615617,"[0, 1, 1, 0, 0, 1, 1, 0, 0, 0]"
8777,3,3,6,0.894579313656072,"[0, 1, 1, 1, 1, 1, 0, 1, 0, 1]"
8778,2,2,4,0.23609073941383196,"[0, 0, 1, 1, 0, 1, 0, 1, 1, 0]"
8779,1,1,2,0.9507202828675912,"[1, 0, 1, 0, 1, 0, 0, 0, 0, 1]"
8780,3,3,6,0.2209667042928738,"[0, 1, 1, 0, 1, 1, 0, 1, 1, 0]"
8781,1,1,2,0.5730965768310543,"[0, 0, 0, 0, 1, 1, 1, 0, 0, 0]"
8782,3,3,6,0.8363769308981777,"[0, 1, 1, 0, 0, 1, 0, 1, 1, 0]"
8783,1,1,2,0.49333370477043126,"[0, 1, 1, 1, 0, 1, 1, 1, 0, 0]"
8784,2,2,4,0.872538919591641,"[1, 0, 1, 0, 0, 1, 0, 1, 1, 0]"
8785,1,1,2,0.8957574504767593,"[1, 0, 0, 0, 0, 1, 0, 1, 0, 0]"
8786,1,1,2,0.7394684441269785,"[1, 0, 0, 1, 0, 1, 0, 1, 1, 1]"
8787,1,1,2,0.6002123541525695,"[1, 0, 1, 0, 0, 0, 0, 0, 0, 0]"
8788,1,1,2,0.5455102273384357,"[0, 1, 0, 0, 0, 1, 0, 1, 0, 0]"
8789,1,1,2,0.600511712596309,"[1, 0, 0, 0, 0, 0, 1, 0, 0, 1]"
8790,1,1,2,0.27014046984119433,"[0, 1, 0, 1, 0, 0, 1, 0, 0, 1]"
8791,2,2,4,0.9479827573860825,"[1, 1, 1, 1, 1, 1, 1, 0, 1, 1]"
8792,1,1,2,0.11207919513279807,"[1, 0, 1, 0, 0, 0, 0, 1, 0, 0]"
8793,1,1,2,0.18624527081478115,"[0, 0, 1, 0, 1, 1, 0, 1, 1, 0]"
8794,1,1,2,0.30444682188408967,"[0, 0, 0, 0, 0, 1, 1, 0, 1, 1]"
8795,1,1,2,0.4157731575330855,"[1, 0, 0, 0, 1, 1, 1, 0, 0, 1]"
8796,1,1,2,0.9640238540663978,"[1, 1, 0, 1, 0, 1, 0, 1, 0, 0]"
8797,1,1,2,0.8177717255319837,"[1, 1, 0, 1, 0, 0, 0, 0, 0, 1]"
8798,1,1,2,0.6885591743827781,"[0, 1, 0, 1, 1, 0, 0, 0, 0, 1]"
8799,1,1,2,0.7613170514735349,"[0, 0, 0, 1, 0, 1, 0, 0, 0, 1]"
8800,1,1,2,0.40519384541467285,"[0, 0, 1, 0, 0, 1, 1, 1, 0, 1]"
8801,1,1,2,0.8918297348475704,"[1, 1, 1, 1, 1, 1, 1, 0, 1, 0]"
8802,1,1,2,0.11912036746315002,"[0, 1, 0, 0, 0, 1, 1, 0, 0, 1]"
8803,1,1,2,0.7657167122788429,"[1, 0, 1, 1, 1, 1, 0, 1, 0, 0]"
8804,2,2,4,0.2126902611492444,"[0, 1, 1, 0, 1, 1, 0, 1, 0, 1]"
8805,3,3,6,0.40073422184640717,"[0, 1, 1, 1, 0, 0, 0, 1, 1, 0]"
8806,1,1,2,0.041928938299745866,"[1, 0, 1, 1, 0, 1, 0, 0, 0, 0]"
8807,8,8,16,0.9373633482415153,"[1, 1, 1, 1, 1, 1, 1, 1, 0, 0]"
8808,2,2,4,0.8137163817534403,"[1, 1, 0, 0, 1, 1, 1, 1, 0, 1]"
8809,1,1,2,0.38088537933198974,"[1, 1, 1, 0, 0, 0, 0, 0, 0, 1]"
8810,2,2,4,0.35997353823447653,"[1, 1, 1, 1, 0, 0, 0, 1, 1, 1]"
8811,1,1,2,0.37107961873918693,"[1, 1, 0, 1, 0, 0, 0, 0, 0, 1]"
8812,1,1,2,0.9282921471962081,"[1, 0, 1, 1, 0, 1, 0, 1, 0, 0]"
8813,4,4,8,0.1411724281440634,"[0, 0, 0, 1, 1, 1, 1, 1, 0, 0]"
8814,1,1,2,0.030088014931634155,"[1, 1, 1, 1, 1, 0, 0, 1, 0, 1]"
8815,2,2,4,0.5533290299122392,"[1, 0, 1, 1, 0, 1, 0, 0, 1, 1]"
8816,1,1,2,0.4260466957357245,"[0, 1, 1, 0, 1, 1, 1, 0, 1, 0]"
8817,1,1,2,0.017880135670316655,"[0, 1, 0, 0, 1, 1, 0, 0, 1, 0]"
8818,1,1,2,0.08342893550625707,"[1, 0, 0, 1, 0, 0, 0, 0, 0, 0]"
8819,1,1,2,0.8011936119125284,"[0, 0, 0, 1, 0, 0, 1, 1, 1, 0]"
8820,1,1,2,0.31677988811469804,"[0, 1, 1, 0, 1, 1, 0, 0, 1, 0]"
8821,2,2,4,0.044942064136409,"[0, 1, 0, 0, 1, 0, 0, 1, 1, 1]"
8822,1,1,2,0.02323111402896061,"[1, 0, 1, 1, 1, 0, 1, 1, 1, 1]"
8823,1,1,2,0.39100765985335184,"[1, 0, 1, 1, 0, 0, 1, 1, 0, 0]"
8824,1,1,2,0.6394036227498325,"[0, 1, 0, 0, 0, 0, 1, 0, 0, 0]"
8825,2,2,4,0.010935071619859849,"[1, 0, 1, 1, 0, 0, 0, 1, 0, 1]"
8826,1,1,2,0.5302064193338958,"[0, 1, 0, 0, 0, 1, 1, 1, 1, 0]"
8827,1,1,2,0.3971600091439118,"[0, 1, 0, 1, 0, 1, 1, 0, 1, 0]"
8828,1,1,2,0.24494138389684827,"[1, 1, 0, 1, 0, 0, 0, 0, 1, 0]"
8829,2,2,4,0.3279072730059738,"[0, 0, 0, 1, 0, 1, 0, 1, 0, 0]"
8830,2,2,4,0.06295465029481162,"[0, 1, 0, 1, 0, 0, 0, 0, 1, 1]"
8831,1,1,2,0.24423002090231516,"[1, 1, 0, 0, 0, 0, 1, 1, 0, 0]"
8832,1,1,2,0.1192495203938474,"[1, 1, 1, 1, 0, 1, 1, 0, 1, 0]"
8833,1,1,2,0.15177691662050707,"[1, 0, 0, 0, 1, 1, 1, 0, 1, 1]"
8834,1,1,2,0.024258378798001634,"[0, 1, 1, 0, 0, 0, 0, 0, 0, 1]"
8835,1,1,2,0.23312562977012163,"[1, 1, 1, 1, 0, 0, 1, 1, 1, 1]"
8836,3,3,6,0.44159701485636105,"[0, 0, 0, 0, 0, 1, 0, 1, 1, 1]"
8837,1,1,2,0.4789475008705668,"[0, 0, 0, 1, 0, 0, 0, 1, 0, 1]"
8838,2,2,4,0.6921624802084371,"[1, 1, 1, 0, 1, 1, 0, 0, 1, 0]"
8839,1,1,2,0.6050781707826232,"[0, 0, 0, 1, 1, 1, 1, 0, 0, 1]"
8840,4,4,8,0.969094546628664,"[1, 1, 1, 0, 1, 1, 1, 0, 1, 1]"
8841,1,1,2,0.9502084886505936,"[1, 1, 1, 1, 1, 1, 0, 0, 1, 0]"
8842,1,1,2,0.9952573747989543,"[1, 1, 1, 0, 0, 1, 0, 0, 0, 0]"
8843,1,1,2,0.5134650713025837,"[0, 1, 1, 0, 1, 1, 1, 0, 0, 0]"
8844,3,3,6,0.8352788739922706,"[1, 1, 1, 1, 0, 0, 1, 1, 0, 1]"
8845,1,1,2,0.5984619467649563,"[0, 1, 0, 0, 1, 1, 1, 1, 1, 1]"
8846,2,2,4,0.940908069510473,"[1, 1, 0, 0, 0, 0, 0, 0, 1, 1]"
8847,1,1,2,0.8886691296340493,"[0, 0, 0, 0, 0, 1, 1, 0, 1, 0]"
8848,1,1,2,0.7050266468565999,"[1, 1, 1, 0, 1, 1, 0, 0, 1, 0]"
8849,1,1,2,0.8179943184812636,"[0, 0, 0, 0, 0, 1, 1, 0, 0, 1]"
8850,2,2,4,0.8612573440937566,"[0, 0, 0, 0, 1, 1, 0, 0, 1, 0]"
8851,1,1,2,0.6216971539662245,"[0, 1, 1, 0, 0, 1, 1, 0, 1, 0]"
8852,2,2,4,0.24390132617353455,"[1, 1, 0, 1, 1, 0, 0, 1, 1, 1]"
8853,1,1,2,0.26556976758701156,"[0, 0, 0, 1, 1, 1, 1, 0, 1, 1]"
8854,1,1,2,0.9767961158825478,"[1, 0, 0, 1, 0, 0, 1, 1, 1, 0]"
8855,4,4,8,0.43015377888299977,"[0, 1, 0, 1, 0, 1, 0, 1, 0, 1]"
8856,1,1,2,0.029982261560589807,"[0, 0, 0, 0, 0, 1, 0, 0, 1, 1]"
8857,2,2,4,0.3109893755905042,"[0, 1, 1, 1, 1, 0, 1, 1, 0, 0]"
8858,2,2,4,0.2501697659284873,"[1, 0, 1, 1, 0, 1, 1, 1, 1, 1]"
8859,1,1,2,0.9204094187756996,"[1, 1, 1, 0, 0, 0, 0, 0, 0, 1]"
8860,3,3,6,0.23136224114092996,"[1, 1, 1, 1, 1, 1, 1, 0, 0, 1]"
8861,1,1,2,0.20056585987178088,"[0, 0, 0, 0, 0, 1, 1, 1, 0, 1]"
8862,1,1,2,0.5785750397179698,"[1, 0, 0, 1, 1, 1, 0, 0, 1, 1]"
8863,2,2,4,0.02460044190415489,"[0, 0, 1, 0, 1, 1, 1, 0, 1, 1]"
8864,2,2,4,0.22007522947189284,"[1, 1, 0, 1, 1, 1, 1, 0, 1, 1]"
8865,1,1,2,0.8388075116163866,"[0, 1, 1, 1, 0, 0, 0, 1, 0, 0]"
8866,1,1,2,0.8527003778237825,"[1, 1, 1, 1, 1, 1, 1, 0, 1, 0]"
8867,2,2,4,0.11087617127268323,"[0, 0, 1, 1, 0, 0, 1, 1, 1, 0]"
8868,1,1,2,0.7551254823957975,"[0, 0, 0, 0, 1, 0, 1, 0, 0, 0]"
8869,1,1,2,0.8861763126699793,"[1, 0, 1, 0, 1, 0, 0, 0, 0, 1]"
8870,1,1,2,0.4882931279317163,"[0, 1, 1, 0, 1, 1, 0, 0, 1, 1]"
8871,1,1,2,0.3856557299630995,"[0, 0, 1, 1, 1, 1, 0, 0, 1, 1]"
8872,2,2,4,0.12964032048073848,"[1, 1, 0, 0, 1, 0, 1, 0, 0, 0]"
8873,1,1,2,0.31953461996723076,"[1, 1, 1, 0, 0, 0, 1, 0, 0, 0]"
8874,1,1,2,0.8384741797779848,"[0, 1, 1, 1, 0, 0, 1, 1, 1, 1]"
8875,1,1,2,0.19459229847552784,"[0, 0, 0, 1, 0, 0, 1, 0, 1, 1]"
8876,1,1,2,0.9088936552611987,"[1, 1, 1, 1, 1, 1, 0, 0, 1, 1]"
8877,2,2,4,0.6724835258890468,"[0, 1, 1, 0, 1, 0, 1, 0, 1, 1]"
8878,1,1,2,0.5352546588574414,"[1, 0, 0, 0, 0, 1, 0, 0, 1, 1]"
8879,1,1,2,0.06162678773583086,"[1, 1, 0, 1, 1, 0, 0, 0, 1, 1]"
8880,1,1,2,0.5971342823258694,"[1, 1, 1, 0, 1, 1, 1, 1, 1, 1]"
8881,2,2,4,0.7629020085502185,"[1, 1, 0, 0, 1, 1, 1, 1, 1, 1]"
8882,1,1,2,0.7044581253010778,"[1, 1, 0, 0, 0, 1, 1, 0, 1, 0]"
8883,1,1,2,0.5603302409571587,"[0, 1, 0, 0, 1, 1, 1, 1, 0, 0]"
8884,3,3,6,0.4067189532174549,"[0, 0, 1, 1, 0, 1, 0, 1, 0, 0]"
8885,1,1,2,0.3006223752991868,"[0, 0, 1, 1, 1, 1, 1, 1, 1, 0]"
8886,1,1,2,0.5776059790190129,"[1, 0, 1, 1, 0, 1, 1, 0, 1, 0]"
8887,1,1,2,0.21891710679957255,"[1, 0, 0, 1, 0, 0, 1, 0, 0, 0]"
8888,1,1,2,0.6097043563341024,"[1, 1, 1, 1, 0, 0, 1, 1, 0, 0]"
8889,1,1,2,0.32772001142635154,"[1, 1, 0, 0, 0, 1, 0, 1, 1, 1]"
8890,1,1,2,0.6886684530314281,"[1, 0, 0, 0, 1, 1, 0, 1, 1, 0]"
8891,2,2,4,0.25516142661628083,"[0, 1, 1, 0, 1, 0, 1, 1, 0, 1]"
8892,1,1,2,0.8301565809733279,"[1, 0, 1, 1, 0, 0, 1, 0, 1, 0]"
8893,1,1,2,0.25743183027966,"[0, 0, 0, 1, 1, 0, 1, 0, 0, 0]"
8894,1,1,2,0.3966800672255779,"[0, 0, 1, 0, 1, 1, 0, 1, 1, 0]"
8895,1,1,2,0.8810483301824601,"[1, 1, 1, 1, 1, 1, 0, 1, 0, 1]"
8896,1,1,2,0.5743824495669746,"[0, 1, 0, 0, 0, 1, 1, 0, 0, 1]"
8897,1,1,2,0.22180481781617434,"[1, 0, 0, 1, 1, 0, 1, 1, 0, 0]"
8898,1,1,2,0.5022302259064803,"[0, 0, 1, 0, 1, 0, 0, 0, 1, 0]"
8899,1,1,2,0.30344072018323265,"[0, 0, 0, 0, 0, 0, 0, 0, 0, 0]"
8900,1,1,2,0.027616013504922376,"[0, 0, 1, 1, 1, 0, 1, 1, 0, 1]"
8901,1,1,2,0.47537314114532947,"[0, 1, 1, 0, 1, 1, 1, 0, 1, 1]"
8902,1,1,2,0.6930817927320471,"[0, 0, 1, 1, 1, 1, 0, 1, 1, 0]"
8903,1,1,2,0.46217059474228506,"[0, 0, 0, 0, 0, 1, 0, 1, 1, 0]"
8904,1,1,2,0.9794795417177421,"[0, 0, 0, 1, 1, 1, 1, 1, 1, 1]"
8905,1,1,2,0.0062326861682711066,"[1, 1, 1, 1, 1, 0, 1, 0, 1, 1]"
8906,1,1,2,0.6556615991394419,"[1, 0, 0, 0, 0, 0, 0, 0, 1, 0]"
8907,3,3,6,0.5709745326525246,"[1, 0, 1, 1, 1, 1, 1, 1, 1, 1]"
8908,1,1,2,0.5613772804282596,"[0, 1, 1, 0, 1, 0, 0, 0, 0, 1]"
8909,1,1,2,0.39682328280993284,"[1, 0, 1, 0, 0, 0, 1, 1, 0, 0]"
8910,1,1,2,0.8654446323826663,"[0, 0, 1, 0, 0, 1, 0, 1, 1, 1]"
8911,1,1,2,0.9995867119801056,"[0, 1, 1, 0, 0, 0, 0, 0, 1, 0]"
8912,1,1,2,0.12347919812287289,"[1, 1, 0, 1, 0, 1, 0, 0, 1, 0]"
8913,1,1,2,0.3576145104409395,"[1, 1, 1, 1, 1, 1, 0, 1, 1, 0]"
8914,2,2,4,0.6916883170728446,"[1, 0, 0, 1, 1, 1, 1, 1, 1, 0]"
8915,2,2,4,0.2655113374483188,"[1, 0, 1, 0, 0, 0, 1, 0, 0, 0]"
8916,2,2,4,0.3890374598076245,"[1, 0, 1, 1, 1, 1, 0, 1, 0, 0]"
8917,2,2,4,0.2858548734848495,"[0, 1, 0, 1, 1, 0, 1, 0, 0, 1]"
8918,3,3,6,0.2007887003842983,"[0, 1, 0, 0, 1, 0, 1, 0, 0, 1]"
8919,2,2,4,0.07374835695737825,"[0, 1, 1, 0, 0, 1, 0, 0, 0, 1]"
8920,1,1,2,0.8435476858630164,"[0, 0, 0, 0, 1, 0, 1, 0, 0, 0]"
8921,1,1,2,0.8796464396081843,"[1, 1, 1, 0, 0, 1, 1, 0, 0, 0]"
8922,2,2,4,0.5896648363658383,"[0, 0, 0, 1, 0, 1, 1, 0, 1, 0]"
8923,1,1,2,0.6509211437849473,"[0, 1, 1, 0, 1, 0, 0, 0, 1, 0]"
8924,2,2,4,0.7000708628269295,"[0, 0, 1, 0, 1, 1, 0, 0, 0, 0]"
8925,1,1,2,0.7237864150651485,"[1, 0, 0, 1, 0, 0, 1, 1, 0, 0]"
8926,1,1,2,0.36809538594418345,"[1, 0, 0, 1, 1, 0, 1, 0, 0, 1]"
8927,1,1,2,0.4074990991586138,"[0, 1, 0, 0, 1, 0, 0, 0, 0, 1]"
8928,1,1,2,0.12381487883289222,"[0, 0, 0, 0, 1, 1, 0, 1, 1, 0]"
8929,2,2,4,0.1581888867564879,"[1, 1, 0, 1, 0, 0, 1, 0, 0, 1]"
8930,1,1,2,0.23414351851355686,"[0, 1, 1, 1, 0, 1, 0, 0, 1, 0]"
8931,1,1,2,0.6171637320220854,"[0, 0, 1, 0, 1, 0, 0, 1, 0, 0]"
8932,1,1,2,0.9058444084102104,"[1, 1, 0, 1, 0, 1, 0, 0, 0, 1]"
8933,1,1,2,0.8996040053861407,"[1, 1, 0, 1, 0, 0, 1, 1, 0, 1]"
8934,2,2,4,0.11965142278846275,"[1, 0, 0, 0, 1, 1, 1, 1, 0, 1]"
8935,3,3,6,0.3412566951468652,"[0, 1, 0, 0, 0, 1, 0, 0, 1, 1]"
8936,3,3,6,0.28290587896129393,"[0, 1, 0, 1, 0, 0, 0, 1, 0, 0]"
8937,1,1,2,0.13284263889518266,"[1, 0, 1, 1, 1, 1, 1, 1, 0, 1]"
8938,1,1,2,0.2529326868266999,"[0, 1, 1, 0, 0, 0, 0, 1, 1, 1]"
8939,1,1,2,0.09591992287599171,"[1, 1, 1, 0, 1, 0, 0, 0, 1, 0]"
8940,3,3,6,0.45613708231314587,"[1, 1, 1, 0, 1, 1, 1, 1, 0, 1]"
8941,2,2,4,0.9802623709547791,"[1, 1, 0, 1, 1, 1, 1, 0, 0, 0]"
8942,1,1,2,0.51043546200349,"[0, 1, 1, 1, 0, 1, 0, 0, 0, 1]"
8943,1,1,2,0.1954296465556643,"[1, 1, 0, 1, 1, 0, 0, 1, 1, 1]"
8944,2,2,4,0.7435456496652687,"[0, 1, 0, 0, 1, 0, 1, 1, 1, 0]"
8945,1,1,2,0.545119430156667,"[0, 1, 1, 0, 0, 0, 1, 0, 1, 1]"
8946,1,1,2,0.3831218475266247,"[1, 1, 0, 1, 1, 1, 0, 0, 1, 0]"
8947,2,2,4,0.35001757420070656,"[1, 1, 0, 1, 1, 1, 0, 1, 0, 1]"
8948,1,1,2,0.5729641508629139,"[0, 1, 1, 1, 1, 0, 0, 0, 1, 0]"
8949,1,1,2,0.7916834222079854,"[0, 0, 1, 0, 0, 0, 0, 0, 0, 0]"
8950,1,1,2,0.8839275892533259,"[1, 0, 0, 0, 1, 1, 0, 1, 1, 1]"
8951,1,1,2,0.5770694851199635,"[1, 0, 1, 1, 0, 1, 1, 1, 1, 0]"
8952,5,5,10,0.29031218424224847,"[1, 1, 0, 1, 1, 0, 0, 1, 0, 0]"
8953,1,1,2,0.8900580041339378,"[1, 0, 1, 0, 0, 0, 0, 0, 0, 1]"
8954,3,3,6,0.37872160139309685,"[1, 1, 1, 0, 1, 1, 1, 0, 0, 1]"
8955,2,2,4,0.6958869651149617,"[1, 0, 0, 1, 1, 1, 1, 0, 1, 1]"
8956,1,1,2,0.6632747299144053,"[1, 1, 1, 0, 0, 0, 1, 1, 1, 1]"
8957,1,1,2,0.21538942477860867,"[1, 0, 0, 0, 0, 0, 1, 1, 0, 1]"
8958,2,2,4,0.9390895452655376,"[0, 0, 0, 0, 0, 1, 0, 0, 1, 1]"
8959,1,1,2,0.8360636897646285,"[0, 0, 0, 0, 0, 1, 0, 1, 1, 0]"
8960,1,1,2,0.7362368380434219,"[1, 0, 1, 1, 1, 0, 0, 0, 1, 1]"
8961,1,1,2,0.8781675042882888,"[0, 0, 0, 1, 1, 1, 0, 0, 0, 1]"
8962,3,3,6,0.2353184968592834,"[0, 1, 1, 1, 0, 1, 0, 0, 1, 1]"
8963,2,2,4,0.586006388142659,"[0, 0, 0, 0, 1, 1, 0, 1, 0, 1]"
8964,1,1,2,0.5977747800793173,"[0, 0, 1, 0, 0, 1, 0, 0, 1, 0]"
8965,1,1,2,0.35897237695260387,"[0, 0, 1, 0, 1, 0, 1, 1, 0, 0]"
8966,1,1,2,0.06330606516395398,"[0, 1, 0, 0, 0, 0, 0, 0, 1, 0]"
8967,1,1,2,0.7054468916249005,"[1, 0, 1, 1, 1, 0, 1, 0, 1, 1]"
8968,1,1,2,0.8379657022701548,"[0, 0, 1, 1, 1, 1, 0, 0, 1, 0]"
8969,1,1,2,0.13469127937711678,"[1, 1, 1, 1, 1, 1, 1, 1, 1, 1]"
8970,2,2,4,0.403687737144126,"[0, 1, 0, 1, 0, 1, 1, 1, 0, 1]"
8971,2,2,4,0.4070735388166268,"[0, 1, 0, 1, 1, 1, 1, 0, 0, 0]"
8972,1,1,2,0.0592286526076663,"[1, 1, 0, 0, 0, 0, 0, 0, 0, 0]"
8973,1,1,2,0.966504899862437,"[0, 0, 1, 1, 0, 1, 1, 1, 0, 1]"
8974,1,1,2,0.7267213562046736,"[1, 0, 1, 1, 1, 1, 0, 1, 0, 1]"
8975,2,2,4,0.8906614319292534,"[1, 1, 1, 0, 1, 1, 1, 0, 1, 1]"
8976,1,1,2,0.6002468203503762,"[0, 1, 0, 1, 0, 0, 1, 0, 0, 1]"
8977,1,1,2,0.28059337736055856,"[0, 0, 0, 0, 1, 0, 1, 1, 0, 0]"
8978,2,2,4,0.128677464560646,"[1, 1, 0, 0, 0, 0, 0, 1, 1, 1]"
8979,1,1,2,0.049637452358398004,"[0, 0, 0, 1, 1, 0, 0, 1, 1, 0]"
8980,2,2,4,0.4030524654512039,"[0, 0, 1, 0, 1, 1, 0, 1, 1, 0]"
8981,2,2,4,0.4096377813401809,"[1, 1, 1, 1, 0, 1, 0, 1, 1, 1]"
8982,2,2,4,0.017890289133724813,"[1, 1, 1, 1, 0, 0, 0, 0, 0, 1]"
8983,1,1,2,0.20217237900854057,"[0, 1, 1, 0, 1, 1, 0, 0, 1, 0]"
8984,3,3,6,0.6433922494660691,"[0, 0, 1, 1, 1, 1, 1, 0, 1, 1]"
8985,1,1,2,0.18834946674787778,"[1, 0, 0, 0, 0, 1, 0, 0, 0, 0]"
8986,1,1,2,0.48809236866081085,"[0, 1, 0, 0, 0, 0, 0, 1, 1, 0]"
8987,2,2,4,0.7835533981560091,"[0, 0, 1, 1, 1, 1, 0, 0, 0, 1]"
8988,4,4,8,0.9182889888016161,"[0, 1, 0, 0, 1, 1, 1, 0, 1, 1]"
8989,2,2,4,0.6317749250995206,"[1, 1, 0, 1, 1, 0, 0, 0, 1, 1]"
8990,2,2,4,0.19255700403848952,"[1, 0, 0, 0, 1, 1, 1, 0, 1, 1]"
8991,1,1,2,0.5325872538134118,"[1, 0, 0, 0, 1, 1, 0, 0, 0, 1]"
8992,1,1,2,0.5939376631802409,"[0, 1, 1, 1, 0, 1, 1, 0, 1, 1]"
8993,1,1,2,0.5491901595613936,"[1, 0, 0, 0, 0, 0, 1, 1, 1, 1]"
8994,1,1,2,0.5274857316101428,"[0, 0, 0, 0, 1, 1, 1, 1, 0, 0]"
8995,1,1,2,0.5228220161138786,"[1, 0, 1, 1, 1, 1, 1, 1, 0, 1]"
8996,1,1,2,0.06020576257157795,"[0, 0, 1, 0, 1, 1, 1, 0, 1, 0]"
8997,1,1,2,0.6151841735915942,"[0, 0, 0, 0, 1, 0, 1, 0, 1, 1]"
8998,1,1,2,0.9246081877198538,"[1, 0, 1, 0, 1, 1, 1, 0, 1, 0]"
8999,1,1,2,0.237703668149841,"[0, 1, 1, 1, 1, 0, 1, 0, 1, 0]"
9000,1,1,2,0.12209577765055946,"[1, 0, 1, 0, 0, 0, 0, 1, 1, 0]"
9001,1,1,2,0.5268273588616097,"[0, 1, 0, 1, 1, 0, 0, 1, 0, 1]"
9002,1,1,2,0.770431865148115,"[1, 1, 0, 0, 0, 1, 0, 1, 1, 0]"
9003,1,1,2,0.5149236112561314,"[1, 1, 1, 0, 0, 1, 0, 1, 1, 0]"
9004,2,2,4,0.760518362391535,"[1, 1, 1, 1, 1, 0, 0, 1, 0, 0]"
9005,1,1,2,0.48662683849856514,"[0, 0, 1, 0, 0, 0, 1, 0, 0, 1]"
9006,1,1,2,0.6215263150540254,"[0, 0, 0, 1, 0, 1, 1, 0, 1, 0]"
9007,1,1,2,0.17075763526340548,"[0, 1, 1, 0, 0, 0, 0, 0, 1, 0]"
9008,1,1,2,0.373118949008994,"[1, 1, 0, 0, 0, 0, 1, 1, 1, 0]"
9009,1,1,2,0.15629004914673117,"[0, 0, 0, 1, 1, 0, 0, 0, 0, 0]"
9010,2,2,4,0.9460638877977192,"[0, 1, 1, 1, 0, 0, 0, 0, 1, 0]"
9011,1,1,2,0.6403265835846343,"[1, 1, 1, 0, 0, 0, 0, 0, 0, 0]"
9012,1,1,2,0.06398283772109703,"[1, 1, 0, 0, 0, 0, 1, 0, 1, 1]"
9013,1,1,2,0.862556443094165,"[0, 0, 1, 0, 1, 1, 0, 0, 1, 0]"
9014,2,2,4,0.8252276884675365,"[0, 1, 0, 0, 1, 1, 1, 1, 1, 1]"
9015,2,2,4,0.3490986763671611,"[0, 1, 0, 1, 1, 1, 0, 1, 1, 1]"
9016,2,2,4,0.8709497128816678,"[1, 1, 0, 1, 0, 0, 0, 1, 0, 1]"
9017,2,2,4,0.8015085816790734,"[1, 1, 1, 1, 0, 0, 0, 1, 0, 0]"
9018,2,2,4,0.541023743322988,"[0, 0, 0, 1, 1, 0, 1, 0, 0, 0]"
9019,2,2,4,0.3877002527085036,"[1, 0, 0, 1, 0, 0, 1, 1, 0, 1]"
9020,3,3,6,0.488153489279182,"[0, 0, 0, 1, 1, 0, 1, 0, 1, 0]"
9021,1,1,2,0.15986014834012607,"[0, 0, 0, 1, 0, 1, 1, 1, 0, 1]"
9022,2,2,4,0.4325264051476545,"[1, 0, 0, 0, 1, 1, 0, 0, 1, 0]"
9023,1,1,2,0.3163854370139324,"[1, 1, 1, 1, 1, 1, 1, 0, 1, 0]"
9024,1,1,2,0.5427460437689765,"[1, 0, 1, 0, 1, 1, 0, 0, 0, 1]"
9025,1,1,2,0.7080021386319123,"[0, 1, 0, 0, 0, 0, 0, 1, 1, 0]"
9026,3,3,6,0.9497979962446875,"[0, 1, 0, 1, 1, 1, 0, 1, 1, 1]"
9027,1,1,2,0.7788314356491809,"[0, 1, 0, 0, 1, 0, 0, 0, 0, 1]"
9028,3,3,6,0.13740740082279124,"[1, 1, 1, 0, 1, 1, 1, 1, 1, 1]"
9029,1,1,2,0.9691770182141795,"[0, 1, 0, 0, 1, 1, 0, 1, 1, 1]"
9030,1,1,2,0.832371673028437,"[0, 0, 0, 0, 1, 1, 1, 0, 1, 0]"
9031,1,1,2,0.3991804490142299,"[1, 0, 1, 0, 0, 0, 0, 0, 1, 1]"
9032,1,1,2,0.6768170406218271,"[1, 1, 1, 1, 0, 0, 1, 1, 1, 0]"
9033,1,1,2,0.35807438805426073,"[1, 0, 1, 1, 1, 1, 0, 1, 0, 0]"
9034,4,4,8,0.355475326278203,"[1, 1, 1, 0, 1, 1, 1, 0, 1, 0]"
9035,3,3,6,0.1259220942506084,"[1, 0, 0, 0, 0, 0, 0, 1, 1, 1]"
9036,3,3,6,0.9822722063643053,"[1, 0, 1, 1, 0, 1, 1, 0, 0, 0]"
9037,1,1,2,0.7137480312450563,"[1, 0, 1, 0, 1, 0, 0, 0, 0, 0]"
9038,1,1,2,0.4172757131729632,"[0, 0, 1, 1, 0, 1, 1, 1, 0, 0]"
9039,2,2,4,0.9635454653261544,"[0, 1, 0, 1, 0, 1, 0, 0, 0, 1]"
9040,1,1,2,0.5459951152434827,"[1, 1, 1, 0, 1, 1, 0, 0, 0, 0]"
9041,1,1,2,0.039119786362852293,"[0, 0, 1, 1, 1, 1, 0, 0, 0, 0]"
9042,1,1,2,0.9015391485261011,"[0, 0, 0, 1, 0, 0, 0, 1, 1, 0]"
9043,1,1,2,0.8428071760272976,"[1, 1, 0, 1, 0, 0, 1, 1, 1, 1]"
9044,1,1,2,0.545230074075729,"[1, 1, 0, 0, 0, 0, 1, 0, 0, 0]"
9045,2,2,4,0.29039659711016186,"[0, 1, 0, 1, 1, 1, 1, 1, 0, 0]"
9046,4,4,8,0.006197638577105979,"[1, 1, 1, 1, 0, 0, 0, 1, 0, 0]"
9047,3,3,6,0.5819468635988645,"[0, 0, 1, 0, 0, 1, 0, 0, 1, 1]"
9048,2,2,4,0.016230471771348065,"[1, 1, 1, 1, 1, 0, 0, 0, 1, 0]"
9049,3,3,6,0.449918539759243,"[1, 1, 0, 0, 1, 1, 0, 1, 1, 1]"
9050,1,1,2,0.8718802500489731,"[0, 0, 1, 0, 0, 0, 0, 1, 1, 1]"
9051,1,1,2,0.9395943997540088,"[1, 0, 1, 1, 0, 0, 1, 0, 1, 0]"
9052,1,1,2,0.9069441006216495,"[1, 1, 0, 1, 0, 1, 0, 0, 1, 1]"
9053,2,2,4,0.5742345476720364,"[0, 1, 1, 1, 0, 1, 1, 0, 0, 1]"
9054,1,1,2,0.8607500274980469,"[0, 0, 0, 0, 1, 0, 1, 0, 0, 0]"
9055,1,1,2,0.5085996946811185,"[1, 0, 0, 0, 0, 1, 0, 1, 0, 0]"
9056,1,1,2,0.3913937865961856,"[0, 1, 1, 0, 0, 0, 0, 0, 0, 1]"
9057,1,1,2,0.3970804136802272,"[1, 0, 0, 0, 1, 0, 0, 0, 1, 0]"
9058,2,2,4,0.15355036032294833,"[1, 0, 1, 0, 0, 1, 0, 0, 0, 1]"
9059,1,1,2,0.03629409755692514,"[0, 0, 1, 1, 0, 0, 1, 0, 0, 1]"
9060,1,1,2,0.17327442957209538,"[1, 1, 0, 0, 0, 1, 0, 0, 0, 1]"
9061,1,1,2,0.235752215120136,"[1, 1, 0, 1, 0, 0, 1, 1, 0, 1]"
9062,1,1,2,0.19551810729886399,"[0, 0, 0, 0, 0, 1, 0, 0, 1, 0]"
9063,1,1,2,0.6829006179578649,"[1, 0, 0, 1, 0, 0, 0, 1, 1, 1]"
9064,1,1,2,0.5076581324007677,"[1, 1, 0, 0, 1, 1, 1, 0, 1, 0]"
9065,2,2,4,0.3901669327596132,"[0, 0, 0, 0, 0, 1, 0, 1, 1, 1]"
9066,1,1,2,0.6304509225815075,"[0, 0, 0, 0, 1, 1, 1, 1, 0, 1]"
9067,3,3,6,0.13139540865677513,"[1, 0, 0, 0, 1, 0, 1, 0, 0, 0]"
9068,3,3,6,0.04542495994833673,"[1, 1, 1, 1, 1, 1, 0, 1, 1, 0]"
9069,1,1,2,0.1296945907126129,"[0, 1, 0, 1, 1, 0, 1, 0, 0, 0]"
9070,2,2,4,0.29780222131991874,"[1, 1, 0, 1, 1, 0, 1, 0, 0, 1]"
9071,1,1,2,0.3031281816909286,"[0, 1, 0, 1, 1, 0, 0, 1, 0, 0]"
9072,1,1,2,0.5009293741810079,"[1, 0, 0, 0, 1, 0, 1, 1, 1, 0]"
9073,1,1,2,0.8732451329446179,"[1, 1, 1, 0, 1, 1, 1, 1, 0, 1]"
9074,1,1,2,0.573311649211204,"[0, 1, 1, 0, 1, 0, 0, 0, 0, 1]"
9075,1,1,2,0.028636411575975296,"[0, 1, 1, 1, 1, 0, 1, 0, 0, 0]"
9076,1,1,2,0.9167182654617912,"[1, 1, 0, 0, 1, 0, 0, 0, 0, 1]"
9077,1,1,2,0.9767426315580855,"[0, 0, 0, 0, 0, 0, 0, 1, 0, 1]"
9078,1,1,2,0.0698698917402849,"[0, 0, 0, 1, 0, 1, 1, 1, 0, 1]"
9079,1,1,2,0.3567865585468746,"[1, 0, 0, 0, 1, 0, 1, 0, 1, 0]"
9080,1,1,2,0.32047897740374787,"[0, 1, 0, 0, 0, 0, 1, 0, 0, 1]"
9081,1,1,2,0.3499482242724552,"[0, 0, 1, 0, 0, 1, 0, 1, 0, 1]"
9082,1,1,2,0.8836820244693286,"[0, 1, 0, 0, 1, 1, 1, 0, 0, 1]"
9083,1,1,2,0.8590133660272422,"[1, 1, 0, 0, 1, 0, 0, 0, 0, 1]"
9084,1,1,2,0.21520581163173358,"[1, 0, 1, 1, 0, 0, 0, 0, 1, 1]"
9085,1,1,2,0.3049397510947439,"[1, 0, 0, 1, 1, 0, 0, 0, 1, 0]"
9086,1,1,2,0.9141665322055745,"[1, 0, 0, 0, 0, 0, 1, 1, 1, 0]"
9087,1,1,2,0.8638833179602554,"[0, 1, 0, 0, 1, 0, 1, 0, 0, 1]"
9088,1,1,2,0.5657677420374471,"[0, 0, 0, 0, 0, 1, 0, 0, 1, 0]"
9089,1,1,2,0.6460076101719278,"[0, 0, 0, 0, 0, 0, 0, 0, 1, 1]"
9090,1,1,2,0.02833343628803897,"[0, 1, 1, 1, 0, 0, 0, 0, 0, 1]"
9091,1,1,2,0.8922187258817464,"[0, 0, 0, 0, 1, 0, 1, 0, 0, 1]"
9092,1,1,2,0.5488884596156808,"[1, 1, 0, 0, 1, 0, 1, 0, 0, 0]"
9093,1,1,2,0.9375774882923954,"[0, 1, 0, 0, 0, 0, 1, 1, 1, 0]"
9094,1,1,2,0.7500533434850899,"[0, 0, 0, 1, 0, 0, 1, 0, 0, 0]"
9095,1,1,2,0.7401384222293677,"[1, 0, 0, 0, 1, 1, 1, 1, 1, 1]"
9096,1,1,2,0.9512062470678782,"[1, 0, 1, 1, 1, 1, 1, 1, 0, 0]"
9097,1,1,2,0.008261176563441608,"[0, 1, 0, 0, 0, 0, 0, 0, 1, 0]"
9098,1,1,2,0.8704950879854035,"[0, 0, 1, 1, 0, 1, 0, 0, 1, 0]"
9099,1,1,2,0.6898877616075084,"[1, 0, 0, 1, 1, 0, 1, 1, 1, 0]"
9100,1,1,2,0.9585415849867733,"[0, 1, 0, 1, 0, 0, 0, 0, 1, 0]"
9101,1,1,2,0.5776399665123457,"[1, 0, 0, 0, 1, 0, 1, 0, 0, 0]"
9102,1,1,2,0.6477206257523399,"[0, 1, 1, 1, 0, 1, 1, 0, 1, 0]"
9103,9,9,18,0.9723055697710403,"[1, 0, 1, 1, 1, 1, 0, 1, 1, 0]"
9104,1,1,2,0.5100706889761546,"[1, 0, 0, 0, 0, 0, 0, 0, 1, 0]"
9105,1,1,2,0.3483544874627219,"[0, 0, 0, 1, 0, 0, 1, 0, 1, 1]"
9106,1,1,2,0.9118209004997624,"[1, 0, 0, 1, 1, 0, 1, 0, 0, 0]"
9107,1,1,2,0.4365004420732699,"[0, 1, 0, 0, 0, 1, 1, 1, 1, 1]"
9108,3,3,6,0.9336355127184185,"[1, 0, 0, 0, 1, 1, 0, 1, 0, 1]"
9109,1,1,2,0.4950817441584501,"[0, 0, 0, 1, 0, 0, 1, 1, 0, 0]"
9110,1,1,2,0.6094747011581134,"[0, 0, 0, 0, 1, 1, 1, 1, 1, 1]"
9111,1,1,2,0.31386113569556007,"[0, 1, 1, 1, 1, 0, 1, 1, 1, 1]"
9112,1,1,2,0.42336566143349863,"[1, 1, 0, 0, 0, 1, 0, 1, 0, 0]"
9113,1,1,2,0.5978539628088692,"[1, 1, 0, 0, 1, 1, 0, 1, 1, 0]"
9114,3,3,6,0.1708211909082472,"[0, 1, 1, 0, 0, 0, 0, 0, 0, 1]"
9115,2,2,4,0.7337817176965721,"[1, 0, 0, 1, 0, 0, 1, 0, 0, 1]"
9116,2,2,4,0.02635594507829242,"[0, 0, 1, 0, 1, 0, 0, 0, 1, 0]"
9117,2,2,4,0.14241051866865195,"[1, 1, 0, 0, 0, 1, 0, 0, 0, 1]"
9118,1,1,2,0.33115713340767094,"[1, 1, 1, 1, 0, 0, 1, 0, 1, 1]"
9119,1,1,2,0.06415013469577446,"[1, 1, 0, 0, 1, 0, 1, 0, 0, 1]"
9120,2,2,4,0.834381286446461,"[0, 1, 1, 0, 0, 0, 0, 0, 1, 0]"
9121,1,1,2,0.8497749172079488,"[0, 1, 1, 1, 0, 0, 0, 0, 1, 0]"
9122,1,1,2,0.8141834743473845,"[0, 1, 0, 0, 0, 0, 0, 0, 0, 0]"
9123,1,1,2,0.5047256653618584,"[1, 1, 0, 1, 1, 1, 1, 1, 1, 0]"
9124,1,1,2,0.9176324350030272,"[1, 1, 1, 1, 1, 1, 1, 1, 1, 1]"
9125,1,1,2,0.3798251589942476,"[0, 1, 0, 0, 0, 1, 1, 1, 0, 1]"
9126,1,1,2,0.09163617440423599,"[0, 1, 1, 1, 0, 1, 1, 0, 0, 0]"
9127,4,4,8,0.2282891604297249,"[0, 0, 1, 0, 0, 0, 1, 1, 0, 1]"
9128,1,1,2,0.3627859291790696,"[1, 1, 0, 0, 1, 0, 0, 0, 1, 1]"
9129,1,1,2,0.18987058106220467,"[1, 1, 1, 0, 0, 1, 1, 0, 0, 1]"
9130,1,1,2,0.023342537053102186,"[0, 0, 1, 0, 0, 0, 0, 1, 0, 0]"
9131,1,1,2,0.664197612830586,"[0, 0, 1, 0, 0, 0, 1, 1, 1, 1]"
9132,1,1,2,0.5425065756187379,"[1, 0, 1, 0, 0, 0, 0, 0, 0, 0]"
9133,1,1,2,0.8889845631351656,"[1, 0, 0, 1, 1, 0, 1, 0, 0, 1]"
9134,1,1,2,0.14752600072651045,"[1, 1, 0, 0, 0, 0, 0, 1, 1, 1]"
9135,1,1,2,0.7368176596968535,"[0, 0, 0, 1, 1, 1, 0, 1, 0, 0]"
9136,1,1,2,0.2527625743412012,"[0, 1, 1, 1, 1, 1, 1, 1, 0, 0]"
9137,3,3,6,0.6011858501320123,"[1, 1, 1, 1, 1, 1, 0, 1, 0, 0]"
9138,1,1,2,0.2809993919578506,"[1, 1, 0, 1, 1, 1, 0, 0, 0, 1]"
9139,1,1,2,0.9344410304602884,"[0, 1, 1, 0, 1, 0, 1, 1, 1, 1]"
9140,1,1,2,0.3139451314089916,"[1, 1, 1, 1, 0, 1, 0, 1, 0, 0]"
9141,1,1,2,0.9796359783105854,"[0, 1, 0, 0, 1, 0, 0, 1, 0, 1]"
9142,2,2,4,0.503729172030507,"[1, 0, 0, 0, 0, 0, 1, 0, 1, 0]"
9143,1,1,2,0.5580069081485812,"[1, 1, 1, 1, 0, 1, 1, 0, 0, 0]"
9144,2,2,4,0.22801937483336443,"[0, 1, 1, 0, 1, 1, 0, 0, 1, 1]"
9145,1,1,2,0.13799307006523687,"[1, 1, 1, 1, 0, 1, 1, 1, 1, 0]"
9146,3,3,6,0.7650607800624691,"[0, 1, 0, 0, 1, 0, 1, 1, 1, 1]"
9147,1,1,2,0.05083288154039711,"[0, 1, 0, 0, 0, 1, 0, 1, 1, 1]"
9148,1,1,2,0.23284938083109052,"[0, 1, 0, 1, 0, 1, 1, 1, 1, 1]"
9149,1,1,2,0.9683316780786061,"[0, 0, 0, 0, 0, 1, 1, 1, 0, 0]"
9150,1,1,2,0.17065056077306828,"[1, 1, 0, 1, 0, 1, 0, 1, 1, 1]"
9151,1,1,2,0.4371479345568856,"[1, 1, 0, 0, 0, 0, 0, 0, 0, 1]"
9152,1,1,2,0.29623229482752333,"[1, 0, 0, 0, 1, 0, 1, 1, 0, 1]"
9153,1,1,2,0.014903434967165619,"[1, 1, 1, 1, 1, 1, 0, 0, 1, 1]"
9154,2,2,4,0.14960822440904264,"[1, 0, 0, 1, 0, 0, 1, 0, 0, 0]"
9155,1,1,2,0.31363659735740235,"[0, 1, 0, 1, 0, 0, 0, 1, 1, 1]"
9156,2,2,4,0.2226374212773975,"[1, 0, 1, 1, 0, 0, 1, 0, 1, 1]"
9157,1,1,2,0.9298057684552384,"[1, 1, 0, 0, 1, 1, 0, 1, 1, 1]"
9158,2,2,4,0.9922865788032018,"[1, 0, 0, 0, 0, 0, 1, 1, 0, 0]"
9159,1,1,2,0.4727708901761145,"[0, 0, 1, 0, 0, 1, 1, 1, 1, 1]"
9160,2,2,4,0.9615665801048087,"[1, 0, 1, 1, 1, 0, 0, 1, 1, 0]"
9161,1,1,2,0.8464881027334893,"[1, 1, 0, 1, 1, 1, 0, 0, 0, 1]"
9162,2,2,4,0.9552204696925028,"[1, 0, 1, 1, 1, 1, 1, 0, 0, 0]"
9163,3,3,6,0.1791043653279345,"[1, 1, 1, 0, 1, 1, 0, 0, 1, 1]"
9164,1,1,2,0.8500629749235592,"[0, 1, 0, 0, 1, 1, 0, 1, 0, 1]"
9165,2,2,4,0.8714821515578011,"[1, 0, 1, 0, 0, 1, 0, 1, 1, 0]"
9166,1,1,2,0.7402739304619784,"[1, 0, 0, 1, 1, 0, 0, 1, 1, 0]"
9167,1,1,2,0.5652917095830725,"[1, 1, 1, 0, 1, 0, 1, 0, 0, 1]"
9168,1,1,2,0.7913425747386899,"[0, 0, 1, 1, 1, 0, 1, 1, 0, 1]"
9169,1,1,2,0.5590185514006256,"[0, 0, 0, 1, 1, 0, 1, 0, 0, 1]"
9170,3,3,6,0.2788357121020154,"[1, 1, 0, 1, 1, 1, 0, 1, 0, 1]"
9171,1,1,2,0.9995686921374698,"[1, 0, 0, 1, 0, 0, 1, 1, 0, 0]"
9172,1,1,2,0.05167577221037545,"[1, 0, 1, 1, 1, 0, 1, 0, 1, 1]"
9173,2,2,4,0.9243955588384313,"[1, 1, 1, 1, 1, 0, 0, 1, 1, 1]"
9174,2,2,4,0.3526891406513104,"[1, 1, 0, 1, 1, 0, 0, 0, 0, 1]"
9175,1,1,2,0.15326898874250228,"[1, 1, 1, 1, 0, 1, 1, 0, 1, 1]"
9176,5,5,10,0.6337717466977335,"[0, 1, 0, 1, 1, 1, 0, 1, 1, 0]"
9177,1,1,2,0.6870867616385699,"[0, 0, 1, 0, 0, 1, 0, 0, 0, 1]"
9178,1,1,2,0.7589164245521347,"[0, 0, 0, 1, 1, 0, 1, 1, 1, 1]"
9179,1,1,2,0.42077175530069333,"[0, 0, 0, 1, 0, 1, 1, 1, 0, 0]"
9180,1,1,2,0.04308554361285555,"[0, 0, 0, 0, 1, 1, 1, 1, 0, 1]"
9181,2,2,4,0.9390187709147906,"[1, 1, 0, 1, 0, 0, 0, 1, 0, 0]"
9182,2,2,4,0.8693965378402266,"[1, 1, 1, 0, 1, 1, 1, 0, 0, 0]"
9183,1,1,2,0.07682734077179065,"[0, 0, 0, 0, 1, 1, 1, 1, 1, 0]"
9184,1,1,2,0.723305014038729,"[0, 0, 0, 0, 0, 0, 1, 0, 1, 1]"
9185,3,3,6,0.4428651608635068,"[0, 1, 0, 0, 1, 1, 1, 0, 0, 0]"
9186,2,2,4,0.15090757949557398,"[1, 1, 0, 1, 0, 0, 1, 1, 0, 0]"
9187,2,2,4,0.4124295158659784,"[1, 0, 1, 0, 0, 1, 0, 0, 0, 0]"
9188,2,2,4,0.9708935730365987,"[1, 1, 0, 0, 0, 0, 0, 0, 1, 0]"
9189,1,1,2,0.21585022695804557,"[0, 0, 1, 0, 0, 0, 0, 0, 0, 0]"
9190,1,1,2,0.6738711242328799,"[1, 1, 1, 0, 0, 1, 1, 1, 0, 0]"
9191,2,2,4,0.5011357914114823,"[0, 0, 1, 0, 0, 0, 1, 1, 1, 0]"
9192,2,2,4,0.48373944339499775,"[1, 0, 1, 0, 1, 0, 1, 0, 1, 0]"
9193,1,1,2,0.16182633482438102,"[0, 1, 1, 1, 0, 1, 1, 1, 1, 1]"
9194,1,1,2,0.05365440730275617,"[1, 1, 1, 1, 0, 1, 1, 0, 1, 1]"
9195,1,1,2,0.5563773717071107,"[1, 0, 1, 1, 1, 1, 0, 0, 1, 0]"
9196,6,6,12,0.05233835567066303,"[1, 1, 1, 1, 0, 0, 1, 1, 0, 0]"
9197,1,1,2,0.46876651349222553,"[1, 1, 1, 0, 1, 0, 1, 0, 1, 1]"
9198,1,1,2,0.6984498134452933,"[1, 1, 1, 0, 0, 1, 0, 0, 0, 0]"
9199,1,1,2,0.1776535658422761,"[0, 1, 1, 1, 0, 0, 0, 1, 1, 1]"
9200,1,1,2,0.020303136630048235,"[1, 1, 1, 1, 0, 1, 0, 0, 0, 1]"
9201,1,1,2,0.26313601491498184,"[1, 0, 0, 1, 1, 0, 1, 0, 1, 0]"
9202,3,3,6,0.12565403112198748,"[0, 1, 1, 0, 1, 1, 1, 0, 1, 0]"
9203,2,2,4,0.12147749360281135,"[0, 0, 1, 0, 1, 1, 0, 1, 0, 0]"
9204,1,1,2,0.718932823577492,"[1, 1, 0, 1, 1, 0, 1, 0, 1, 1]"
9205,1,1,2,0.2791966876617743,"[0, 0, 0, 0, 1, 1, 0, 0, 1, 1]"
9206,1,1,2,0.5002701285459429,"[0, 1, 0, 0, 0, 0, 1, 0, 1, 0]"
9207,2,2,4,0.5213184879139882,"[1, 1, 0, 0, 1, 0, 0, 1, 1, 0]"
9208,1,1,2,0.30973085906421916,"[0, 0, 1, 0, 1, 0, 0, 0, 0, 0]"
9209,4,4,8,0.9417491749329634,"[0, 0, 1, 1, 0, 1, 0, 0, 1, 0]"
9210,1,1,2,0.9370387110837952,"[0, 0, 0, 1, 0, 1, 0, 0, 1, 1]"
9211,1,1,2,0.5625099549954544,"[1, 0, 0, 1, 0, 0, 0, 0, 0, 1]"
9212,1,1,2,0.5520281925328575,"[1, 0, 0, 0, 0, 1, 0, 0, 1, 1]"
9213,1,1,2,0.3120740702274707,"[1, 0, 0, 1, 0, 1, 0, 1, 1, 1]"
9214,1,1,2,0.2113523486822837,"[1, 0, 0, 0, 0, 1, 0, 0, 1, 0]"
9215,2,2,4,0.15876999318054175,"[0, 1, 0, 0, 0, 1, 1, 1, 1, 0]"
9216,2,2,4,0.5353059608488266,"[0, 0, 1, 0, 1, 0, 0, 1, 0, 0]"
9217,1,1,2,0.8799573787318878,"[0, 0, 1, 1, 0, 1, 0, 1, 0, 1]"
9218,1,1,2,0.8659893447855804,"[1, 0, 0, 0, 0, 1, 1, 1, 0, 1]"
9219,2,2,4,0.03471277508005255,"[0, 1, 1, 1, 0, 1, 1, 1, 1, 1]"
9220,1,1,2,0.3099214244659163,"[1, 1, 1, 0, 1, 1, 1, 0, 1, 0]"
9221,1,1,2,0.04184623396704468,"[1, 0, 1, 0, 0, 1, 1, 1, 1, 0]"
9222,1,1,2,0.6387454578125114,"[1, 1, 0, 1, 0, 1, 0, 1, 1, 1]"
9223,1,1,2,0.13258179826529015,"[1, 0, 0, 1, 1, 1, 0, 0, 0, 0]"
9224,1,1,2,0.21020724713117667,"[0, 0, 0, 0, 0, 0, 0, 0, 1, 0]"
9225,2,2,4,0.6616361677668592,"[1, 1, 1, 1, 1, 1, 1, 1, 0, 1]"
9226,1,1,2,0.33200404492038726,"[0, 1, 1, 0, 1, 1, 0, 1, 1, 1]"
9227,2,2,4,0.0044642439125383016,"[0, 1, 1, 1, 1, 0, 1, 0, 0, 1]"
9228,1,1,2,0.565522750667446,"[1, 0, 1, 0, 0, 0, 0, 1, 1, 0]"
9229,1,1,2,0.9635838891936479,"[0, 0, 1, 0, 1, 0, 1, 0, 0, 0]"
9230,1,1,2,0.21416518853402267,"[1, 1, 0, 1, 0, 1, 0, 0, 0, 0]"
9231,1,1,2,0.5120747095373758,"[0, 1, 0, 1, 0, 0, 0, 0, 1, 0]"
9232,1,1,2,0.3486174612637254,"[0, 0, 1, 0, 0, 1, 1, 0, 0, 1]"
9233,1,1,2,0.2911492807450693,"[0, 0, 0, 0, 1, 1, 0, 1, 0, 0]"
9234,1,1,2,0.14026662784984534,"[1, 1, 0, 0, 1, 1, 1, 1, 1, 1]"
9235,2,2,4,0.7977370551598096,"[1, 1, 1, 1, 0, 1, 0, 1, 1, 1]"
9236,1,1,2,0.6100207034619021,"[0, 0, 1, 0, 0, 1, 1, 0, 0, 0]"
9237,1,1,2,0.32484813557618697,"[1, 0, 0, 1, 1, 1, 1, 1, 1, 0]"
9238,1,1,2,0.036816331657852586,"[0, 0, 0, 0, 1, 1, 0, 1, 1, 0]"
9239,1,1,2,0.996116489474726,"[1, 1, 0, 0, 0, 1, 1, 0, 1, 1]"
9240,1,1,2,0.24505605994656177,"[0, 0, 1, 0, 1, 1, 1, 0, 1, 0]"
9241,1,1,2,0.489315666920752,"[0, 0, 0, 0, 0, 1, 0, 1, 1, 1]"
9242,3,3,6,0.04430916279653574,"[1, 1, 1, 0, 1, 0, 0, 1, 1, 1]"
9243,1,1,2,0.6994476461036779,"[1, 1, 1, 1, 0, 0, 0, 1, 1, 0]"
9244,1,1,2,0.7487816107541796,"[0, 0, 0, 0, 0, 0, 1, 0, 1, 1]"
9245,1,1,2,0.7050867612533339,"[1, 0, 0, 0, 0, 0, 0, 1, 0, 0]"
9246,1,1,2,0.5156778101829311,"[1, 0, 1, 0, 1, 0, 0, 1, 0, 1]"
9247,4,4,8,0.5037388206576318,"[0, 1, 0, 1, 0, 0, 1, 1, 1, 1]"
9248,2,2,4,0.4178876446847348,"[0, 0, 1, 1, 0, 0, 1, 1, 1, 1]"
9249,1,1,2,0.17753340214483948,"[0, 1, 1, 0, 0, 0, 1, 0, 0, 0]"
9250,1,1,2,0.581930426619405,"[1, 0, 1, 1, 1, 0, 1, 1, 1, 1]"
9251,1,1,2,0.43326459129045225,"[1, 1, 0, 0, 0, 1, 1, 1, 0, 0]"
9252,1,1,2,0.18875104552628896,"[1, 0, 1, 1, 0, 1, 0, 1, 0, 0]"
9253,2,2,4,0.2806055646089597,"[1, 1, 0, 0, 1, 1, 0, 1, 1, 0]"
9254,2,2,4,0.9017313076634895,"[1, 0, 1, 1, 0, 1, 0, 0, 1, 1]"
9255,2,2,4,0.47118117334494225,"[1, 1, 1, 0, 1, 0, 1, 0, 1, 1]"
9256,1,1,2,0.8591805595760919,"[1, 0, 1, 0, 0, 1, 1, 1, 1, 1]"
9257,3,3,6,0.23757111222126603,"[0, 0, 1, 0, 1, 1, 0, 1, 0, 1]"
9258,1,1,2,0.7425835419622726,"[1, 0, 1, 0, 0, 1, 0, 1, 0, 1]"
9259,1,1,2,0.7620050549830979,"[1, 1, 1, 0, 0, 1, 1, 0, 0, 1]"
9260,2,2,4,0.003469534773418048,"[0, 0, 0, 1, 0, 0, 0, 0, 1, 1]"
9261,1,1,2,0.8867645268332057,"[0, 1, 1, 0, 1, 1, 1, 1, 0, 0]"
9262,1,1,2,0.7585552062842005,"[1, 0, 0, 0, 1, 1, 0, 1, 0, 1]"
9263,1,1,2,0.9933272139594245,"[0, 0, 1, 0, 1, 0, 0, 1, 0, 0]"
9264,1,1,2,0.6913733419134263,"[0, 0, 0, 1, 1, 0, 1, 0, 0, 0]"
9265,1,1,2,0.6000872839752054,"[1, 0, 1, 0, 1, 0, 0, 1, 1, 0]"
9266,2,2,4,0.3032483550125594,"[1, 1, 1, 0, 0, 1, 1, 1, 1, 0]"
9267,2,2,4,0.7247061328357793,"[0, 0, 1, 0, 1, 1, 1, 0, 0, 1]"
9268,1,1,2,0.2956672076316387,"[0, 0, 0, 0, 0, 0, 1, 0, 1, 1]"
9269,2,2,4,0.6115707091746382,"[0, 0, 1, 1, 1, 1, 0, 1, 1, 0]"
9270,1,1,2,0.8797538914099715,"[0, 1, 1, 0, 1, 0, 1, 1, 0, 1]"
9271,2,2,4,0.24416735056007866,"[1, 0, 1, 0, 0, 1, 0, 0, 1, 1]"
9272,2,2,4,0.7407330704771337,"[0, 1, 0, 1, 0, 1, 0, 1, 1, 1]"
9273,1,1,2,0.38053228380219795,"[0, 1, 1, 0, 0, 1, 0, 0, 1, 0]"
9274,1,1,2,0.07813989574588476,"[1, 0, 1, 1, 0, 0, 1, 0, 1, 0]"
9275,2,2,4,0.5831969450856751,"[0, 0, 0, 1, 1, 0, 1, 0, 1, 0]"
9276,1,1,2,0.9557221154966034,"[1, 1, 0, 0, 0, 0, 1, 0, 0, 1]"
9277,1,1,2,0.345759819470405,"[0, 0, 0, 1, 1, 1, 0, 1, 1, 0]"
9278,2,2,4,0.5310998870686309,"[1, 1, 1, 1, 1, 0, 0, 0, 1, 0]"
9279,4,4,8,0.9327713716369195,"[1, 0, 0, 0, 0, 0, 1, 0, 1, 1]"
9280,1,1,2,0.882950492355675,"[0, 0, 0, 0, 0, 1, 1, 0, 1, 1]"
9281,1,1,2,0.5250326389599327,"[1, 0, 0, 1, 1, 0, 1, 1, 0, 1]"
9282,2,2,4,0.1386294161243271,"[1, 0, 1, 0, 1, 1, 0, 0, 1, 0]"
9283,1,1,2,0.18602696800643648,"[0, 0, 1, 0, 0, 0, 1, 0, 1, 0]"
9284,1,1,2,0.7096118075209499,"[1, 0, 0, 1, 0, 1, 1, 0, 1, 1]"
9285,2,2,4,0.025170497483947618,"[0, 1, 1, 1, 1, 0, 0, 1, 1, 0]"
9286,1,1,2,0.6689302081241136,"[1, 1, 1, 1, 1, 1, 1, 1, 0, 1]"
9287,1,1,2,0.560233147816862,"[1, 1, 1, 0, 0, 0, 1, 1, 1, 1]"
9288,1,1,2,0.3803834686154042,"[0, 0, 1, 1, 0, 1, 0, 0, 1, 0]"
9289,1,1,2,0.18478186446349965,"[1, 1, 1, 1, 0, 1, 1, 0, 1, 0]"
9290,1,1,2,0.612226360716,"[1, 1, 1, 1, 1, 0, 1, 0, 1, 0]"
9291,2,2,4,0.48364678940027983,"[1, 1, 1, 0, 1, 1, 0, 0, 1, 1]"
9292,1,1,2,0.2599519012469257,"[0, 0, 0, 1, 1, 0, 1, 0, 0, 1]"
9293,2,2,4,0.8586278329408562,"[1, 1, 0, 1, 1, 0, 1, 0, 0, 1]"
9294,1,1,2,0.29929309501992296,"[1, 1, 0, 1, 1, 1, 0, 1, 1, 1]"
9295,2,2,4,0.1833819005098154,"[0, 1, 0, 1, 1, 1, 0, 0, 1, 1]"
9296,1,1,2,0.5925639648619119,"[1, 1, 1, 1, 0, 1, 0, 0, 1, 1]"
9297,2,2,4,0.309939346173814,"[1, 0, 0, 1, 0, 0, 0, 1, 1, 1]"
9298,2,2,4,0.9307821286324036,"[1, 0, 0, 1, 1, 0, 0, 0, 0, 1]"
9299,2,2,4,0.46853108345580696,"[1, 1, 0, 1, 1, 0, 0, 0, 1, 0]"
9300,2,2,4,0.17034337474994687,"[0, 0, 0, 0, 0, 1, 1, 0, 1, 1]"
9301,1,1,2,0.45581197725516187,"[1, 0, 0, 1, 1, 1, 0, 1, 0, 1]"
9302,1,1,2,0.49491808268875903,"[1, 0, 1, 1, 0, 1, 0, 1, 1, 1]"
9303,1,1,2,0.35495499717962065,"[0, 0, 1, 0, 0, 1, 0, 1, 0, 0]"
9304,2,2,4,0.7828447486844947,"[1, 0, 1, 1, 1, 0, 1, 0, 0, 1]"
9305,1,1,2,0.4648905880056786,"[1, 1, 1, 1, 0, 0, 1, 1, 1, 0]"
9306,1,1,2,0.3427974232540255,"[0, 1, 1, 1, 1, 1, 0, 0, 0, 0]"
9307,2,2,4,0.48155562989350853,"[0, 0, 1, 1, 1, 0, 1, 0, 0, 0]"
9308,2,2,4,0.6548108979556674,"[0, 0, 0, 1, 1, 1, 1, 0, 1, 1]"
9309,1,1,2,0.5569692364075699,"[1, 0, 0, 0, 1, 1, 1, 0, 1, 0]"
9310,2,2,4,0.6103021608537678,"[1, 1, 0, 1, 1, 1, 0, 0, 0, 1]"
9311,1,1,2,0.3098914032840817,"[0, 0, 0, 1, 1, 0, 0, 1, 0, 0]"
9312,1,1,2,0.7579706299449824,"[0, 1, 0, 0, 1, 0, 1, 0, 1, 1]"
9313,2,2,4,0.32472005065851384,"[1, 0, 0, 0, 1, 0, 1, 0, 0, 1]"
9314,3,3,6,0.1471532998488695,"[0, 0, 0, 0, 1, 1, 1, 1, 1, 1]"
9315,1,1,2,0.6916657711842277,"[0, 0, 0, 0, 0, 1, 0, 0, 1, 1]"
9316,1,1,2,0.7110861239902447,"[1, 0, 0, 1, 0, 1, 0, 0, 1, 0]"
9317,2,2,4,0.5569808743638962,"[1, 1, 1, 0, 0, 0, 1, 1, 0, 1]"
9318,2,2,4,0.7060777189585511,"[0, 1, 0, 0, 0, 0, 0, 1, 0, 1]"
9319,3,3,6,0.40906753453147515,"[1, 1, 1, 1, 0, 1, 1, 1, 1, 0]"
9320,1,1,2,0.7355449498521303,"[0, 0, 0, 1, 0, 0, 1, 1, 1, 1]"
9321,1,1,2,0.9330759010351996,"[0, 0, 1, 1, 1, 0, 1, 0, 1, 1]"
9322,1,1,2,0.7604070223691014,"[0, 1, 1, 1, 1, 0, 0, 1, 0, 0]"
9323,1,1,2,0.3383043794985884,"[1, 1, 0, 1, 0, 0, 0, 0, 0, 1]"
9324,1,1,2,0.26867703832572765,"[1, 1, 1, 0, 1, 1, 1, 0, 1, 1]"
9325,1,1,2,0.2844757838301517,"[0, 1, 1, 1, 1, 0, 0, 1, 0, 1]"
9326,1,1,2,0.8915262896577681,"[1, 1, 1, 0, 0, 1, 1, 0, 1, 0]"
9327,1,1,2,0.27013893825296353,"[0, 0, 1, 1, 1, 0, 0, 1, 1, 1]"
9328,1,1,2,0.7424490825234759,"[1, 1, 0, 1, 1, 0, 0, 0, 0, 0]"
9329,2,2,4,0.9401575406843173,"[1, 0, 1, 1, 1, 1, 0, 0, 1, 0]"
9330,1,1,2,0.49569899336849266,"[0, 0, 0, 1, 1, 0, 1, 0, 1, 0]"
9331,1,1,2,0.512646302107943,"[0, 1, 0, 0, 1, 0, 0, 0, 0, 1]"
9332,1,1,2,0.6922970628138402,"[0, 0, 1, 0, 1, 0, 1, 1, 0, 1]"
9333,1,1,2,0.8716896541724019,"[0, 1, 0, 0, 0, 1, 1, 0, 1, 1]"
9334,3,3,6,0.34792669563906187,"[0, 1, 0, 1, 0, 1, 0, 1, 1, 1]"
9335,1,1,2,0.4069838982294103,"[1, 1, 0, 0, 1, 1, 1, 1, 1, 1]"
9336,1,1,2,0.907160943242022,"[0, 0, 0, 1, 1, 1, 0, 0, 0, 0]"
9337,1,1,2,0.046455872846086654,"[1, 0, 1, 1, 0, 0, 0, 0, 0, 1]"
9338,1,1,2,0.17232533929680516,"[1, 1, 1, 0, 1, 0, 0, 1, 1, 0]"
9339,1,1,2,0.6247043152636986,"[1, 0, 0, 0, 0, 0, 0, 0, 0, 1]"
9340,1,1,2,0.16956626207862668,"[1, 0, 0, 0, 0, 1, 1, 1, 0, 0]"
9341,1,1,2,0.6949809409965988,"[1, 1, 0, 0, 1, 0, 0, 0, 0, 0]"
9342,1,1,2,0.15286755314704337,"[1, 1, 0, 0, 1, 0, 0, 0, 0, 1]"
9343,1,1,2,0.552215321026562,"[0, 0, 0, 0, 1, 1, 1, 1, 0, 0]"
9344,1,1,2,0.7624529596097155,"[0, 0, 1, 0, 0, 1, 1, 1, 1, 1]"
9345,1,1,2,0.23021879499950426,"[0, 0, 0, 1, 1, 1, 0, 1, 0, 1]"
9346,1,1,2,0.3964393728216894,"[0, 1, 1, 0, 0, 1, 0, 0, 0, 1]"
9347,3,3,6,0.15604967862212182,"[1, 1, 1, 0, 0, 1, 1, 0, 0, 0]"
9348,1,1,2,0.3764514378832674,"[1, 0, 1, 1, 1, 0, 0, 0, 0, 1]"
9349,1,1,2,0.5752337723398906,"[0, 0, 1, 1, 0, 1, 0, 0, 1, 1]"
9350,1,1,2,0.5067753431739191,"[1, 1, 1, 0, 0, 1, 0, 1, 0, 0]"
9351,1,1,2,0.8786316543027664,"[0, 0, 1, 1, 1, 1, 1, 1, 1, 0]"
9352,1,1,2,0.7237254855739046,"[1, 1, 1, 1, 0, 1, 0, 0, 1, 0]"
9353,1,1,2,0.21342887653929998,"[0, 1, 0, 0, 0, 1, 1, 1, 1, 0]"
9354,1,1,2,0.18767936099239857,"[0, 0, 0, 1, 1, 0, 0, 0, 1, 0]"
9355,1,1,2,0.8846667194155446,"[1, 0, 1, 1, 1, 1, 0, 1, 1, 0]"
9356,2,2,4,0.8706992824348536,"[0, 1, 0, 1, 0, 1, 0, 1, 0, 1]"
9357,1,1,2,0.36229592215693707,"[0, 0, 1, 0, 1, 0, 0, 0, 0, 0]"
9358,1,1,2,0.31087224606057595,"[1, 1, 1, 0, 0, 0, 1, 1, 0, 1]"
9359,1,1,2,0.45706214651931654,"[0, 0, 0, 1, 0, 0, 0, 0, 0, 1]"
9360,2,2,4,0.21025142183005063,"[1, 1, 0, 0, 1, 1, 1, 0, 1, 1]"
9361,2,2,4,0.7063769979929528,"[0, 1, 1, 1, 1, 0, 0, 1, 1, 0]"
9362,2,2,4,0.4055793048919265,"[0, 0, 0, 1, 1, 0, 1, 1, 1, 1]"
9363,1,1,2,0.1271872014595079,"[0, 0, 1, 1, 1, 0, 0, 0, 1, 1]"
9364,1,1,2,0.13722510341994887,"[1, 1, 0, 0, 1, 0, 1, 1, 0, 0]"
9365,3,3,6,0.7841210010854852,"[1, 1, 1, 1, 1, 1, 1, 1, 0, 0]"
9366,2,2,4,0.21810192406887918,"[0, 1, 1, 1, 1, 0, 1, 1, 1, 0]"
9367,1,1,2,0.4386718477159578,"[1, 0, 0, 0, 1, 0, 1, 0, 1, 0]"
9368,1,1,2,0.7799492720443091,"[0, 0, 1, 0, 0, 1, 1, 0, 1, 0]"
9369,3,3,6,0.5409461116828911,"[0, 0, 1, 1, 0, 1, 0, 1, 1, 1]"
9370,3,3,6,0.7551277866236483,"[0, 1, 0, 0, 1, 1, 0, 1, 1, 0]"
9371,1,1,2,0.5274553185083127,"[0, 1, 0, 0, 0, 0, 0, 1, 0, 1]"
9372,1,1,2,0.8037147056627076,"[0, 1, 0, 1, 0, 1, 1, 0, 1, 0]"
9373,1,1,2,0.4933153229944255,"[1, 0, 1, 0, 1, 1, 0, 0, 1, 0]"
9374,1,1,2,0.38505381703748276,"[1, 0, 1, 1, 1, 0, 1, 1, 0, 0]"
9375,2,2,4,0.17741513474945048,"[0, 0, 1, 0, 0, 0, 1, 0, 0, 0]"
9376,1,1,2,0.4833571588938058,"[1, 1, 1, 1, 0, 1, 1, 1, 0, 1]"
9377,1,1,2,0.37346015535990673,"[1, 1, 1, 1, 1, 0, 0, 0, 1, 0]"
9378,3,3,6,0.14195845572524501,"[0, 0, 0, 1, 1, 1, 1, 0, 0, 0]"
9379,1,1,2,0.6237776896763194,"[1, 1, 1, 0, 0, 1, 0, 0, 0, 1]"
9380,1,1,2,0.2833498155428036,"[1, 1, 0, 0, 1, 1, 1, 1, 0, 1]"
9381,1,1,2,0.3625798030395396,"[0, 0, 1, 0, 0, 1, 0, 0, 0, 1]"
9382,1,1,2,0.7996222310313806,"[0, 0, 0, 0, 1, 0, 0, 0, 0, 0]"
9383,1,1,2,0.40115395912453033,"[0, 0, 1, 0, 0, 0, 0, 0, 0, 1]"
9384,1,1,2,0.5822976211793385,"[1, 0, 0, 0, 1, 1, 0, 1, 0, 1]"
9385,1,1,2,0.5499181688758478,"[0, 1, 0, 0, 0, 0, 0, 1, 0, 0]"
9386,1,1,2,0.2793141345519966,"[1, 0, 0, 0, 0, 1, 0, 1, 0, 0]"
9387,2,2,4,0.5121099736637946,"[0, 0, 0, 0, 1, 1, 1, 0, 0, 0]"
9388,1,1,2,0.6619197323785282,"[0, 0, 0, 0, 1, 1, 1, 0, 1, 0]"
9389,3,3,6,0.349324047404154,"[0, 0, 1, 0, 0, 1, 1, 0, 0, 1]"
9390,2,2,4,0.7040828627182423,"[1, 1, 1, 0, 0, 0, 1, 0, 0, 0]"
9391,2,2,4,0.08945569380247864,"[0, 1, 1, 1, 1, 0, 1, 1, 0, 0]"
9392,1,1,2,0.12127525547035889,"[0, 1, 0, 0, 1, 1, 0, 1, 0, 1]"
9393,1,1,2,0.5655571908511177,"[0, 1, 0, 0, 0, 1, 0, 0, 1, 0]"
9394,1,1,2,0.2750850546826803,"[0, 0, 1, 0, 0, 0, 0, 0, 0, 1]"
9395,1,1,2,0.39723703252428166,"[1, 1, 0, 0, 0, 0, 0, 0, 1, 0]"
9396,1,1,2,0.11188775480346824,"[1, 1, 1, 0, 1, 0, 0, 0, 1, 1]"
9397,3,3,6,0.6193746915847781,"[1, 0, 0, 1, 1, 1, 0, 0, 1, 1]"
9398,3,3,6,0.6663989363230817,"[1, 1, 1, 0, 0, 0, 1, 1, 0, 0]"
9399,1,1,2,0.018885470157571027,"[1, 1, 0, 1, 0, 0, 1, 0, 0, 1]"
9400,1,1,2,0.2993751969209345,"[0, 0, 0, 1, 0, 0, 0, 0, 1, 1]"
9401,1,1,2,0.5726777771858306,"[0, 1, 1, 1, 1, 0, 1, 0, 1, 0]"
9402,1,1,2,0.6147994858269847,"[1, 1, 0, 1, 1, 1, 1, 0, 0, 0]"
9403,1,1,2,0.753767098995639,"[1, 0, 1, 1, 1, 0, 0, 1, 1, 0]"
9404,1,1,2,0.3205596660745227,"[0, 0, 0, 0, 0, 0, 0, 1, 1, 0]"
9405,1,1,2,0.59864635446472,"[1, 0, 1, 1, 0, 0, 0, 1, 1, 1]"
9406,1,1,2,0.9593166127457506,"[1, 1, 0, 1, 0, 1, 0, 0, 1, 1]"
9407,4,4,8,0.508470514001773,"[0, 1, 1, 1, 1, 0, 0, 0, 0, 1]"
9408,1,1,2,0.1942110571752087,"[1, 0, 0, 1, 1, 0, 0, 0, 1, 0]"
9409,2,2,4,0.10270446521506738,"[1, 1, 1, 0, 1, 0, 1, 1, 0, 1]"
9410,2,2,4,0.9370662802560863,"[1, 0, 0, 0, 0, 1, 1, 1, 1, 1]"
9411,2,2,4,0.378947077501846,"[1, 1, 1, 1, 1, 0, 0, 1, 1, 0]"
9412,2,2,4,0.8402259624965085,"[1, 0, 1, 0, 0, 0, 1, 1, 1, 0]"
9413,1,1,2,0.9950544591920444,"[0, 0, 0, 1, 0, 1, 1, 1, 1, 0]"
9414,1,1,2,0.2081274268455996,"[0, 1, 0, 0, 1, 0, 1, 0, 0, 0]"
9415,1,1,2,0.45768307505520844,"[0, 0, 1, 1, 1, 0, 1, 0, 0, 1]"
9416,1,1,2,0.46639803222531506,"[0, 1, 0, 1, 1, 1, 0, 1, 1, 1]"
9417,1,1,2,0.3158267829918059,"[1, 1, 1, 0, 1, 0, 1, 1, 1, 1]"
9418,1,1,2,0.9244373575418411,"[1, 1, 0, 1, 1, 1, 0, 0, 1, 0]"
9419,1,1,2,0.08546072308983588,"[0, 1, 1, 0, 1, 1, 0, 1, 0, 0]"
9420,1,1,2,0.7357301121746952,"[1, 0, 0, 1, 1, 0, 0, 1, 0, 1]"
9421,1,1,2,0.2513086780882866,"[0, 0, 1, 0, 1, 0, 1, 1, 1, 1]"
9422,1,1,2,0.7634394328984685,"[0, 1, 0, 0, 1, 0, 1, 1, 1, 0]"
9423,2,2,4,0.7703435681103201,"[1, 0, 0, 0, 1, 1, 0, 1, 1, 0]"
9424,1,1,2,0.29600421530323573,"[1, 0, 0, 0, 0, 0, 0, 0, 0, 1]"
9425,1,1,2,0.8497055075430431,"[0, 0, 1, 0, 0, 0, 1, 1, 0, 0]"
9426,1,1,2,0.4832730163143468,"[0, 1, 0, 1, 0, 0, 0, 1, 0, 1]"
9427,1,1,2,0.8514234156719304,"[0, 0, 0, 0, 0, 0, 0, 0, 0, 1]"
9428,2,2,4,0.7070798932536644,"[0, 0, 0, 1, 1, 1, 0, 0, 0, 1]"
9429,1,1,2,0.47630117974973496,"[1, 1, 0, 1, 0, 0, 1, 0, 1, 0]"
9430,3,3,6,0.9308284851521872,"[0, 1, 0, 1, 0, 1, 0, 1, 0, 0]"
9431,1,1,2,0.9247968824796065,"[0, 0, 0, 1, 0, 0, 1, 1, 1, 1]"
9432,1,1,2,0.1867490861698352,"[1, 0, 1, 1, 0, 1, 0, 0, 1, 1]"
9433,2,2,4,0.11274356864772173,"[1, 1, 0, 0, 1, 0, 1, 1, 1, 0]"
9434,1,1,2,0.22961251163638108,"[0, 1, 1, 1, 1, 1, 0, 0, 1, 1]"
9435,1,1,2,0.799701180388207,"[1, 0, 1, 0, 0, 0, 0, 0, 1, 0]"
9436,1,1,2,0.07407290918267329,"[1, 1, 0, 1, 0, 1, 1, 0, 0, 1]"
9437,1,1,2,0.9368367537939826,"[0, 1, 1, 1, 0, 1, 0, 0, 0, 0]"
9438,2,2,4,0.9355429849911033,"[1, 0, 0, 0, 0, 0, 0, 0, 1, 1]"
9439,1,1,2,0.8171078408317983,"[1, 1, 0, 0, 1, 0, 1, 1, 1, 0]"
9440,1,1,2,0.2881303892576368,"[1, 0, 0, 0, 0, 0, 0, 0, 1, 1]"
9441,1,1,2,0.6002086221373218,"[0, 0, 0, 1, 0, 0, 1, 0, 1, 1]"
9442,1,1,2,0.9532814560544958,"[0, 1, 0, 1, 0, 1, 0, 1, 0, 1]"
9443,1,1,2,0.9730070653325529,"[0, 1, 1, 1, 1, 0, 0, 1, 0, 1]"
9444,2,2,4,0.7293757831663382,"[1, 0, 1, 1, 0, 1, 1, 1, 1, 1]"
9445,1,1,2,0.5024636267623424,"[0, 0, 1, 0, 0, 0, 0, 1, 1, 0]"
9446,1,1,2,0.5397513796586111,"[0, 1, 1, 1, 0, 1, 1, 1, 1, 1]"
9447,1,1,2,0.3583293006927464,"[1, 0, 0, 0, 1, 0, 1, 1, 1, 0]"
9448,1,1,2,0.9109017475600014,"[1, 1, 0, 0, 0, 0, 0, 1, 0, 1]"
9449,1,1,2,0.027911949815125014,"[1, 0, 1, 1, 0, 1, 0, 0, 1, 1]"
9450,1,1,2,0.40321613869776696,"[0, 0, 0, 0, 0, 1, 0, 0, 1, 1]"
9451,1,1,2,0.23371720893607084,"[0, 0, 1, 0, 0, 1, 1, 0, 1, 1]"
9452,1,1,2,0.08384621058678488,"[0, 1, 0, 0, 1, 1, 1, 1, 0, 0]"
9453,1,1,2,0.9394110252894416,"[1, 1, 0, 1, 1, 0, 0, 1, 1, 0]"
9454,1,1,2,0.970726361415909,"[1, 0, 0, 1, 1, 0, 1, 1, 1, 1]"
9455,1,1,2,0.9412461681422016,"[1, 0, 0, 0, 1, 0, 0, 1, 0, 0]"
9456,1,1,2,0.7962190203860762,"[1, 1, 1, 1, 0, 1, 0, 0, 1, 1]"
9457,2,2,4,0.5232628929892499,"[1, 0, 0, 1, 1, 1, 1, 0, 1, 1]"
9458,2,2,4,0.061999140028758726,"[0, 0, 0, 1, 0, 1, 0, 0, 0, 1]"
9459,1,1,2,0.04947100577463692,"[0, 1, 0, 1, 1, 1, 0, 0, 0, 1]"
9460,1,1,2,0.5283441494909806,"[1, 0, 0, 1, 1, 0, 0, 1, 1, 1]"
9461,1,1,2,0.6031214749788488,"[0, 0, 0, 0, 0, 0, 1, 1, 0, 0]"
9462,1,1,2,0.9188200153685072,"[1, 1, 0, 0, 1, 0, 0, 1, 0, 0]"
9463,1,1,2,0.9376983767714575,"[0, 1, 1, 1, 1, 1, 1, 0, 0, 1]"
9464,1,1,2,0.652241673092844,"[0, 1, 1, 1, 0, 0, 1, 0, 0, 1]"
9465,1,1,2,0.886058867409077,"[1, 1, 1, 1, 1, 1, 0, 0, 1, 1]"
9466,3,3,6,0.49836483186248626,"[1, 1, 1, 1, 1, 1, 1, 1, 1, 1]"
9467,1,1,2,0.22214323063870078,"[0, 0, 1, 0, 0, 1, 0, 0, 0, 0]"
9468,1,1,2,0.8098413160160082,"[1, 1, 0, 1, 1, 1, 1, 0, 0, 1]"
9469,1,1,2,0.5838536687084162,"[0, 0, 0, 0, 1, 1, 1, 1, 0, 1]"
9470,1,1,2,0.9557406064586901,"[1, 1, 1, 0, 1, 0, 0, 1, 0, 0]"
9471,2,2,4,0.39039723933387993,"[1, 1, 1, 1, 1, 0, 0, 1, 0, 1]"
9472,3,3,6,0.3660975005854695,"[1, 1, 0, 0, 0, 1, 1, 1, 0, 0]"
9473,1,1,2,0.5137546027344263,"[0, 0, 1, 1, 0, 1, 1, 0, 1, 1]"
9474,2,2,4,0.27880687157564077,"[1, 0, 1, 0, 0, 0, 1, 0, 1, 1]"
9475,1,1,2,0.8941446849163548,"[1, 1, 0, 1, 0, 0, 0, 1, 0, 0]"
9476,1,1,2,0.40366060963884276,"[0, 0, 0, 1, 1, 1, 0, 0, 1, 1]"
9477,1,1,2,0.11178713048544076,"[0, 1, 1, 0, 0, 1, 0, 0, 0, 1]"
9478,1,1,2,0.42557769119960664,"[0, 0, 0, 1, 0, 0, 1, 1, 0, 0]"
9479,1,1,2,0.43674954881393513,"[0, 0, 0, 1, 0, 0, 0, 0, 0, 1]"
9480,1,1,2,0.5872294948354408,"[1, 0, 1, 0, 0, 1, 1, 1, 1, 0]"
9481,2,2,4,0.18693871023358277,"[0, 1, 1, 1, 0, 1, 1, 0, 0, 0]"
9482,1,1,2,0.7068346325498497,"[0, 0, 0, 1, 0, 1, 1, 1, 0, 1]"
9483,1,1,2,0.5524551972479627,"[1, 1, 1, 1, 1, 1, 0, 0, 1, 0]"
9484,1,1,2,0.6815780992594278,"[0, 1, 1, 1, 1, 0, 1, 0, 0, 0]"
9485,1,1,2,0.47696484728796285,"[0, 0, 1, 0, 0, 1, 0, 0, 0, 1]"
9486,1,1,2,0.7400750951099297,"[1, 1, 0, 0, 0, 0, 0, 0, 1, 0]"
9487,1,1,2,0.20379367853890673,"[1, 0, 1, 0, 0, 1, 1, 0, 1, 1]"
9488,2,2,4,0.7097149600312467,"[1, 0, 0, 1, 0, 1, 1, 1, 0, 0]"
9489,1,1,2,0.6420476982435201,"[1, 1, 0, 0, 0, 0, 0, 1, 1, 0]"
9490,1,1,2,0.9421816716963141,"[0, 0, 1, 0, 0, 0, 0, 1, 1, 0]"
9491,1,1,2,0.662449629773182,"[0, 0, 1, 1, 1, 0, 1, 1, 0, 0]"
9492,1,1,2,0.0023616427552839436,"[0, 1, 1, 0, 1, 0, 0, 0, 0, 1]"
9493,1,1,2,0.8826620196273505,"[0, 0, 0, 1, 0, 0, 0, 1, 0, 0]"
9494,1,1,2,0.3150546526696799,"[0, 0, 1, 0, 0, 0, 0, 1, 0, 1]"
9495,1,1,2,0.01164693346311041,"[1, 1, 0, 0, 1, 0, 1, 1, 1, 0]"
9496,4,4,8,0.981092907010586,"[1, 0, 1, 1, 1, 0, 1, 0, 0, 1]"
9497,3,3,6,0.9979140537159631,"[1, 0, 0, 1, 1, 1, 1, 1, 1, 1]"
9498,1,1,2,0.16592887509633691,"[1, 1, 0, 1, 0, 1, 0, 0, 1, 1]"
9499,1,1,2,0.6994225409411352,"[1, 1, 1, 0, 1, 0, 0, 1, 0, 0]"
9500,1,1,2,0.2731862917277328,"[1, 0, 0, 0, 0, 0, 0, 1, 1, 0]"
9501,1,1,2,0.448963044020282,"[1, 0, 0, 1, 0, 0, 1, 0, 0, 1]"
9502,1,1,2,0.3025830815946312,"[0, 1, 0, 1, 0, 0, 1, 1, 1, 0]"
9503,1,1,2,0.4049717842545051,"[1, 0, 1, 1, 1, 0, 1, 0, 1, 1]"
9504,1,1,2,0.5619463748269677,"[1, 1, 1, 1, 0, 0, 1, 0, 1, 0]"
9505,1,1,2,0.5653936222645574,"[1, 0, 1, 0, 1, 1, 0, 1, 0, 0]"
9506,1,1,2,0.8749356690839493,"[0, 0, 0, 1, 1, 1, 0, 0, 1, 0]"
9507,2,2,4,0.21813754287054943,"[0, 0, 1, 1, 1, 0, 0, 1, 1, 1]"
9508,1,1,2,0.3323397536466931,"[0, 1, 0, 0, 1, 1, 1, 1, 0, 1]"
9509,1,1,2,0.7824859992288182,"[0, 1, 0, 1, 0, 0, 0, 0, 1, 1]"
9510,2,2,4,0.81509591913184,"[0, 0, 1, 1, 1, 1, 0, 0, 1, 0]"
9511,2,2,4,0.46553752900538925,"[1, 1, 1, 0, 0, 0, 0, 1, 1, 0]"
9512,1,1,2,0.4662713621024155,"[1, 1, 0, 0, 1, 1, 0, 0, 0, 0]"
9513,2,2,4,0.7938273337425235,"[1, 0, 0, 1, 1, 1, 0, 0, 0, 0]"
9514,2,2,4,0.045633682020285615,"[1, 1, 0, 0, 0, 0, 0, 0, 1, 0]"
9515,2,2,4,0.09831915040752848,"[0, 0, 1, 1, 0, 0, 1, 1, 1, 1]"
9516,1,1,2,0.5871930431075455,"[1, 0, 0, 1, 0, 0, 0, 1, 1, 0]"
9517,1,1,2,0.7197372902159578,"[0, 1, 0, 1, 1, 1, 1, 1, 1, 1]"
9518,1,1,2,0.1629277094681285,"[0, 0, 0, 1, 1, 1, 0, 1, 0, 1]"
9519,2,2,4,0.6939150506839209,"[1, 1, 0, 0, 0, 0, 0, 1, 0, 0]"
9520,1,1,2,0.11127430651087566,"[1, 0, 1, 1, 1, 0, 0, 0, 1, 0]"
9521,2,2,4,0.1762703811739339,"[1, 0, 0, 0, 0, 0, 0, 0, 0, 1]"
9522,1,1,2,0.20992726676260076,"[0, 1, 0, 0, 1, 1, 1, 0, 1, 1]"
9523,2,2,4,0.918723634550215,"[1, 0, 0, 1, 0, 0, 0, 1, 0, 0]"
9524,1,1,2,0.10851008558455544,"[0, 0, 1, 1, 0, 1, 1, 0, 1, 0]"
9525,1,1,2,0.20542658361486643,"[0, 1, 1, 0, 0, 0, 0, 0, 0, 1]"
9526,2,2,4,0.9153065624095923,"[0, 1, 1, 0, 1, 1, 0, 1, 0, 0]"
9527,2,2,4,0.7187863835701814,"[1, 1, 1, 1, 0, 1, 1, 0, 0, 0]"
9528,2,2,4,0.8662531087779435,"[1, 0, 1, 1, 0, 1, 0, 1, 0, 1]"
9529,2,2,4,0.265746385446186,"[1, 1, 0, 1, 1, 1, 1, 1, 0, 0]"
9530,4,4,8,0.4075552080283166,"[0, 1, 1, 1, 1, 0, 1, 1, 1, 0]"
9531,1,1,2,0.34035832492459606,"[0, 0, 1, 0, 1, 0, 1, 0, 0, 1]"
9532,1,1,2,0.8237507950513255,"[0, 1, 0, 1, 1, 1, 1, 1, 0, 0]"
9533,1,1,2,0.16354770406446095,"[1, 0, 0, 1, 0, 1, 0, 1, 0, 0]"
9534,1,1,2,0.21375148426954638,"[0, 0, 0, 0, 0, 0, 1, 0, 1, 0]"
9535,2,2,4,0.5862025573144453,"[0, 0, 0, 0, 1, 1, 1, 0, 1, 0]"
9536,2,2,4,0.28190313335684636,"[1, 1, 0, 1, 1, 0, 1, 0, 0, 0]"
9537,1,1,2,0.3771041159580907,"[1, 0, 1, 0, 0, 1, 1, 0, 0, 0]"
9538,1,1,2,0.5559561182253202,"[1, 0, 1, 0, 0, 0, 0, 0, 0, 1]"
9539,1,1,2,0.283257183612712,"[1, 1, 0, 1, 0, 1, 0, 0, 0, 1]"
9540,1,1,2,0.6497436109462491,"[1, 0, 0, 0, 1, 0, 0, 0, 1, 1]"
9541,1,1,2,0.640650790713749,"[1, 1, 1, 1, 0, 1, 0, 1, 0, 1]"
9542,1,1,2,0.5584863176409777,"[1, 1, 0, 0, 0, 1, 0, 1, 0, 1]"
9543,2,2,4,0.8276828700386758,"[0, 1, 0, 1, 1, 1, 1, 1, 0, 1]"
9544,2,2,4,0.3721334147089027,"[1, 0, 1, 0, 1, 0, 1, 1, 1, 0]"
9545,1,1,2,0.537383625334328,"[0, 0, 1, 0, 0, 0, 1, 1, 1, 1]"
9546,3,3,6,0.7150189147065512,"[1, 1, 1, 1, 0, 1, 1, 1, 1, 1]"
9547,1,1,2,0.5416675315846093,"[1, 1, 1, 0, 1, 1, 0, 0, 0, 1]"
9548,2,2,4,0.5188778516836051,"[0, 1, 0, 0, 0, 0, 1, 1, 0, 0]"
9549,1,1,2,0.3041669914182781,"[0, 0, 0, 0, 0, 0, 1, 0, 1, 1]"
9550,1,1,2,0.32857757803269505,"[1, 1, 1, 1, 0, 0, 0, 0, 1, 1]"
9551,1,1,2,0.2708167525519227,"[1, 1, 1, 0, 1, 1, 1, 1, 1, 1]"
9552,1,1,2,0.6587403846857739,"[0, 0, 0, 0, 0, 1, 0, 1, 0, 1]"
9553,4,4,8,0.4804034976265089,"[1, 1, 1, 1, 0, 1, 1, 1, 0, 1]"
9554,1,1,2,0.8544078163562752,"[1, 1, 0, 0, 0, 0, 0, 1, 0, 1]"
9555,2,2,4,0.2422834775549707,"[0, 1, 0, 1, 1, 1, 0, 0, 0, 0]"
9556,3,3,6,0.12596166371701634,"[1, 0, 0, 0, 0, 0, 1, 0, 1, 0]"
9557,1,1,2,0.949914849335712,"[1, 1, 0, 1, 0, 1, 0, 0, 0, 0]"
9558,1,1,2,0.8543543022370856,"[1, 1, 0, 0, 0, 1, 1, 1, 0, 1]"
9559,1,1,2,0.2874590222644552,"[1, 1, 0, 1, 1, 1, 1, 1, 1, 0]"
9560,2,2,4,0.09115662713080286,"[0, 1, 1, 1, 0, 0, 0, 0, 0, 0]"
9561,2,2,4,0.715336489129205,"[1, 0, 1, 1, 0, 1, 1, 1, 1, 1]"
9562,4,4,8,0.9494937879892346,"[0, 1, 1, 0, 1, 1, 0, 0, 1, 1]"
9563,2,2,4,0.8391521890325999,"[1, 1, 1, 1, 0, 1, 1, 0, 1, 0]"
9564,1,1,2,0.3671672862267752,"[1, 1, 1, 1, 0, 1, 1, 1, 1, 1]"
9565,1,1,2,0.1763663806395963,"[0, 0, 0, 1, 0, 1, 0, 0, 0, 0]"
9566,1,1,2,0.995350656509623,"[0, 0, 0, 0, 0, 0, 0, 1, 0, 0]"
9567,5,5,10,0.7720648459209327,"[1, 0, 0, 0, 0, 1, 1, 1, 1, 0]"
9568,1,1,2,0.3091310306639776,"[1, 1, 0, 0, 1, 1, 1, 1, 0, 1]"
9569,4,4,8,0.9562756236992142,"[1, 1, 0, 0, 0, 1, 1, 0, 1, 1]"
9570,2,2,4,0.8801200193487797,"[0, 0, 0, 0, 1, 1, 0, 1, 1, 0]"
9571,1,1,2,0.24064311008053285,"[1, 1, 0, 0, 0, 1, 0, 0, 0, 0]"
9572,1,1,2,0.5076067901701931,"[1, 0, 1, 1, 1, 0, 0, 0, 1, 0]"
9573,1,1,2,0.33843269903669515,"[1, 0, 0, 1, 1, 1, 0, 1, 0, 0]"
9574,3,3,6,0.17116828264003747,"[0, 1, 1, 1, 0, 0, 0, 1, 0, 1]"
9575,2,2,4,0.5949104941871315,"[1, 1, 0, 1, 0, 0, 1, 1, 0, 0]"
9576,2,2,4,0.20362370641926486,"[0, 1, 0, 0, 0, 0, 0, 0, 0, 0]"
9577,1,1,2,0.9116209703797074,"[0, 1, 1, 0, 1, 0, 1, 1, 1, 1]"
9578,4,4,8,0.43861553118418684,"[1, 0, 1, 0, 1, 0, 0, 0, 0, 1]"
9579,3,3,6,0.4747211206541473,"[0, 1, 1, 1, 0, 1, 1, 1, 0, 0]"
9580,1,1,2,0.08852591443677316,"[1, 0, 0, 1, 1, 1, 1, 1, 0, 0]"
9581,1,1,2,0.1825821427421992,"[0, 0, 0, 1, 1, 0, 0, 1, 0, 0]"
9582,1,1,2,0.44552781335846126,"[0, 0, 1, 0, 0, 0, 0, 1, 1, 0]"
9583,1,1,2,0.2591213492801041,"[0, 0, 1, 1, 1, 0, 0, 1, 0, 1]"
9584,1,1,2,0.4082449532562238,"[1, 1, 0, 1, 0, 0, 0, 0, 0, 0]"
9585,1,1,2,0.12540787181505386,"[0, 1, 1, 1, 1, 1, 0, 0, 1, 0]"
9586,1,1,2,0.24772209803558431,"[1, 1, 1, 0, 1, 1, 0, 0, 0, 1]"
9587,1,1,2,0.10268299340347509,"[1, 1, 1, 0, 1, 0, 0, 0, 0, 1]"
9588,2,2,4,0.7350284099722146,"[1, 1, 0, 1, 0, 0, 1, 0, 0, 1]"
9589,2,2,4,0.26578126079599873,"[1, 0, 0, 0, 1, 0, 1, 1, 1, 0]"
9590,1,1,2,0.4780837035046658,"[1, 1, 0, 0, 0, 1, 1, 1, 1, 1]"
9591,1,1,2,0.07880199967378532,"[0, 0, 1, 0, 1, 0, 1, 1, 1, 1]"
9592,2,2,4,0.1960891204736397,"[0, 1, 1, 0, 0, 1, 1, 0, 1, 0]"
9593,1,1,2,0.09972002873549357,"[1, 0, 1, 0, 1, 0, 1, 1, 0, 1]"
9594,2,2,4,0.805613931800248,"[1, 0, 0, 0, 0, 0, 1, 0, 0, 0]"
9595,1,1,2,0.9462755312619219,"[1, 1, 0, 0, 0, 1, 1, 1, 0, 1]"
9596,1,1,2,0.5183589144329673,"[1, 0, 0, 0, 0, 0, 1, 0, 1, 0]"
9597,1,1,2,0.051552948566396695,"[0, 0, 0, 1, 1, 1, 0, 0, 1, 1]"
9598,1,1,2,0.24625665046514322,"[0, 0, 1, 0, 1, 1, 0, 0, 1, 0]"
9599,1,1,2,0.041634206038221655,"[1, 1, 1, 1, 1, 1, 1, 0, 1, 1]"
9600,1,1,2,0.6335729543653765,"[0, 1, 1, 0, 1, 0, 0, 1, 0, 0]"
9601,1,1,2,0.5035454882507644,"[1, 1, 1, 1, 1, 0, 0, 0, 0, 1]"
9602,1,1,2,0.11989612952267181,"[0, 1, 0, 1, 0, 1, 1, 1, 1, 1]"
9603,1,1,2,0.4646863738080168,"[0, 0, 1, 0, 1, 0, 1, 0, 1, 0]"
9604,2,2,4,0.15619341086547278,"[1, 1, 1, 1, 0, 1, 0, 0, 0, 1]"
9605,1,1,2,0.7670922223952054,"[0, 0, 0, 1, 1, 1, 0, 1, 0, 1]"
9606,1,1,2,0.7544985378211915,"[1, 0, 0, 0, 1, 0, 0, 0, 1, 1]"
9607,1,1,2,0.7617138678873537,"[0, 1, 1, 1, 0, 0, 0, 1, 1, 1]"
9608,1,1,2,0.954189007552122,"[0, 1, 1, 0, 0, 0, 0, 0, 1, 1]"
9609,1,1,2,0.743296711949424,"[0, 0, 0, 1, 1, 0, 0, 1, 1, 1]"
9610,1,1,2,0.4092572383187394,"[1, 1, 0, 1, 1, 0, 1, 0, 0, 1]"
9611,3,3,6,0.7681407243088715,"[1, 1, 0, 0, 1, 0, 1, 0, 1, 0]"
9612,1,1,2,0.43212607675203163,"[0, 1, 1, 1, 0, 0, 0, 0, 0, 0]"
9613,1,1,2,0.7347434474661666,"[1, 0, 0, 1, 1, 0, 1, 0, 1, 1]"
9614,1,1,2,0.002577124543689191,"[0, 1, 1, 1, 1, 1, 0, 1, 0, 0]"
9615,1,1,2,0.11355224714860701,"[1, 1, 1, 1, 0, 1, 1, 0, 0, 0]"
9616,1,1,2,0.03958158029261605,"[0, 0, 1, 1, 1, 0, 1, 1, 0, 0]"
9617,2,2,4,0.6631871380163223,"[0, 1, 0, 0, 0, 1, 1, 0, 1, 1]"
9618,1,1,2,0.7146883675697554,"[0, 0, 1, 1, 1, 0, 1, 1, 1, 1]"
9619,1,1,2,0.46419997240108835,"[1, 0, 0, 0, 0, 0, 1, 0, 1, 1]"
9620,1,1,2,0.9022443087066953,"[0, 0, 0, 0, 0, 0, 0, 1, 0, 0]"
9621,1,1,2,0.6633488527656466,"[0, 1, 1, 1, 1, 1, 0, 0, 1, 0]"
9622,2,2,4,0.9280787202758501,"[0, 1, 1, 1, 0, 1, 0, 1, 0, 1]"
9623,3,3,6,0.09680580516651727,"[1, 0, 1, 1, 1, 1, 0, 1, 0, 0]"
9624,1,1,2,0.015834101702061232,"[0, 1, 0, 0, 0, 0, 1, 0, 1, 0]"
9625,1,1,2,0.646114142280286,"[0, 0, 1, 1, 1, 1, 1, 0, 0, 1]"
9626,2,2,4,0.9667382643725019,"[1, 0, 1, 1, 0, 0, 0, 1, 0, 0]"
9627,1,1,2,0.8613250682936913,"[1, 0, 0, 1, 0, 0, 0, 0, 0, 1]"
9628,1,1,2,0.5694669750038363,"[1, 0, 1, 1, 1, 0, 0, 1, 0, 0]"
9629,1,1,2,0.4270680244143439,"[0, 0, 1, 1, 0, 0, 1, 1, 0, 1]"
9630,1,1,2,0.9570447467345593,"[0, 1, 1, 0, 0, 0, 0, 0, 0, 1]"
9631,1,1,2,0.7732156203171031,"[0, 0, 0, 1, 0, 0, 1, 0, 0, 1]"
9632,3,3,6,0.20619939198245607,"[0, 1, 1, 0, 1, 1, 0, 1, 0, 0]"
9633,1,1,2,0.6109910684440085,"[0, 1, 0, 0, 0, 1, 1, 0, 0, 0]"
9634,1,1,2,0.42128552630577687,"[0, 0, 0, 0, 1, 1, 0, 1, 1, 0]"
9635,1,1,2,0.00607503148853894,"[0, 1, 0, 1, 1, 0, 0, 1, 1, 0]"
9636,1,1,2,0.36433176808528156,"[1, 1, 0, 0, 1, 1, 0, 0, 0, 1]"
9637,1,1,2,0.15006691572764552,"[1, 1, 1, 0, 0, 1, 1, 0, 0, 0]"
9638,2,2,4,0.9097130471291476,"[1, 0, 1, 1, 1, 1, 1, 0, 1, 1]"
9639,1,1,2,0.3474550856146007,"[0, 1, 1, 0, 0, 0, 1, 1, 1, 0]"
9640,2,2,4,0.4756155001049994,"[0, 1, 1, 1, 0, 1, 0, 1, 1, 0]"
9641,1,1,2,0.38049871753357734,"[1, 0, 1, 1, 0, 1, 0, 0, 1, 0]"
9642,1,1,2,0.39939028655959463,"[1, 0, 0, 1, 0, 0, 1, 0, 0, 1]"
9643,1,1,2,0.8331229730430902,"[0, 1, 0, 1, 0, 1, 0, 1, 1, 1]"
9644,1,1,2,0.6452767529690479,"[1, 0, 0, 0, 0, 0, 1, 0, 0, 0]"
9645,1,1,2,0.9512209266553363,"[1, 1, 1, 1, 0, 0, 0, 1, 1, 0]"
9646,1,1,2,0.5933433555552108,"[1, 0, 1, 0, 1, 1, 1, 0, 1, 0]"
9647,2,2,4,0.8262706127521031,"[1, 1, 0, 0, 0, 1, 0, 0, 1, 1]"
9648,1,1,2,0.8831183417926698,"[1, 1, 0, 0, 1, 0, 1, 1, 1, 1]"
9649,2,2,4,0.26908313658757965,"[1, 1, 1, 1, 1, 1, 1, 1, 1, 0]"
9650,4,4,8,0.07230802305848283,"[0, 0, 0, 0, 0, 1, 1, 0, 1, 1]"
9651,1,1,2,0.40648209001906666,"[1, 0, 1, 0, 0, 0, 0, 0, 1, 0]"
9652,1,1,2,0.958023021347495,"[0, 0, 0, 0, 0, 0, 0, 0, 1, 1]"
9653,1,1,2,0.8988141673865078,"[0, 1, 1, 0, 1, 1, 0, 1, 0, 0]"
9654,1,1,2,0.5214533026648221,"[0, 1, 1, 0, 0, 0, 0, 0, 1, 1]"
9655,2,2,4,0.569704250716581,"[1, 1, 0, 1, 0, 1, 1, 0, 0, 1]"
9656,1,1,2,0.7727236872852016,"[0, 0, 1, 0, 1, 0, 0, 0, 0, 1]"
9657,1,1,2,0.010949242309047924,"[0, 0, 1, 0, 0, 0, 0, 0, 1, 1]"
9658,3,3,6,0.957489561795995,"[1, 0, 0, 1, 0, 0, 0, 1, 1, 1]"
9659,1,1,2,0.9832177690237269,"[0, 1, 1, 1, 0, 0, 0, 0, 0, 1]"
9660,1,1,2,0.2712972431585896,"[0, 1, 1, 0, 0, 0, 0, 0, 1, 0]"
9661,2,2,4,0.5739605945878751,"[1, 1, 1, 0, 1, 1, 1, 0, 0, 0]"
9662,1,1,2,0.834024536204392,"[1, 0, 0, 0, 0, 1, 0, 1, 0, 1]"
9663,4,4,8,0.28228005270246115,"[1, 1, 1, 1, 1, 0, 0, 1, 1, 0]"
9664,1,1,2,0.5316371691641942,"[0, 0, 1, 1, 0, 0, 0, 0, 0, 0]"
9665,1,1,2,0.8791952216172018,"[0, 1, 1, 0, 0, 1, 1, 1, 0, 1]"
9666,1,1,2,0.026248840826892605,"[0, 1, 1, 1, 1, 1, 1, 1, 0, 0]"
9667,1,1,2,0.671290601053089,"[1, 0, 0, 0, 0, 1, 1, 0, 0, 0]"
9668,1,1,2,0.2137429610077759,"[1, 0, 1, 1, 0, 1, 1, 1, 0, 0]"
9669,1,1,2,0.7179050014055304,"[1, 0, 0, 1, 1, 0, 0, 0, 1, 1]"
9670,1,1,2,0.3620706682008412,"[1, 0, 1, 0, 1, 0, 1, 0, 1, 1]"
9671,2,2,4,0.04836956548962579,"[1, 0, 1, 0, 0, 1, 0, 1, 1, 0]"
9672,2,2,4,0.7596791295455484,"[0, 0, 0, 1, 0, 1, 0, 0, 1, 1]"
9673,2,2,4,0.9748982654934759,"[1, 0, 1, 1, 0, 1, 0, 1, 1, 0]"
9674,1,1,2,0.97149920099068,"[0, 1, 0, 1, 0, 0, 1, 1, 0, 0]"
9675,1,1,2,0.2794697308310856,"[0, 1, 1, 1, 1, 0, 0, 1, 1, 0]"
9676,1,1,2,0.7588793782146931,"[1, 0, 1, 0, 1, 1, 0, 1, 1, 0]"
9677,1,1,2,0.7345768928985863,"[0, 0, 1, 0, 1, 0, 0, 0, 0, 1]"
9678,1,1,2,0.46676745144846365,"[0, 1, 0, 1, 1, 0, 1, 1, 0, 1]"
9679,2,2,4,0.6056787668942903,"[0, 0, 1, 0, 1, 1, 0, 0, 0, 1]"
9680,2,2,4,0.3415171037864101,"[1, 1, 0, 1, 0, 0, 1, 0, 1, 0]"
9681,3,3,6,0.35921876028451494,"[1, 0, 1, 1, 0, 0, 0, 1, 1, 0]"
9682,1,1,2,0.39052623097329653,"[0, 1, 1, 0, 0, 1, 1, 0, 0, 0]"
9683,1,1,2,0.654946992639065,"[0, 0, 1, 0, 0, 1, 0, 1, 0, 0]"
9684,1,1,2,0.6700581377743067,"[0, 1, 1, 0, 0, 1, 1, 0, 0, 1]"
9685,2,2,4,0.7878860886707887,"[0, 0, 1, 1, 1, 0, 1, 0, 1, 0]"
9686,1,1,2,0.5596603223813029,"[1, 0, 1, 1, 1, 0, 1, 1, 1, 1]"
9687,1,1,2,0.19473351140490158,"[0, 0, 0, 1, 0, 0, 0, 1, 1, 1]"
9688,3,3,6,0.4323760124159326,"[1, 0, 0, 0, 0, 1, 1, 0, 0, 1]"
9689,2,2,4,0.6107580072173941,"[1, 0, 1, 1, 1, 0, 1, 1, 1, 0]"
9690,1,1,2,0.4116812943992375,"[1, 0, 0, 0, 1, 1, 0, 0, 1, 0]"
9691,1,1,2,0.8286858354607619,"[1, 1, 1, 1, 0, 0, 1, 1, 0, 0]"
9692,2,2,4,0.8162538796200127,"[1, 0, 1, 0, 0, 1, 1, 0, 1, 0]"
9693,1,1,2,0.1857313042357196,"[0, 1, 0, 1, 0, 0, 1, 0, 1, 1]"
9694,2,2,4,0.27054916729786727,"[1, 0, 1, 1, 0, 0, 0, 1, 1, 0]"
9695,1,1,2,0.3653638774509743,"[1, 0, 1, 1, 0, 1, 0, 0, 1, 0]"
9696,1,1,2,0.6130658240535225,"[0, 1, 0, 0, 1, 1, 1, 1, 0, 0]"
9697,1,1,2,0.18442098700336407,"[1, 0, 0, 0, 0, 0, 1, 1, 0, 1]"
9698,1,1,2,0.4878583560284906,"[0, 1, 1, 0, 1, 1, 1, 0, 1, 1]"
9699,1,1,2,0.30379797454552226,"[0, 0, 0, 0, 0, 0, 1, 1, 1, 1]"
9700,1,1,2,0.904191923435592,"[0, 1, 0, 0, 1, 1, 0, 1, 1, 0]"
9701,4,4,8,0.3776080174367423,"[1, 1, 0, 1, 1, 1, 1, 0, 1, 1]"
9702,1,1,2,0.44443431318629045,"[0, 0, 1, 1, 1, 1, 1, 1, 0, 1]"
9703,1,1,2,0.6713924574937175,"[1, 0, 1, 0, 1, 1, 1, 1, 1, 0]"
9704,1,1,2,0.4911606297912319,"[0, 1, 0, 0, 1, 1, 0, 0, 1, 0]"
9705,2,2,4,0.158185162092071,"[1, 0, 0, 0, 1, 0, 0, 0, 1, 0]"
9706,1,1,2,0.7449984212522734,"[0, 0, 1, 1, 1, 1, 0, 1, 0, 0]"
9707,1,1,2,0.8455731940479004,"[0, 0, 1, 0, 1, 0, 0, 1, 1, 1]"
9708,4,4,8,0.8559370503574467,"[1, 1, 0, 0, 1, 1, 1, 1, 1, 0]"
9709,2,2,4,0.0931180912581111,"[1, 1, 0, 1, 0, 0, 1, 0, 0, 1]"
9710,1,1,2,0.491713231309322,"[1, 1, 1, 0, 1, 0, 1, 0, 1, 0]"
9711,2,2,4,0.4340241114773281,"[1, 1, 1, 1, 1, 0, 1, 0, 0, 0]"
9712,2,2,4,0.24082245911442457,"[1, 0, 0, 0, 0, 1, 0, 0, 1, 0]"
9713,1,1,2,0.5972429193611174,"[0, 0, 0, 1, 1, 1, 0, 1, 0, 1]"
9714,3,3,6,0.9676307157210448,"[1, 0, 1, 0, 1, 1, 1, 0, 1, 1]"
9715,1,1,2,0.19159526574624286,"[1, 0, 1, 0, 0, 1, 0, 1, 0, 0]"
9716,1,1,2,0.6341054917626333,"[1, 0, 1, 1, 0, 1, 0, 1, 1, 1]"
9717,1,1,2,0.276372478134681,"[0, 0, 1, 1, 0, 1, 0, 0, 0, 1]"
9718,1,1,2,0.9474830083258706,"[0, 0, 0, 1, 1, 0, 1, 0, 1, 0]"
9719,1,1,2,0.39997210319015297,"[1, 0, 0, 0, 1, 1, 0, 0, 0, 0]"
9720,3,3,6,0.020720843584525417,"[0, 0, 1, 1, 1, 0, 0, 0, 1, 1]"
9721,1,1,2,0.9331763532628191,"[0, 1, 0, 0, 0, 1, 1, 0, 1, 1]"
9722,2,2,4,0.30742524454320186,"[1, 0, 1, 1, 1, 1, 1, 1, 1, 1]"
9723,2,2,4,0.05900647813737925,"[1, 0, 1, 0, 0, 0, 1, 0, 1, 0]"
9724,2,2,4,0.9686658156095561,"[0, 1, 1, 0, 1, 1, 1, 1, 1, 0]"
9725,1,1,2,0.27333158603855245,"[0, 0, 0, 0, 0, 0, 1, 1, 1, 1]"
9726,1,1,2,0.5974786224479376,"[0, 1, 1, 1, 1, 1, 0, 1, 0, 0]"
9727,1,1,2,0.9131703701757369,"[1, 1, 0, 1, 1, 0, 0, 1, 1, 1]"
9728,1,1,2,0.7795940736419029,"[1, 1, 1, 1, 0, 1, 0, 0, 1, 1]"
9729,1,1,2,0.8931115427245926,"[0, 0, 1, 1, 1, 0, 1, 1, 0, 0]"
9730,1,1,2,0.9643493796019208,"[0, 1, 1, 1, 0, 0, 0, 1, 0, 1]"
9731,1,1,2,0.5355537250339191,"[1, 1, 0, 0, 0, 0, 1, 1, 1, 0]"
9732,1,1,2,0.36496256454254905,"[0, 0, 0, 0, 1, 1, 1, 0, 0, 0]"
9733,2,2,4,0.024388924559400227,"[0, 1, 0, 0, 1, 1, 1, 0, 0, 1]"
9734,1,1,2,0.9138313735179816,"[0, 0, 0, 1, 0, 1, 0, 1, 0, 0]"
9735,1,1,2,0.9128333430060056,"[1, 0, 0, 0, 0, 0, 0, 1, 0, 1]"
9736,1,1,2,0.4391150890783465,"[0, 0, 1, 0, 1, 0, 0, 1, 1, 1]"
9737,1,1,2,0.9653814747312021,"[0, 1, 1, 1, 1, 1, 0, 0, 1, 0]"
9738,2,2,4,0.5010047203887521,"[1, 1, 0, 0, 0, 0, 1, 1, 1, 0]"
9739,2,2,4,0.8099361415517266,"[0, 0, 1, 0, 1, 1, 0, 1, 0, 1]"
9740,1,1,2,0.5139033090706652,"[1, 1, 1, 0, 0, 0, 0, 0, 1, 1]"
9741,1,1,2,0.09771600812082815,"[1, 1, 1, 1, 0, 0, 0, 1, 0, 1]"
9742,1,1,2,0.6355447156512429,"[0, 0, 0, 0, 1, 0, 1, 0, 0, 1]"
9743,2,2,4,0.3232175299458194,"[0, 0, 0, 0, 1, 1, 1, 0, 1, 0]"
9744,1,1,2,0.1854833163407299,"[1, 1, 0, 1, 0, 0, 0, 1, 1, 1]"
9745,1,1,2,0.930308390785306,"[0, 1, 0, 0, 0, 0, 0, 0, 1, 0]"
9746,1,1,2,0.217297363866223,"[1, 0, 0, 0, 1, 0, 0, 0, 1, 0]"
9747,1,1,2,0.984891741901639,"[1, 1, 0, 1, 0, 0, 1, 1, 0, 1]"
9748,1,1,2,0.6945620479021521,"[0, 1, 0, 0, 0, 1, 0, 1, 0, 0]"
9749,2,2,4,0.08407179555056166,"[1, 1, 0, 0, 1, 0, 0, 0, 1, 0]"
9750,2,2,4,0.8924153929047955,"[1, 1, 1, 0, 0, 0, 1, 1, 1, 0]"
9751,1,1,2,0.35092355915801,"[0, 0, 0, 1, 1, 0, 1, 0, 0, 1]"
9752,1,1,2,0.877704922790312,"[1, 1, 0, 1, 1, 0, 1, 1, 1, 1]"
9753,3,3,6,0.1090135774042228,"[1, 1, 1, 0, 0, 0, 0, 0, 1, 1]"
9754,1,1,2,0.42743724486613077,"[0, 1, 0, 0, 1, 0, 0, 1, 1, 1]"
9755,1,1,2,0.11993831773138353,"[1, 0, 1, 0, 1, 0, 0, 1, 0, 0]"
9756,1,1,2,0.3206199869012306,"[0, 0, 1, 0, 1, 0, 0, 1, 1, 0]"
9757,1,1,2,0.2946948669309787,"[0, 0, 1, 0, 1, 1, 1, 0, 0, 1]"
9758,1,1,2,0.8932907523061839,"[0, 1, 1, 0, 0, 1, 1, 1, 1, 0]"
9759,1,1,2,0.156162791437934,"[0, 0, 0, 0, 1, 1, 1, 0, 0, 1]"
9760,1,1,2,0.032778153761866546,"[0, 1, 0, 1, 0, 0, 0, 0, 0, 1]"
9761,1,1,2,0.6265482608554472,"[1, 0, 0, 0, 1, 1, 0, 1, 1, 0]"
9762,1,1,2,0.8630698953575207,"[1, 0, 0, 0, 0, 0, 0, 1, 0, 1]"
9763,1,1,2,0.19740381574939314,"[1, 0, 0, 1, 0, 0, 1, 0, 0, 1]"
9764,1,1,2,0.11297506160997406,"[0, 1, 0, 0, 0, 1, 1, 1, 0, 0]"
9765,2,2,4,0.522147229959093,"[0, 0, 1, 0, 0, 0, 1, 1, 1, 0]"
9766,1,1,2,0.5796015383565445,"[0, 1, 0, 1, 0, 1, 0, 0, 1, 0]"
9767,1,1,2,0.9744439937489383,"[0, 0, 1, 0, 0, 1, 1, 1, 1, 0]"
9768,1,1,2,0.9775274493876479,"[0, 0, 1, 1, 1, 1, 0, 0, 1, 0]"
9769,1,1,2,0.7846245596961904,"[0, 0, 1, 0, 1, 1, 1, 0, 1, 0]"
9770,1,1,2,0.28115978986531753,"[1, 0, 0, 0, 0, 0, 0, 0, 0, 1]"
9771,1,1,2,0.8411726302860661,"[0, 1, 1, 0, 0, 1, 0, 1, 0, 1]"
9772,1,1,2,0.29478446635247535,"[1, 1, 1, 1, 1, 0, 1, 0, 0, 1]"
9773,2,2,4,0.7973664907466368,"[1, 0, 0, 1, 1, 1, 1, 0, 1, 1]"
9774,1,1,2,0.691514573963237,"[1, 1, 0, 0, 0, 1, 1, 0, 0, 1]"
9775,3,3,6,0.6348941229949165,"[0, 0, 0, 0, 1, 1, 1, 1, 0, 1]"
9776,1,1,2,0.4077638596306282,"[1, 0, 0, 0, 1, 0, 0, 0, 0, 1]"
9777,2,2,4,0.6605843283291556,"[0, 0, 1, 1, 0, 1, 0, 0, 1, 1]"
9778,2,2,4,0.9360127571893359,"[1, 0, 0, 1, 1, 1, 0, 0, 0, 1]"
9779,1,1,2,0.08913080597485279,"[0, 1, 0, 0, 0, 0, 0, 1, 0, 1]"
9780,1,1,2,0.05568623960774166,"[0, 0, 1, 1, 0, 0, 1, 0, 1, 0]"
9781,1,1,2,0.2087373700569889,"[1, 1, 1, 0, 1, 1, 1, 1, 0, 0]"
9782,1,1,2,0.3896233393435524,"[1, 1, 1, 1, 1, 1, 1, 1, 0, 1]"
9783,1,1,2,0.5758176159212031,"[0, 1, 1, 0, 0, 1, 1, 1, 0, 1]"
9784,1,1,2,0.49070016079389955,"[1, 0, 1, 0, 1, 1, 0, 0, 1, 0]"
9785,1,1,2,0.8265459511361082,"[0, 1, 1, 1, 0, 1, 1, 1, 0, 1]"
9786,1,1,2,0.6585827326793336,"[0, 1, 0, 1, 0, 1, 1, 0, 0, 0]"
9787,1,1,2,0.847451915605062,"[1, 1, 1, 0, 1, 1, 0, 1, 0, 0]"
9788,1,1,2,0.24542099273704077,"[0, 0, 0, 0, 0, 0, 0, 1, 1, 0]"
9789,1,1,2,0.6457870890058311,"[1, 1, 1, 1, 1, 0, 1, 0, 1, 1]"
9790,1,1,2,0.2820893347872706,"[1, 0, 1, 1, 0, 1, 0, 1, 1, 1]"
9791,1,1,2,0.17939296166792684,"[0, 0, 0, 1, 1, 0, 1, 1, 0, 0]"
9792,1,1,2,0.22775321772512125,"[0, 0, 1, 1, 1, 0, 0, 1, 0, 1]"
9793,1,1,2,0.11050041262988841,"[0, 0, 0, 1, 0, 0, 1, 0, 1, 0]"
9794,1,1,2,0.27229044854643325,"[0, 1, 0, 0, 0, 0, 1, 1, 1, 0]"
9795,1,1,2,0.3267113398708582,"[0, 1, 1, 0, 1, 1, 1, 0, 1, 1]"
9796,4,4,8,0.6784081351294854,"[0, 1, 0, 1, 1, 0, 1, 0, 0, 1]"
9797,2,2,4,0.16302229371888055,"[1, 0, 0, 0, 0, 0, 1, 0, 0, 0]"
9798,1,1,2,0.32488401595472294,"[1, 0, 1, 1, 1, 1, 0, 1, 1, 0]"
9799,1,1,2,0.7934253566733266,"[0, 1, 1, 0, 0, 0, 0, 0, 1, 1]"
9800,2,2,4,0.8105306406775029,"[0, 0, 1, 1, 1, 1, 1, 0, 0, 0]"
9801,1,1,2,0.058685576144780316,"[1, 0, 1, 1, 0, 1, 0, 0, 1, 0]"
9802,1,1,2,0.5500895029778364,"[0, 0, 1, 0, 1, 1, 1, 1, 0, 0]"
9803,1,1,2,0.7481934680452954,"[1, 1, 0, 1, 0, 0, 1, 1, 1, 0]"
9804,1,1,2,0.8145500347305893,"[1, 1, 0, 1, 0, 0, 1, 0, 0, 0]"
9805,2,2,4,0.2832740687868458,"[0, 0, 0, 0, 1, 1, 0, 1, 0, 1]"
9806,1,1,2,0.07060565548828635,"[1, 0, 0, 0, 0, 0, 1, 1, 1, 1]"
9807,1,1,2,0.38599731191215725,"[0, 1, 0, 0, 1, 0, 0, 1, 0, 1]"
9808,1,1,2,0.5917874184143026,"[1, 0, 1, 0, 0, 1, 1, 1, 0, 1]"
9809,1,1,2,0.4390338409692297,"[0, 1, 0, 1, 1, 0, 1, 0, 0, 1]"
9810,1,1,2,0.513592233519136,"[0, 1, 0, 0, 0, 0, 0, 0, 0, 0]"
9811,1,1,2,0.28776723818922645,"[0, 0, 0, 0, 1, 0, 0, 1, 1, 0]"
9812,2,2,4,0.2873608809654843,"[1, 0, 1, 0, 1, 0, 1, 1, 1, 1]"
9813,2,2,4,0.1304518486885533,"[0, 1, 1, 1, 0, 0, 1, 0, 0, 1]"
9814,1,1,2,0.11224696845915383,"[1, 0, 0, 0, 1, 1, 1, 1, 0, 1]"
9815,1,1,2,0.6111405034244214,"[0, 1, 1, 1, 1, 0, 0, 1, 1, 0]"
9816,2,2,4,0.9177884449252048,"[1, 0, 1, 0, 1, 0, 0, 1, 1, 1]"
9817,1,1,2,0.9663523885631715,"[0, 0, 1, 1, 0, 0, 1, 0, 0, 1]"
9818,2,2,4,0.7960100908334639,"[1, 0, 1, 1, 0, 0, 0, 1, 0, 0]"
9819,2,2,4,0.5409391316306474,"[1, 1, 1, 1, 0, 0, 0, 1, 0, 0]"
9820,3,3,6,0.7768946600340862,"[0, 1, 0, 0, 1, 0, 1, 0, 1, 0]"
9821,1,1,2,0.16731154333722853,"[0, 0, 1, 0, 0, 1, 1, 1, 1, 0]"
9822,1,1,2,0.5562074893234068,"[0, 0, 1, 0, 0, 0, 0, 0, 1, 0]"
9823,1,1,2,0.7364438594324412,"[0, 1, 1, 1, 1, 0, 1, 0, 1, 1]"
9824,2,2,4,0.36569691733512966,"[1, 1, 1, 0, 0, 1, 0, 1, 1, 1]"
9825,2,2,4,0.07747231834287582,"[1, 0, 0, 1, 1, 0, 0, 1, 0, 0]"
9826,2,2,4,0.9796051815346624,"[1, 1, 0, 1, 1, 0, 1, 0, 1, 1]"
9827,1,1,2,0.934309238780621,"[0, 0, 0, 1, 0, 1, 1, 1, 0, 0]"
9828,2,2,4,0.8645618134137804,"[1, 0, 1, 0, 0, 0, 1, 1, 1, 1]"
9829,1,1,2,0.07474311783369436,"[1, 1, 0, 1, 1, 0, 0, 0, 0, 0]"
9830,1,1,2,0.25240161822488394,"[1, 0, 0, 1, 1, 0, 0, 0, 1, 1]"
9831,1,1,2,0.9630014266260661,"[0, 0, 0, 1, 1, 1, 1, 0, 0, 0]"
9832,1,1,2,0.480736432983236,"[0, 0, 0, 0, 1, 1, 1, 0, 1, 0]"
9833,1,1,2,0.4252615507085199,"[0, 1, 0, 0, 1, 0, 1, 1, 1, 1]"
9834,1,1,2,0.7324004827024063,"[0, 0, 0, 0, 0, 1, 1, 1, 0, 0]"
9835,1,1,2,0.28779300215455905,"[1, 1, 0, 1, 1, 1, 0, 0, 0, 1]"
9836,2,2,4,0.08072644233743276,"[0, 0, 1, 0, 0, 0, 0, 1, 0, 0]"
9837,4,4,8,0.007018886038521521,"[0, 1, 1, 1, 0, 1, 1, 1, 1, 0]"
9838,2,2,4,0.0027326676663392835,"[0, 0, 0, 1, 0, 0, 1, 1, 0, 1]"
9839,1,1,2,0.7414839709087738,"[1, 0, 1, 0, 0, 1, 1, 0, 1, 1]"
9840,1,1,2,0.19018269012049727,"[0, 0, 0, 0, 0, 0, 1, 0, 1, 1]"
9841,2,2,4,0.5897804159586687,"[0, 0, 1, 0, 1, 1, 1, 0, 0, 0]"
9842,1,1,2,0.09369109146044396,"[0, 1, 0, 0, 0, 1, 0, 1, 1, 0]"
9843,1,1,2,0.8844370065615526,"[0, 1, 0, 0, 1, 0, 0, 1, 0, 0]"
9844,2,2,4,0.7017752281479827,"[1, 0, 1, 0, 0, 0, 1, 1, 1, 0]"
9845,1,1,2,0.07507538304398498,"[1, 0, 0, 0, 1, 1, 0, 0, 0, 0]"
9846,1,1,2,0.12436733213442652,"[0, 0, 0, 1, 0, 0, 0, 1, 1, 1]"
9847,1,1,2,0.13171046583448265,"[1, 1, 0, 0, 0, 0, 1, 1, 1, 1]"
9848,1,1,2,0.14209076987749059,"[0, 0, 0, 0, 1, 1, 0, 1, 0, 0]"
9849,2,2,4,0.05515620340948002,"[0, 0, 1, 0, 0, 1, 0, 0, 1, 1]"
9850,2,2,4,0.8045350989490111,"[0, 1, 1, 0, 1, 1, 0, 0, 1, 1]"
9851,1,1,2,0.5935470050531314,"[1, 0, 0, 0, 0, 0, 0, 1, 1, 0]"
9852,1,1,2,0.7728596494666565,"[0, 1, 1, 0, 1, 0, 0, 1, 1, 1]"
9853,3,3,6,0.08878338565055421,"[1, 1, 0, 0, 0, 1, 0, 1, 1, 1]"
9854,1,1,2,0.6646668969539256,"[1, 1, 0, 0, 0, 0, 1, 0, 0, 0]"
9855,1,1,2,0.9483070830835089,"[1, 0, 1, 0, 0, 1, 1, 1, 0, 1]"
9856,1,1,2,0.5439133558524062,"[0, 0, 0, 0, 1, 1, 1, 1, 0, 0]"
9857,1,1,2,0.44022573048012126,"[0, 0, 1, 1, 1, 0, 0, 1, 1, 1]"
9858,1,1,2,0.7627054066441622,"[1, 1, 0, 1, 1, 1, 0, 0, 0, 0]"
9859,1,1,2,0.3893604324254195,"[1, 1, 0, 1, 1, 1, 0, 0, 1, 0]"
9860,2,2,4,0.7303589219897197,"[1, 1, 1, 0, 0, 1, 1, 1, 1, 0]"
9861,1,1,2,0.13218788138796178,"[1, 0, 0, 1, 1, 0, 0, 0, 0, 0]"
9862,1,1,2,0.8478245320587622,"[1, 1, 0, 0, 0, 1, 0, 0, 1, 0]"
9863,1,1,2,0.6984022910805432,"[0, 1, 0, 0, 1, 0, 0, 0, 1, 1]"
9864,3,3,6,0.9005320224206448,"[1, 1, 0, 0, 1, 0, 0, 1, 0, 0]"
9865,1,1,2,0.9398132200648512,"[0, 0, 1, 1, 0, 0, 0, 1, 1, 1]"
9866,1,1,2,0.6773444399949551,"[0, 1, 1, 1, 0, 0, 1, 1, 0, 0]"
9867,1,1,2,0.0008696539302861517,"[0, 0, 1, 0, 1, 0, 0, 1, 1, 1]"
9868,1,1,2,0.8038427131606887,"[0, 0, 0, 1, 1, 1, 1, 0, 0, 0]"
9869,1,1,2,0.0404395657455946,"[1, 0, 1, 0, 0, 0, 0, 0, 1, 0]"
9870,1,1,2,0.5134939569688229,"[1, 0, 0, 1, 0, 0, 0, 0, 1, 0]"
9871,1,1,2,0.23725015344690936,"[1, 1, 1, 1, 1, 0, 1, 0, 0, 0]"
9872,1,1,2,0.4967857119337188,"[0, 0, 0, 1, 1, 0, 0, 1, 0, 1]"
9873,2,2,4,0.34766810525966463,"[1, 1, 0, 0, 1, 0, 1, 0, 1, 0]"
9874,1,1,2,0.964103757929398,"[0, 1, 0, 1, 1, 1, 1, 1, 1, 0]"
9875,1,1,2,0.6732630004369754,"[0, 1, 0, 0, 1, 1, 1, 0, 0, 1]"
9876,1,1,2,0.8727259352336374,"[0, 1, 1, 0, 1, 0, 1, 0, 0, 0]"
9877,1,1,2,0.6845954316359335,"[0, 1, 1, 0, 0, 0, 1, 0, 1, 1]"
9878,1,1,2,0.6573647767948314,"[1, 0, 1, 1, 0, 0, 0, 0, 0, 1]"
9879,1,1,2,0.5862310636710325,"[1, 1, 0, 0, 1, 0, 1, 0, 0, 1]"
9880,1,1,2,0.7994791048328501,"[0, 0, 1, 1, 1, 1, 1, 1, 0, 0]"
9881,2,2,4,0.9603944411953081,"[1, 0, 0, 1, 0, 0, 1, 0, 0, 0]"
9882,1,1,2,0.45423123386759523,"[0, 1, 1, 0, 1, 0, 0, 0, 0, 0]"
9883,1,1,2,0.9730133409858572,"[0, 1, 1, 0, 1, 1, 1, 0, 0, 1]"
9884,2,2,4,0.3910748749967137,"[0, 0, 1, 0, 1, 1, 1, 1, 1, 1]"
9885,1,1,2,0.969558288600124,"[0, 1, 1, 0, 0, 1, 0, 1, 0, 0]"
9886,1,1,2,0.5840425750730729,"[1, 1, 0, 0, 0, 1, 0, 1, 0, 1]"
9887,1,1,2,0.4299458674116108,"[0, 0, 1, 1, 0, 1, 1, 0, 0, 1]"
9888,1,1,2,0.07530650519296866,"[0, 1, 0, 0, 0, 1, 1, 1, 0, 1]"
9889,2,2,4,0.9037065184836152,"[0, 0, 1, 0, 1, 1, 1, 1, 0, 1]"
9890,2,2,4,0.6140637622250232,"[0, 0, 1, 0, 0, 0, 1, 0, 0, 0]"
9891,3,3,6,0.2953628363333328,"[1, 0, 0, 0, 0, 1, 0, 1, 1, 0]"
9892,1,1,2,0.714420112109378,"[1, 0, 1, 1, 0, 0, 1, 0, 1, 0]"
9893,2,2,4,0.9937129986472021,"[0, 0, 1, 0, 0, 0, 0, 0, 1, 0]"
9894,1,1,2,0.16314753998399822,"[1, 0, 1, 0, 0, 0, 0, 0, 1, 0]"
9895,2,2,4,0.835725415125616,"[0, 1, 1, 0, 0, 1, 0, 0, 0, 1]"
9896,1,1,2,0.5131950321672989,"[1, 0, 0, 1, 1, 0, 0, 0, 1, 1]"
9897,1,1,2,0.7510793599045461,"[0, 1, 0, 1, 0, 1, 1, 0, 0, 0]"
9898,3,3,6,0.6029367656600926,"[0, 0, 0, 0, 1, 1, 1, 1, 1, 1]"
9899,1,1,2,0.34114961021334966,"[1, 0, 0, 1, 0, 0, 1, 1, 0, 0]"
9900,4,4,8,0.2685760848140054,"[0, 0, 1, 1, 1, 1, 1, 1, 0, 1]"
9901,1,1,2,0.22043704240093853,"[1, 1, 1, 1, 0, 0, 0, 0, 1, 1]"
9902,2,2,4,0.5918247425986214,"[1, 1, 0, 0, 1, 0, 1, 1, 1, 1]"
9903,1,1,2,0.23074625728869191,"[1, 1, 0, 0, 0, 1, 1, 1, 0, 0]"
9904,2,2,4,0.3011399238224013,"[1, 1, 1, 0, 0, 1, 1, 0, 1, 1]"
9905,1,1,2,0.41826252267066,"[0, 0, 0, 1, 1, 0, 0, 1, 0, 1]"
9906,1,1,2,0.9841660350896354,"[0, 1, 0, 0, 0, 1, 1, 0, 0, 1]"
9907,3,3,6,0.704994543367844,"[1, 0, 0, 1, 0, 1, 0, 0, 1, 0]"
9908,1,1,2,0.6770799913228608,"[0, 1, 0, 1, 0, 0, 1, 1, 1, 1]"
9909,2,2,4,0.4061679477208888,"[1, 1, 1, 0, 1, 0, 1, 1, 0, 0]"
9910,2,2,4,0.4655939004897065,"[1, 1, 0, 0, 1, 0, 0, 0, 1, 1]"
9911,2,2,4,0.7704100260102489,"[1, 1, 1, 0, 1, 0, 0, 0, 0, 0]"
9912,1,1,2,0.7965187855089493,"[0, 0, 1, 1, 1, 1, 1, 1, 1, 0]"
9913,2,2,4,0.13790393442303384,"[1, 1, 1, 1, 0, 0, 0, 0, 0, 1]"
9914,1,1,2,0.15109704631229448,"[0, 1, 1, 1, 1, 1, 1, 0, 0, 0]"
9915,1,1,2,0.5165645485188298,"[1, 0, 0, 0, 0, 0, 1, 1, 1, 0]"
9916,2,2,4,0.9201685197641979,"[1, 0, 0, 0, 1, 0, 0, 0, 1, 1]"
9917,2,2,4,0.4802995916702262,"[0, 0, 1, 0, 1, 1, 0, 1, 1, 1]"
9918,1,1,2,0.9775259110045631,"[0, 0, 0, 0, 0, 1, 1, 0, 1, 0]"
9919,1,1,2,0.2722688502402141,"[0, 1, 0, 0, 0, 1, 0, 1, 1, 0]"
9920,1,1,2,0.15590591295411294,"[0, 1, 0, 0, 0, 1, 0, 0, 0, 0]"
9921,1,1,2,0.8678747445402645,"[1, 1, 1, 0, 0, 0, 0, 0, 1, 0]"
9922,1,1,2,0.4206229683787821,"[1, 1, 1, 0, 1, 0, 0, 1, 1, 1]"
9923,1,1,2,0.5494694574229377,"[0, 0, 1, 1, 0, 0, 0, 0, 0, 1]"
9924,1,1,2,0.30505912108848887,"[1, 1, 0, 1, 1, 0, 0, 0, 1, 1]"
9925,1,1,2,0.242520188488223,"[0, 0, 1, 0, 0, 0, 0, 1, 0, 0]"
9926,1,1,2,0.9745758313228408,"[1, 0, 0, 1, 0, 0, 0, 1, 0, 0]"
9927,1,1,2,0.2777454951978754,"[0, 1, 1, 0, 1, 0, 1, 0, 1, 1]"
9928,1,1,2,0.9393828773556733,"[1, 1, 1, 1, 0, 0, 1, 1, 1, 0]"
9929,1,1,2,0.9761327919858915,"[0, 0, 1, 0, 0, 1, 1, 0, 0, 0]"
9930,1,1,2,0.6965064841378523,"[0, 0, 1, 1, 0, 0, 0, 1, 0, 1]"
9931,1,1,2,0.825538363061744,"[0, 0, 0, 0, 0, 0, 1, 1, 0, 0]"
9932,1,1,2,0.546186392611477,"[0, 1, 0, 0, 0, 1, 1, 1, 0, 1]"
9933,2,2,4,0.7053089267047727,"[0, 1, 1, 0, 0, 1, 1, 1, 0, 0]"
9934,2,2,4,0.8693048446357585,"[1, 1, 0, 1, 1, 1, 0, 0, 0, 0]"
9935,1,1,2,0.704871881432134,"[0, 0, 1, 0, 0, 0, 0, 0, 1, 1]"
9936,1,1,2,0.7911336197497089,"[1, 0, 1, 0, 1, 0, 0, 0, 1, 1]"
9937,1,1,2,0.7132810807575605,"[1, 1, 1, 0, 0, 1, 0, 1, 0, 1]"
9938,1,1,2,0.9503429644986612,"[1, 1, 1, 0, 1, 1, 0, 1, 0, 0]"
9939,2,2,4,0.9825222022211508,"[1, 0, 0, 0, 1, 0, 0, 1, 1, 1]"
9940,1,1,2,0.4039304242056643,"[0, 1, 0, 1, 0, 0, 1, 0, 0, 0]"
9941,4,4,8,0.6046972171078395,"[1, 0, 1, 0, 1, 1, 0, 1, 1, 1]"
9942,1,1,2,0.6661716082150521,"[0, 0, 0, 1, 1, 1, 0, 1, 0, 1]"
9943,2,2,4,0.46562613421967813,"[1, 1, 1, 1, 0, 0, 1, 1, 0, 1]"
9944,1,1,2,0.36246280146724597,"[1, 0, 1, 0, 1, 1, 0, 0, 0, 0]"
9945,2,2,4,0.12648213820738696,"[1, 0, 1, 1, 0, 1, 1, 1, 0, 0]"
9946,1,1,2,0.12184103036448735,"[1, 0, 0, 0, 1, 1, 0, 1, 1, 0]"
9947,3,3,6,0.9682241170661636,"[0, 1, 0, 1, 1, 0, 1, 1, 0, 1]"
9948,1,1,2,0.5133589740787261,"[0, 1, 1, 1, 0, 1, 0, 0, 0, 1]"
9949,1,1,2,0.7076257753977905,"[0, 1, 1, 0, 1, 0, 0, 0, 0, 1]"
9950,2,2,4,0.3354456933306017,"[0, 0, 1, 1, 0, 0, 1, 1, 1, 0]"
9951,2,2,4,0.6892386616717706,"[1, 1, 0, 0, 0, 1, 1, 0, 1, 1]"
9952,2,2,4,0.060607042391063515,"[0, 0, 0, 1, 1, 0, 1, 1, 1, 0]"
9953,1,1,2,0.987952702663643,"[0, 0, 1, 1, 0, 0, 0, 1, 0, 1]"
9954,1,1,2,0.7213574201583071,"[0, 0, 0, 0, 1, 1, 0, 1, 0, 0]"
9955,1,1,2,0.28199295591824414,"[1, 1, 1, 0, 1, 1, 0, 1, 0, 1]"
9956,3,3,6,0.05993001938978115,"[1, 0, 1, 0, 0, 1, 0, 0, 0, 0]"
9957,1,1,2,0.6984656000691282,"[0, 0, 1, 1, 1, 1, 1, 0, 1, 1]"
9958,2,2,4,0.354350856708455,"[1, 0, 0, 0, 1, 0, 0, 0, 1, 1]"
9959,1,1,2,0.6030408166361627,"[0, 1, 1, 0, 1, 1, 1, 0, 0, 0]"
9960,3,3,6,0.881997389920454,"[1, 0, 0, 0, 1, 1, 1, 1, 0, 1]"
9961,1,1,2,0.4525057941348887,"[1, 1, 1, 1, 0, 1, 0, 0, 0, 0]"
9962,2,2,4,0.039584514634165346,"[0, 1, 0, 1, 1, 1, 0, 1, 1, 0]"
9963,1,1,2,0.9552582059067177,"[1, 0, 1, 1, 1, 0, 0, 1, 0, 1]"
9964,1,1,2,0.12531507936232267,"[0, 1, 0, 0, 0, 0, 1, 1, 1, 1]"
9965,1,1,2,0.24531556081256145,"[0, 0, 0, 1, 0, 1, 0, 1, 1, 1]"
9966,1,1,2,0.626868842497846,"[1, 1, 0, 1, 0, 0, 1, 1, 0, 1]"
9967,4,4,8,0.0996908958462085,"[0, 0, 1, 1, 1, 1, 0, 0, 1, 0]"
9968,2,2,4,0.1249445761254151,"[1, 1, 0, 0, 1, 1, 1, 0, 0, 1]"
9969,3,3,6,0.06390154637288847,"[0, 0, 0, 0, 1, 1, 1, 1, 1, 1]"
9970,1,1,2,0.2062206287109266,"[0, 1, 1, 1, 0, 1, 0, 0, 0, 1]"
9971,1,1,2,0.34855461144065514,"[0, 0, 1, 1, 0, 1, 1, 1, 0, 0]"
9972,1,1,2,0.5379167266106352,"[1, 1, 0, 0, 1, 1, 1, 0, 0, 1]"
9973,1,1,2,0.7013836758392286,"[0, 1, 1, 0, 0, 0, 0, 0, 0, 0]"
9974,1,1,2,0.9756895441753741,"[0, 1, 1, 1, 0, 0, 1, 1, 0, 0]"
9975,1,1,2,0.8225422490383726,"[1, 1, 0, 0, 1, 1, 0, 0, 1, 0]"
9976,1,1,2,0.06971965867641217,"[1, 1, 1, 1, 0, 0, 1, 1, 0, 0]"
9977,1,1,2,0.8759543729000507,"[1, 1, 0, 1, 0, 1, 0, 0, 0, 0]"
9978,2,2,4,0.704672154575793,"[1, 0, 1, 0, 0, 0, 0, 1, 0, 1]"
9979,1,1,2,0.8382545029250849,"[0, 0, 0, 1, 0, 0, 0, 1, 0, 0]"
9980,1,1,2,0.8578453123388382,"[0, 1, 1, 0, 1, 1, 1, 0, 0, 0]"
9981,1,1,2,0.4090786887814626,"[1, 1, 0, 1, 0, 0, 1, 0, 0, 0]"
9982,2,2,4,0.7760380314378863,"[1, 1, 1, 1, 1, 0, 1, 0, 0, 1]"
9983,1,1,2,0.43170497463542323,"[0, 0, 1, 0, 1, 0, 1, 1, 0, 0]"
9984,3,3,6,0.5560560876270985,"[1, 1, 0, 1, 0, 1, 0, 1, 0, 0]"
9985,2,2,4,0.44420227354223996,"[0, 1, 1, 0, 1, 0, 0, 0, 0, 1]"
9986,1,1,2,0.9717288409162397,"[0, 1, 1, 0, 0, 1, 1, 0, 0, 0]"
9987,1,1,2,0.6476750064083062,"[1, 0, 1, 0, 0, 0, 0, 1, 1, 1]"
9988,1,1,2,0.7268034617257041,"[0, 1, 0, 0, 1, 1, 1, 1, 0, 0]"
9989,1,1,2,0.5551351842308329,"[1, 1, 0, 0, 0, 0, 1, 1, 1, 1]"
9990,1,1,2,0.10878347602162197,"[1, 1, 1, 1, 0, 1, 1, 0, 1, 0]"
9991,1,1,2,0.498310367617681,"[0, 0, 1, 1, 0, 1, 1, 1, 0, 1]"
9992,1,1,2,0.3215367501349389,"[0, 1, 0, 0, 0, 0, 0, 1, 1, 1]"
9993,1,1,2,0.32233737635346826,"[1, 0, 0, 0, 1, 1, 0, 1, 0, 0]"
9994,1,1,2,0.4513677285964568,"[0, 0, 0, 0, 1, 0, 1, 1, 0, 1]"
9995,1,1,2,0.6546566231230803,"[1, 1, 1, 0, 0, 1, 0, 0, 0, 1]"
9996,1,1,2,0.38620956107470106,"[1, 1, 0, 0, 1, 1, 1, 0, 1, 0]"
9997,1,1,2,0.7722127358182012,"[0, 0, 1, 0, 0, 0, 0, 1, 1, 1]"
9998,1,1,2,0.955203014359959,"[1, 0, 1, 0, 1, 0, 1, 0, 0, 1]"
9999,3,3,6,0.6400035850940357,"[0, 1, 0, 1, 1, 0, 1, 1, 1, 1]"
10000,1,1,2,0.4870253025824872,"[0, 0, 0, 0, 0, 0, 0, 0, 1, 0]"
10001,1,1,2,0.09551772506432521,"[0, 0, 0, 1, 0, 0, 0, 0, 1, 1]"
10002,3,3,6,0.14173813089209808,"[0, 1, 0, 0, 0, 0, 1, 1, 1, 0]"
10003,5,5,10,0.11962520390026954,"[1, 1, 1, 0, 1, 0, 0, 1, 0, 0]"
10004,1,1,2,0.6196087439481477,"[1, 0, 1, 1, 1, 0, 0, 1, 1, 1]"
10005,1,1,2,0.10382241662881608,"[1, 0, 0, 1, 1, 0, 0, 1, 1, 1]"
10006,2,2,4,0.2103030871664593,"[1, 0, 0, 0, 1, 0, 1, 0, 1, 0]"
10007,2,2,4,0.745340427613242,"[1, 0, 1, 1, 0, 1, 0, 0, 1, 1]"
10008,2,2,4,0.6228083520202019,"[0, 0, 0, 1, 0, 1, 1, 1, 0, 1]"
10009,1,1,2,0.8570516170002298,"[0, 0, 1, 1, 0, 1, 1, 1, 1, 0]"
10010,1,1,2,0.2692700789053998,"[0, 0, 1, 0, 0, 1, 1, 1, 1, 0]"
10011,3,3,6,0.5595931274204988,"[0, 1, 1, 1, 1, 0, 1, 0, 0, 0]"
10012,1,1,2,0.9613656748097098,"[0, 1, 0, 0, 1, 1, 1, 0, 1, 1]"
10013,1,1,2,0.5349501934350863,"[1, 0, 0, 0, 1, 0, 0, 0, 1, 1]"
10014,2,2,4,0.898526544428268,"[0, 0, 1, 0, 1, 1, 1, 1, 1, 1]"
10015,1,1,2,0.06347137801607539,"[1, 0, 0, 0, 1, 1, 1, 1, 0, 0]"
10016,1,1,2,0.43099440267668165,"[0, 1, 0, 0, 0, 1, 0, 0, 0, 1]"
10017,2,2,4,0.9034634413818216,"[1, 0, 1, 1, 0, 1, 1, 1, 1, 0]"
10018,1,1,2,0.7704099135564276,"[1, 1, 1, 1, 0, 1, 0, 0, 1, 0]"
10019,3,3,6,0.34786823166365655,"[1, 1, 1, 0, 0, 0, 0, 0, 1, 0]"
10020,1,1,2,0.4596519977245547,"[1, 0, 1, 1, 1, 0, 1, 0, 0, 1]"
10021,2,2,4,0.3560182384676708,"[1, 0, 1, 0, 0, 0, 0, 1, 0, 0]"
10022,1,1,2,0.5384837541194741,"[0, 1, 1, 1, 0, 0, 1, 1, 1, 1]"
10023,2,2,4,0.2156215270570484,"[1, 1, 1, 1, 0, 1, 1, 0, 1, 1]"
10024,1,1,2,0.8209508937898131,"[1, 0, 0, 1, 0, 1, 1, 0, 1, 0]"
10025,1,1,2,0.7900297798250124,"[0, 1, 0, 1, 0, 1, 1, 0, 0, 0]"
10026,1,1,2,0.13341314743323573,"[1, 1, 0, 0, 0, 1, 1, 1, 0, 0]"
10027,3,3,6,0.7458484484098833,"[0, 1, 1, 1, 1, 1, 1, 0, 1, 0]"
10028,1,1,2,0.06993666808138355,"[1, 1, 0, 0, 1, 0, 1, 1, 0, 0]"
10029,1,1,2,0.9141980058397623,"[0, 0, 0, 0, 1, 1, 1, 0, 1, 1]"
10030,1,1,2,0.5913756650618879,"[0, 1, 0, 1, 0, 1, 0, 0, 0, 1]"
10031,1,1,2,0.6557136117790102,"[0, 0, 0, 0, 1, 1, 1, 1, 1, 1]"
10032,2,2,4,0.1536581860018149,"[1, 1, 1, 1, 0, 1, 0, 0, 1, 1]"
10033,2,2,4,0.6699469375867283,"[1, 1, 0, 1, 1, 1, 1, 0, 0, 1]"
10034,2,2,4,0.9287048279164498,"[1, 0, 0, 0, 0, 0, 1, 1, 0, 0]"
10035,2,2,4,0.5276731897447577,"[0, 0, 0, 0, 0, 0, 1, 1, 0, 0]"
10036,1,1,2,0.9936804621815326,"[0, 0, 1, 0, 1, 1, 1, 1, 1, 1]"
10037,1,1,2,0.07202539163607002,"[1, 0, 0, 0, 0, 1, 1, 0, 0, 0]"
10038,1,1,2,0.6659135102808541,"[1, 0, 0, 0, 0, 1, 1, 0, 0, 0]"
10039,1,1,2,0.6119780609326569,"[1, 1, 0, 1, 0, 1, 1, 0, 1, 1]"
10040,1,1,2,0.9150389470836346,"[1, 0, 0, 0, 1, 0, 0, 1, 1, 0]"
10041,3,3,6,0.6241875689910942,"[1, 0, 1, 0, 0, 0, 1, 1, 1, 0]"
10042,1,1,2,0.7267688728950991,"[0, 1, 0, 1, 0, 1, 1, 1, 1, 0]"
10043,1,1,2,0.6414760002786335,"[0, 0, 0, 0, 1, 0, 0, 0, 0, 1]"
10044,1,1,2,0.040267089439722126,"[1, 0, 1, 1, 0, 0, 1, 0, 0, 0]"
10045,1,1,2,0.18127448309153538,"[0, 1, 1, 0, 0, 1, 0, 1, 1, 0]"
10046,1,1,2,0.12108484303776534,"[0, 0, 1, 0, 1, 1, 1, 1, 0, 0]"
10047,5,5,10,0.5032471597684148,"[1, 0, 1, 0, 1, 1, 0, 1, 1, 0]"
10048,1,1,2,0.900386576123675,"[0, 0, 0, 0, 0, 1, 0, 1, 1, 1]"
10049,1,1,2,0.9402446017088851,"[1, 0, 1, 1, 1, 1, 0, 1, 0, 0]"
10050,1,1,2,0.275622071320892,"[1, 0, 1, 0, 1, 0, 1, 0, 1, 0]"
10051,1,1,2,0.33757695930884957,"[1, 1, 1, 0, 1, 1, 1, 1, 1, 0]"
10052,1,1,2,0.00987914393326017,"[1, 0, 1, 0, 0, 1, 0, 0, 0, 1]"
10053,1,1,2,0.7058146343950455,"[0, 1, 0, 0, 1, 0, 0, 1, 0, 1]"
10054,2,2,4,0.3914227406627534,"[0, 1, 1, 1, 1, 0, 0, 1, 0, 1]"
10055,1,1,2,0.22414034047485054,"[1, 0, 1, 0, 1, 1, 1, 1, 1, 1]"
10056,1,1,2,0.917711839670216,"[1, 1, 1, 1, 0, 1, 0, 0, 0, 1]"
10057,1,1,2,0.7818277804435347,"[0, 0, 1, 0, 1, 1, 0, 1, 0, 0]"
10058,1,1,2,0.5429435371072642,"[1, 1, 0, 1, 0, 0, 0, 1, 0, 1]"
10059,1,1,2,0.5172367756282604,"[0, 1, 1, 0, 0, 1, 1, 0, 1, 1]"
10060,2,2,4,0.0431941644692857,"[1, 1, 0, 0, 1, 1, 1, 1, 1, 0]"
10061,1,1,2,0.44500242320310424,"[1, 0, 0, 0, 0, 1, 0, 0, 1, 1]"
10062,1,1,2,0.9671978941180613,"[0, 0, 0, 1, 1, 0, 0, 1, 1, 1]"
10063,1,1,2,0.48160515282113747,"[0, 1, 1, 0, 0, 1, 1, 0, 1, 0]"
10064,1,1,2,0.8758943913816001,"[1, 1, 0, 1, 0, 0, 0, 0, 0, 0]"
10065,1,1,2,0.253441886229432,"[0, 0, 0, 0, 1, 1, 0, 1, 0, 0]"
10066,1,1,2,0.47491740741022836,"[0, 0, 0, 1, 0, 1, 1, 0, 1, 1]"
10067,2,2,4,0.884666102110809,"[1, 1, 0, 1, 1, 0, 0, 1, 0, 0]"
10068,1,1,2,0.2831603454932521,"[1, 1, 1, 0, 0, 1, 1, 0, 0, 1]"
10069,1,1,2,0.9916797048314373,"[0, 0, 0, 1, 1, 0, 0, 1, 0, 1]"
10070,1,1,2,0.9552845765111201,"[1, 0, 1, 0, 0, 0, 1, 0, 1, 0]"
10071,2,2,4,0.26938026167116047,"[1, 1, 0, 1, 0, 0, 1, 1, 0, 0]"
10072,1,1,2,0.3750345391837767,"[1, 1, 0, 0, 0, 1, 1, 0, 0, 1]"
10073,1,1,2,0.3581621830516568,"[0, 1, 1, 1, 1, 1, 1, 0, 1, 1]"
10074,1,1,2,0.6777807528362938,"[0, 0, 1, 0, 0, 1, 0, 0, 1, 1]"
10075,2,2,4,0.6226199612406138,"[1, 1, 1, 1, 1, 1, 0, 1, 1, 0]"
10076,2,2,4,0.8209335405953883,"[1, 1, 0, 0, 1, 0, 0, 0, 1, 1]"
10077,4,4,8,0.6261040627046304,"[1, 0, 1, 1, 0, 1, 1, 0, 0, 0]"
10078,2,2,4,0.8430208389030609,"[0, 1, 1, 1, 1, 1, 1, 1, 0, 0]"
10079,1,1,2,0.3140769100669386,"[0, 1, 0, 0, 0, 0, 0, 1, 0, 1]"
10080,1,1,2,0.25314500259593886,"[1, 0, 1, 1, 1, 0, 0, 1, 1, 0]"
10081,2,2,4,0.9871121735890546,"[0, 1, 1, 0, 0, 1, 0, 0, 0, 1]"
10082,1,1,2,0.46740854139349175,"[1, 0, 1, 0, 1, 1, 0, 1, 1, 1]"
10083,1,1,2,0.16651702256175793,"[1, 1, 0, 0, 1, 1, 0, 1, 0, 1]"
10084,1,1,2,0.06404709001405584,"[1, 1, 0, 1, 0, 0, 1, 0, 0, 0]"
10085,1,1,2,0.44427298376460744,"[0, 1, 1, 0, 0, 0, 0, 0, 0, 1]"
10086,2,2,4,0.5080001277878212,"[0, 0, 0, 0, 1, 0, 1, 0, 0, 0]"
10087,1,1,2,0.9467924290620936,"[1, 1, 0, 0, 0, 1, 0, 1, 0, 1]"
10088,1,1,2,0.020505918341716334,"[0, 1, 0, 0, 1, 0, 1, 0, 0, 0]"
10089,4,4,8,0.693209736377194,"[1, 1, 1, 0, 1, 0, 1, 1, 1, 0]"
10090,3,3,6,0.01438594892630729,"[0, 1, 1, 0, 1, 1, 0, 0, 1, 0]"
10091,1,1,2,0.6714291745930769,"[1, 0, 0, 1, 0, 0, 1, 0, 1, 0]"
10092,1,1,2,0.5450682781336567,"[1, 0, 0, 1, 0, 1, 1, 1, 1, 1]"
10093,2,2,4,0.6709925193302534,"[0, 1, 1, 1, 1, 1, 0, 1, 1, 0]"
10094,1,1,2,0.7215303941350533,"[0, 1, 1, 1, 0, 0, 0, 1, 1, 1]"
10095,2,2,4,0.3292193756428572,"[1, 1, 0, 0, 0, 1, 0, 1, 1, 1]"
10096,1,1,2,0.3105358320823124,"[0, 0, 0, 1, 1, 1, 1, 0, 1, 1]"
10097,1,1,2,0.24009021734494407,"[0, 1, 0, 0, 0, 1, 0, 1, 0, 0]"
10098,1,1,2,0.4300076225367342,"[0, 0, 1, 0, 1, 1, 0, 0, 0, 0]"
10099,1,1,2,0.3489178678348719,"[0, 0, 1, 0, 0, 0, 1, 0, 1, 1]"
10100,1,1,2,0.3657103764584432,"[1, 0, 1, 1, 0, 0, 1, 1, 1, 0]"
10101,2,2,4,0.9498626144741358,"[1, 0, 1, 1, 1, 1, 0, 1, 0, 1]"
10102,2,2,4,0.5459035903929552,"[0, 1, 0, 1, 1, 1, 1, 1, 0, 0]"
10103,1,1,2,0.3982410195946765,"[0, 1, 1, 0, 1, 1, 0, 0, 1, 0]"
10104,1,1,2,0.8818268630599074,"[0, 0, 0, 1, 1, 0, 0, 1, 1, 1]"
10105,2,2,4,0.35103541177526343,"[1, 0, 0, 1, 1, 1, 0, 0, 0, 1]"
10106,1,1,2,0.7023838694312909,"[0, 1, 1, 1, 0, 1, 0, 1, 1, 0]"
10107,1,1,2,0.7853084043750505,"[0, 0, 0, 0, 0, 0, 0, 1, 0, 0]"
10108,1,1,2,0.9457086236314616,"[1, 0, 0, 1, 1, 1, 0, 1, 0, 1]"
10109,2,2,4,0.49742779218948974,"[1, 0, 0, 0, 0, 1, 0, 1, 0, 1]"
10110,1,1,2,0.7971533681701524,"[0, 1, 1, 0, 1, 0, 0, 0, 1, 1]"
10111,2,2,4,0.3258680011308551,"[1, 1, 1, 0, 0, 1, 1, 0, 0, 1]"
10112,1,1,2,0.3228061312167435,"[1, 0, 1, 1, 1, 1, 0, 0, 0, 1]"
10113,2,2,4,0.5703715972613214,"[0, 0, 0, 1, 0, 1, 1, 0, 1, 0]"
10114,2,2,4,0.09460301508435032,"[1, 1, 1, 1, 1, 1, 1, 0, 1, 0]"
10115,2,2,4,0.5432692666172183,"[0, 0, 1, 0, 1, 1, 1, 0, 0, 1]"
10116,1,1,2,0.45146559263507935,"[0, 1, 1, 0, 1, 0, 0, 0, 1, 1]"
10117,1,1,2,0.43905251095668807,"[0, 1, 1, 0, 1, 1, 0, 0, 0, 1]"
10118,1,1,2,0.6667990591971945,"[1, 1, 0, 0, 1, 0, 0, 0, 1, 0]"
10119,1,1,2,0.09865812070120716,"[1, 1, 1, 0, 1, 1, 0, 1, 0, 0]"
10120,1,1,2,0.6864590000438644,"[1, 0, 1, 1, 0, 1, 0, 0, 1, 0]"
10121,1,1,2,0.6009527104475115,"[1, 0, 1, 0, 1, 0, 1, 0, 1, 0]"
10122,1,1,2,0.9607020799523748,"[1, 0, 0, 1, 0, 1, 1, 1, 0, 0]"
10123,2,2,4,0.970101271227701,"[1, 0, 1, 1, 0, 0, 0, 1, 1, 1]"
10124,1,1,2,0.06389613004068173,"[1, 1, 1, 1, 0, 1, 1, 1, 0, 0]"
10125,1,1,2,0.7924234304225724,"[0, 0, 0, 0, 0, 0, 1, 0, 1, 0]"
10126,1,1,2,0.4506089373452067,"[0, 0, 0, 0, 1, 0, 0, 0, 0, 1]"
10127,4,4,8,0.02644804348281382,"[1, 0, 1, 1, 0, 0, 0, 1, 0, 0]"
10128,2,2,4,0.2968008426798654,"[0, 1, 1, 0, 1, 1, 1, 0, 0, 0]"
10129,2,2,4,0.10515915173717538,"[0, 0, 0, 1, 1, 0, 1, 1, 1, 1]"
10130,2,2,4,0.9660350952436348,"[1, 1, 0, 0, 0, 1, 1, 1, 0, 0]"
10131,1,1,2,0.8034806248053022,"[1, 0, 1, 0, 1, 1, 1, 1, 1, 1]"
10132,1,1,2,0.8831094203229372,"[1, 1, 1, 0, 0, 0, 0, 1, 0, 0]"
10133,1,1,2,0.009009047499993317,"[0, 1, 0, 0, 0, 0, 1, 0, 0, 1]"
10134,1,1,2,0.6808641582930421,"[1, 1, 0, 1, 0, 0, 0, 1, 0, 1]"
10135,1,1,2,0.5366925136056033,"[1, 0, 0, 1, 0, 1, 1, 1, 0, 0]"
10136,2,2,4,0.7211547021401764,"[0, 1, 0, 0, 1, 1, 0, 0, 0, 0]"
10137,3,3,6,0.1480471169489791,"[1, 1, 0, 1, 1, 0, 1, 1, 1, 0]"
10138,3,3,6,0.8519911606238979,"[1, 1, 0, 0, 1, 1, 1, 1, 1, 0]"
10139,1,1,2,0.5990672236234734,"[0, 0, 0, 0, 1, 1, 0, 0, 0, 0]"
10140,1,1,2,0.6652199121025443,"[0, 1, 0, 1, 0, 1, 1, 1, 0, 1]"
10141,1,1,2,0.5877895374733744,"[1, 1, 1, 0, 0, 1, 0, 1, 0, 1]"
10142,3,3,6,0.7504747116674411,"[1, 0, 0, 0, 1, 1, 1, 1, 0, 1]"
10143,1,1,2,0.5988103241447592,"[1, 0, 0, 0, 1, 0, 1, 0, 1, 1]"
10144,1,1,2,0.4107032032332667,"[0, 0, 1, 1, 1, 0, 1, 1, 1, 0]"
10145,1,1,2,0.8198121925801225,"[1, 0, 1, 1, 1, 1, 0, 0, 1, 1]"
10146,2,2,4,0.9581674801667951,"[0, 0, 0, 1, 1, 0, 1, 0, 0, 1]"
10147,1,1,2,0.3118964162202247,"[0, 0, 1, 1, 0, 1, 0, 0, 0, 0]"
10148,1,1,2,0.6904807744780752,"[1, 0, 0, 1, 1, 0, 0, 0, 1, 1]"
10149,2,2,4,0.182025755477368,"[0, 0, 0, 0, 0, 0, 1, 0, 1, 1]"
10150,1,1,2,0.17579735098069504,"[1, 0, 1, 1, 0, 0, 0, 0, 1, 0]"
10151,3,3,6,0.4686769838214495,"[0, 1, 0, 0, 0, 1, 1, 0, 0, 1]"
10152,1,1,2,0.244273705853419,"[1, 0, 0, 1, 1, 1, 0, 0, 1, 0]"
10153,3,3,6,0.3759478773919239,"[0, 1, 1, 1, 0, 1, 1, 0, 1, 1]"
10154,2,2,4,0.13541238359068208,"[1, 1, 0, 0, 0, 0, 1, 1, 1, 0]"
10155,2,2,4,0.6792120159409185,"[0, 0, 0, 0, 0, 1, 0, 0, 1, 0]"
10156,2,2,4,0.061171248835471315,"[1, 0, 1, 1, 1, 0, 1, 1, 0, 0]"
10157,3,3,6,0.666505718105865,"[1, 1, 1, 1, 0, 0, 0, 1, 1, 1]"
10158,1,1,2,0.04585818175743295,"[0, 1, 0, 0, 1, 1, 0, 1, 1, 0]"
10159,1,1,2,0.10999752378010874,"[0, 1, 1, 0, 0, 1, 0, 0, 1, 1]"
10160,1,1,2,0.06956425390470433,"[1, 0, 1, 1, 1, 0, 0, 0, 1, 1]"
10161,1,1,2,0.16808728030852116,"[1, 1, 1, 0, 1, 1, 0, 1, 0, 0]"
10162,1,1,2,0.2560619930102127,"[0, 0, 1, 1, 0, 0, 1, 1, 1, 0]"
10163,2,2,4,0.16311960641265044,"[1, 1, 0, 1, 1, 1, 0, 0, 0, 1]"
10164,1,1,2,0.3957609472472148,"[1, 1, 0, 0, 1, 0, 1, 0, 1, 0]"
10165,1,1,2,0.2292080077849381,"[1, 0, 0, 1, 1, 1, 0, 0, 0, 0]"
10166,1,1,2,0.9972522337459889,"[1, 0, 1, 1, 0, 1, 0, 1, 0, 0]"
10167,1,1,2,0.028821339966127124,"[0, 0, 1, 1, 1, 0, 0, 1, 1, 1]"
10168,1,1,2,0.9266741677147309,"[0, 1, 0, 0, 0, 1, 1, 1, 0, 1]"
10169,1,1,2,0.019769074544558563,"[1, 0, 1, 0, 1, 0, 1, 0, 1, 1]"
10170,2,2,4,0.21130757817942225,"[1, 1, 1, 1, 1, 1, 0, 0, 0, 1]"
10171,2,2,4,0.41260777944934346,"[0, 1, 1, 0, 1, 0, 1, 0, 1, 1]"
10172,1,1,2,0.6459030421084062,"[0, 1, 0, 1, 0, 1, 1, 1, 1, 0]"
10173,3,3,6,0.23384694622216717,"[1, 0, 1, 0, 0, 1, 1, 0, 0, 0]"
10174,1,1,2,0.28279671444674725,"[0, 1, 1, 1, 1, 0, 1, 1, 1, 0]"
10175,1,1,2,0.4743614906855784,"[0, 1, 0, 0, 0, 1, 0, 0, 0, 1]"
10176,1,1,2,0.7515086009057946,"[1, 0, 0, 0, 1, 1, 0, 0, 0, 1]"
10177,1,1,2,0.4698108728887255,"[1, 1, 0, 1, 0, 1, 1, 0, 0, 0]"
10178,1,1,2,0.7705893296601615,"[1, 0, 0, 1, 1, 0, 0, 0, 1, 1]"
10179,1,1,2,0.46683409241352125,"[1, 1, 1, 0, 0, 0, 0, 0, 1, 1]"
10180,2,2,4,0.2653409701691818,"[1, 0, 0, 1, 1, 1, 1, 1, 1, 0]"
10181,1,1,2,0.25482612167781893,"[0, 0, 1, 0, 1, 0, 0, 0, 1, 0]"
10182,1,1,2,0.03990628733427426,"[0, 0, 0, 1, 1, 0, 1, 0, 0, 1]"
10183,1,1,2,0.2595032256029758,"[1, 1, 1, 1, 0, 1, 1, 1, 0, 1]"
10184,1,1,2,0.5191539981920114,"[0, 1, 0, 0, 1, 0, 1, 0, 0, 1]"
10185,1,1,2,0.01789902480539296,"[0, 1, 0, 0, 0, 1, 0, 0, 1, 1]"
10186,1,1,2,0.21670031088542197,"[0, 1, 1, 0, 0, 1, 1, 0, 1, 1]"
10187,2,2,4,0.6694225352350779,"[1, 1, 1, 0, 1, 1, 0, 1, 0, 0]"
10188,3,3,6,0.7332813263332655,"[1, 1, 1, 0, 1, 1, 0, 0, 1, 1]"
10189,1,1,2,0.5273937552996109,"[0, 0, 0, 0, 1, 1, 0, 0, 1, 0]"
10190,1,1,2,0.5864622920112587,"[0, 1, 0, 0, 0, 0, 1, 1, 1, 0]"
10191,1,1,2,0.5624683526775114,"[1, 0, 0, 1, 0, 1, 1, 0, 1, 0]"
10192,1,1,2,0.384045220753519,"[0, 1, 0, 0, 1, 0, 1, 1, 0, 0]"
10193,1,1,2,0.3019933642929158,"[1, 1, 1, 0, 1, 1, 0, 1, 1, 1]"
10194,1,1,2,0.5046826621106345,"[0, 0, 0, 0, 0, 0, 1, 0, 1, 1]"
10195,1,1,2,0.1848645245092625,"[0, 0, 1, 0, 0, 1, 1, 0, 0, 1]"
10196,1,1,2,0.5863693454215655,"[0, 0, 1, 0, 1, 1, 1, 0, 1, 1]"
10197,1,1,2,0.7951772454987734,"[1, 1, 1, 0, 1, 0, 1, 0, 0, 1]"
10198,1,1,2,0.771939020161209,"[0, 0, 1, 1, 0, 1, 0, 0, 0, 1]"
10199,1,1,2,0.7376043291877121,"[0, 0, 1, 1, 1, 0, 1, 1, 0, 1]"
10200,1,1,2,0.41302861551638215,"[1, 0, 1, 0, 1, 0, 0, 1, 0, 0]"
10201,1,1,2,0.36824617737361376,"[1, 0, 0, 0, 0, 0, 0, 1, 1, 0]"
10202,2,2,4,0.4716109370187175,"[0, 0, 1, 0, 0, 0, 1, 1, 1, 0]"
10203,1,1,2,0.047114745410335446,"[0, 0, 1, 1, 1, 1, 0, 1, 1, 0]"
10204,1,1,2,0.8666120237910355,"[1, 0, 1, 0, 0, 0, 1, 0, 0, 0]"
10205,1,1,2,0.7797806952319274,"[1, 0, 1, 0, 0, 0, 1, 1, 0, 0]"
10206,1,1,2,0.7070288438570187,"[0, 1, 1, 1, 0, 0, 1, 1, 0, 1]"
10207,1,1,2,0.08977491726774334,"[1, 1, 1, 0, 1, 0, 0, 0, 1, 0]"
10208,1,1,2,0.4334155535435966,"[0, 0, 0, 1, 1, 1, 0, 1, 0, 0]"
10209,1,1,2,0.3352840668019573,"[0, 0, 0, 0, 0, 0, 0, 0, 0, 1]"
10210,1,1,2,0.6110524104018054,"[0, 1, 1, 0, 0, 0, 0, 0, 0, 1]"
10211,1,1,2,0.08207354897073049,"[0, 1, 0, 1, 1, 1, 0, 0, 0, 1]"
10212,1,1,2,0.29642545284311594,"[0, 1, 0, 1, 1, 1, 0, 0, 1, 1]"
10213,1,1,2,0.7237944306368759,"[1, 1, 0, 0, 1, 0, 0, 1, 0, 0]"
10214,1,1,2,0.9006886467323523,"[1, 1, 1, 1, 1, 0, 0, 1, 1, 1]"
10215,2,2,4,0.6957898719191332,"[1, 0, 0, 1, 1, 0, 1, 1, 0, 0]"
10216,2,2,4,0.9249222008995301,"[1, 0, 1, 1, 0, 1, 0, 0, 1, 1]"
10217,3,3,6,0.10387293869947578,"[0, 0, 0, 0, 0, 1, 1, 1, 1, 0]"
10218,1,1,2,0.8449368061419958,"[0, 1, 0, 1, 0, 1, 0, 1, 0, 1]"
10219,1,1,2,0.8631646716188514,"[0, 1, 0, 0, 0, 1, 0, 1, 1, 0]"
10220,1,1,2,0.5782311226185151,"[0, 1, 1, 0, 1, 0, 0, 1, 0, 1]"
10221,1,1,2,0.1775135736990986,"[1, 1, 1, 1, 0, 0, 0, 1, 1, 0]"
10222,1,1,2,0.8455686942202078,"[1, 0, 0, 0, 1, 1, 1, 0, 0, 1]"
10223,1,1,2,0.965800492479748,"[1, 1, 0, 1, 1, 0, 0, 1, 1, 0]"
10224,2,2,4,0.14192916134735345,"[0, 1, 1, 0, 0, 0, 1, 1, 0, 1]"
10225,1,1,2,0.5147432589566792,"[1, 0, 0, 1, 0, 0, 1, 0, 1, 0]"
10226,1,1,2,0.3169631485133305,"[1, 0, 0, 0, 1, 1, 0, 1, 1, 1]"
10227,1,1,2,0.5115307225239564,"[1, 1, 1, 1, 1, 0, 0, 1, 1, 1]"
10228,1,1,2,0.44603607731978945,"[1, 0, 1, 0, 0, 1, 0, 1, 1, 0]"
10229,1,1,2,0.8182663877356701,"[1, 1, 1, 1, 1, 0, 1, 0, 0, 0]"
10230,3,3,6,0.024554023254365287,"[1, 1, 0, 1, 1, 0, 1, 1, 0, 0]"
10231,3,3,6,0.6736057854201996,"[1, 1, 1, 1, 1, 0, 1, 0, 1, 0]"
10232,6,6,12,0.6619360756493955,"[1, 0, 0, 0, 0, 1, 1, 1, 1, 1]"
10233,1,1,2,0.9490209855456935,"[0, 0, 1, 1, 0, 1, 0, 0, 0, 0]"
10234,1,1,2,0.7292112143598258,"[1, 0, 0, 0, 1, 0, 0, 1, 0, 1]"
10235,1,1,2,0.6820122214772938,"[0, 1, 1, 1, 1, 1, 0, 0, 1, 0]"
10236,4,4,8,0.6643115047179489,"[0, 0, 1, 0, 1, 1, 0, 0, 1, 1]"
10237,2,2,4,0.25167739231181874,"[0, 0, 1, 1, 1, 0, 0, 0, 1, 0]"
10238,2,2,4,0.6202460980599502,"[1, 0, 0, 0, 0, 1, 0, 0, 0, 1]"
10239,2,2,4,0.26717844387590883,"[1, 0, 0, 1, 0, 0, 1, 0, 0, 0]"
10240,2,2,4,0.3442234407928335,"[0, 0, 1, 0, 0, 1, 1, 0, 0, 0]"
10241,1,1,2,0.9024760657926917,"[0, 1, 1, 1, 0, 1, 1, 0, 0, 0]"
10242,1,1,2,0.5732198642566193,"[1, 0, 0, 0, 0, 0, 1, 1, 0, 1]"
10243,2,2,4,0.6297592383607983,"[0, 0, 0, 0, 1, 1, 0, 0, 0, 1]"
10244,1,1,2,0.19698989408480383,"[1, 0, 0, 1, 1, 0, 1, 0, 1, 1]"
10245,1,1,2,0.2934330005697535,"[0, 0, 1, 0, 1, 1, 0, 1, 0, 0]"
10246,1,1,2,0.09510456102908216,"[0, 1, 0, 0, 1, 0, 0, 1, 1, 0]"
10247,1,1,2,0.5494302121534121,"[0, 1, 0, 0, 0, 0, 1, 0, 1, 0]"
10248,1,1,2,0.7012235040209456,"[1, 1, 0, 1, 0, 1, 0, 1, 0, 0]"
10249,1,1,2,0.8511503783779987,"[1, 1, 1, 0, 1, 1, 0, 0, 0, 0]"
10250,1,1,2,0.32381413200649656,"[0, 1, 0, 0, 1, 1, 1, 1, 1, 1]"
10251,2,2,4,0.08800967660787773,"[0, 0, 0, 1, 1, 0, 1, 1, 0, 0]"
10252,3,3,6,0.542660549686117,"[1, 1, 0, 1, 0, 1, 1, 1, 1, 1]"
10253,2,2,4,0.7732614099183879,"[0, 0, 0, 0, 1, 0, 1, 0, 1, 0]"
10254,1,1,2,0.07494092417881348,"[1, 0, 0, 0, 1, 1, 1, 0, 1, 0]"
10255,1,1,2,0.658315826140593,"[0, 0, 0, 1, 0, 0, 1, 1, 1, 1]"
10256,1,1,2,0.9885749887972771,"[0, 0, 1, 1, 1, 0, 0, 0, 0, 0]"
10257,1,1,2,0.8901183151072364,"[0, 1, 1, 1, 0, 0, 0, 1, 0, 1]"
10258,2,2,4,0.9996884566963029,"[1, 1, 1, 0, 1, 1, 1, 0, 0, 1]"
10259,4,4,8,0.38842974130269525,"[1, 1, 1, 1, 1, 1, 0, 1, 1, 0]"
10260,3,3,6,0.38659986850085337,"[1, 1, 0, 1, 0, 1, 0, 0, 0, 1]"
10261,2,2,4,0.046141992834692225,"[0, 0, 1, 0, 1, 1, 0, 0, 1, 0]"
10262,1,1,2,0.6300744743579465,"[0, 1, 0, 0, 1, 0, 1, 0, 0, 0]"
10263,1,1,2,0.9910586957909961,"[1, 0, 1, 0, 1, 0, 0, 0, 0, 0]"
10264,1,1,2,0.9195346105496354,"[1, 1, 1, 1, 1, 1, 1, 0, 1, 0]"
10265,1,1,2,0.6054380591246405,"[0, 0, 0, 1, 1, 1, 0, 1, 0, 1]"
10266,1,1,2,0.7481868157407843,"[0, 1, 1, 0, 1, 0, 0, 0, 1, 0]"
10267,1,1,2,0.423269459572011,"[1, 1, 0, 0, 0, 0, 0, 1, 1, 0]"
10268,1,1,2,0.9741849559011555,"[0, 0, 1, 0, 1, 0, 1, 1, 1, 0]"
10269,1,1,2,0.5732979183576274,"[0, 0, 1, 0, 0, 1, 0, 0, 0, 0]"
10270,1,1,2,0.26345859811312267,"[0, 1, 1, 0, 1, 1, 1, 0, 0, 0]"
10271,1,1,2,0.7267329687293343,"[0, 0, 1, 1, 1, 0, 1, 0, 0, 1]"
10272,1,1,2,0.7610834248490043,"[0, 1, 0, 0, 1, 0, 0, 0, 0, 0]"
10273,1,1,2,0.11600943079282267,"[0, 0, 1, 0, 1, 0, 0, 1, 1, 1]"
10274,1,1,2,0.11393495224251526,"[1, 0, 0, 0, 0, 1, 0, 1, 0, 0]"
10275,4,4,8,0.00819200008547849,"[0, 1, 0, 0, 1, 1, 0, 0, 1, 0]"
10276,2,2,4,0.7689300609679274,"[1, 0, 1, 0, 0, 0, 0, 0, 1, 0]"
10277,1,1,2,0.6844370632473115,"[1, 0, 1, 1, 1, 0, 1, 1, 1, 1]"
10278,2,2,4,0.6080415251212088,"[0, 1, 0, 0, 0, 0, 0, 1, 1, 0]"
10279,1,1,2,0.8224557646678098,"[1, 0, 1, 1, 0, 0, 0, 1, 0, 0]"
10280,1,1,2,0.4205102147896741,"[1, 0, 0, 1, 1, 1, 0, 0, 1, 1]"
10281,1,1,2,0.1752312034266742,"[1, 0, 1, 0, 1, 0, 1, 0, 1, 0]"
10282,1,1,2,0.06784216545147304,"[0, 0, 0, 1, 1, 1, 1, 1, 1, 0]"
10283,3,3,6,0.5019401403709229,"[1, 0, 1, 1, 0, 0, 1, 1, 1, 0]"
10284,1,1,2,0.13093537254860876,"[1, 0, 0, 0, 1, 0, 0, 0, 1, 1]"
10285,2,2,4,0.8715195337040045,"[1, 1, 0, 0, 1, 1, 0, 0, 0, 1]"
10286,1,1,2,0.8841648166593619,"[0, 0, 1, 1, 0, 0, 1, 0, 1, 0]"
10287,1,1,2,0.8181664121914437,"[1, 1, 0, 0, 0, 1, 1, 0, 0, 1]"
10288,1,1,2,0.9754341315760643,"[0, 0, 1, 0, 0, 0, 0, 0, 1, 1]"
10289,2,2,4,0.859578109312592,"[0, 1, 1, 0, 1, 1, 0, 1, 1, 1]"
10290,1,1,2,0.12545960802571188,"[0, 1, 1, 1, 0, 0, 0, 1, 0, 1]"
10291,2,2,4,0.33870030707537613,"[1, 1, 1, 0, 0, 0, 0, 1, 0, 0]"
10292,2,2,4,0.058319943743377456,"[1, 1, 1, 1, 0, 1, 1, 0, 1, 0]"
10293,3,3,6,0.1746636614108137,"[1, 1, 0, 1, 0, 1, 1, 0, 1, 0]"
10294,2,2,4,0.5952762846127255,"[1, 1, 1, 0, 1, 0, 1, 0, 1, 0]"
10295,1,1,2,0.3392992871478354,"[1, 0, 1, 0, 0, 1, 0, 1, 0, 0]"
10296,1,1,2,0.15187118108042286,"[0, 0, 0, 0, 1, 1, 0, 1, 1, 0]"
10297,1,1,2,0.4221986175967204,"[1, 1, 1, 0, 1, 1, 1, 1, 0, 0]"
10298,2,2,4,0.2727625410389398,"[1, 1, 0, 0, 0, 0, 0, 0, 1, 1]"
10299,1,1,2,0.517023468097482,"[0, 0, 0, 0, 0, 0, 1, 0, 0, 0]"
10300,2,2,4,0.02857402364670969,"[1, 1, 1, 1, 0, 0, 1, 0, 1, 1]"
10301,1,1,2,0.19246566783015662,"[1, 0, 1, 0, 0, 1, 1, 1, 1, 1]"
10302,1,1,2,0.01083252220837072,"[1, 0, 1, 0, 1, 0, 1, 0, 1, 1]"
10303,1,1,2,0.2501953352213563,"[0, 0, 1, 1, 1, 0, 0, 1, 1, 0]"
10304,1,1,2,0.5790072542350673,"[0, 0, 0, 1, 0, 1, 0, 0, 0, 1]"
10305,1,1,2,0.8898651875695445,"[1, 0, 0, 0, 1, 1, 1, 1, 0, 0]"
10306,3,3,6,0.7202710431212391,"[0, 0, 1, 1, 0, 1, 1, 1, 1, 1]"
10307,1,1,2,0.3957953319763404,"[1, 0, 0, 0, 1, 0, 0, 0, 0, 0]"
10308,1,1,2,0.22921821436488288,"[0, 0, 1, 0, 1, 1, 1, 0, 0, 1]"
10309,1,1,2,0.8234295058981927,"[0, 0, 0, 0, 1, 0, 1, 0, 0, 1]"
10310,2,2,4,0.5882735768819221,"[1, 1, 0, 1, 0, 0, 0, 1, 1, 1]"
10311,1,1,2,0.9866923381007517,"[0, 1, 0, 0, 1, 1, 1, 0, 0, 1]"
10312,1,1,2,0.11198332561063984,"[1, 0, 1, 1, 0, 0, 0, 0, 1, 0]"
10313,1,1,2,0.2876707540114929,"[0, 0, 1, 0, 0, 1, 0, 0, 0, 0]"
10314,1,1,2,0.2907368209872889,"[1, 1, 0, 1, 0, 0, 0, 1, 0, 1]"
10315,1,1,2,0.7449717467316657,"[0, 0, 0, 0, 0, 1, 1, 0, 0, 0]"
10316,1,1,2,0.1704877848528208,"[0, 1, 0, 0, 1, 0, 0, 0, 0, 1]"
10317,3,3,6,0.7533024338822709,"[1, 0, 1, 1, 0, 1, 0, 0, 1, 0]"
10318,1,1,2,0.11369343317649094,"[1, 0, 1, 0, 0, 1, 0, 0, 0, 0]"
10319,1,1,2,0.8861181596132501,"[1, 1, 1, 1, 0, 0, 0, 0, 1, 0]"
10320,1,1,2,0.8290160824874553,"[0, 1, 0, 1, 0, 1, 0, 1, 1, 0]"
10321,1,1,2,0.375201163177052,"[1, 0, 1, 1, 1, 0, 0, 1, 1, 1]"
10322,1,1,2,0.43427786627251974,"[1, 0, 0, 0, 1, 1, 1, 1, 0, 1]"
10323,1,1,2,0.6930101666528592,"[0, 1, 1, 1, 1, 0, 1, 1, 1, 0]"
10324,1,1,2,0.48151621985707105,"[0, 0, 0, 1, 0, 1, 1, 0, 1, 0]"
10325,2,2,4,0.6178818155589438,"[0, 0, 0, 0, 0, 1, 1, 0, 0, 1]"
10326,1,1,2,0.9170781885358805,"[1, 1, 0, 1, 1, 1, 0, 0, 1, 1]"
10327,1,1,2,0.9689907460964837,"[0, 1, 0, 0, 1, 1, 1, 0, 0, 0]"
10328,1,1,2,0.4053180561616341,"[1, 0, 1, 0, 1, 0, 0, 1, 0, 1]"
10329,2,2,4,0.3894464942376875,"[0, 0, 1, 1, 1, 1, 1, 0, 0, 1]"
10330,1,1,2,0.9507713652768459,"[1, 1, 0, 1, 0, 0, 0, 0, 0, 1]"
10331,1,1,2,0.9024505352075785,"[0, 0, 1, 1, 0, 1, 0, 1, 0, 0]"
10332,1,1,2,0.6396526968885184,"[0, 0, 1, 0, 0, 1, 1, 1, 0, 0]"
10333,1,1,2,0.3701320912293976,"[0, 1, 1, 0, 0, 0, 0, 1, 1, 1]"
10334,1,1,2,0.7584032697857536,"[1, 0, 1, 1, 0, 0, 0, 1, 1, 0]"
10335,1,1,2,0.6661202433477308,"[1, 0, 1, 1, 0, 0, 1, 0, 1, 0]"
10336,4,4,8,0.5592491649903072,"[0, 0, 0, 0, 1, 1, 1, 1, 1, 0]"
10337,1,1,2,0.9624375391288008,"[1, 1, 0, 1, 0, 0, 1, 1, 0, 1]"
10338,2,2,4,0.9335943383751336,"[1, 1, 0, 1, 0, 0, 1, 1, 0, 1]"
10339,1,1,2,0.6990884614345124,"[0, 0, 0, 0, 0, 0, 0, 1, 0, 1]"
10340,3,3,6,0.9073906707981338,"[0, 1, 1, 1, 1, 1, 1, 0, 0, 1]"
10341,2,2,4,0.08867490464141303,"[1, 1, 1, 1, 0, 0, 0, 1, 0, 1]"
10342,1,1,2,0.9822214302752253,"[0, 0, 0, 0, 0, 1, 0, 1, 0, 1]"
10343,1,1,2,0.7405673557333315,"[0, 0, 1, 0, 0, 1, 1, 0, 1, 0]"
10344,1,1,2,0.122278284378324,"[0, 1, 0, 1, 1, 0, 0, 0, 0, 0]"
10345,2,2,4,0.826336603876517,"[0, 1, 1, 0, 0, 0, 1, 1, 1, 1]"
10346,1,1,2,0.9993360850163483,"[1, 1, 1, 1, 0, 0, 1, 1, 1, 0]"
10347,1,1,2,0.4358170211221525,"[1, 0, 1, 1, 1, 1, 0, 1, 1, 0]"
10348,1,1,2,0.46618340587427376,"[1, 0, 0, 0, 0, 1, 0, 1, 1, 0]"
10349,1,1,2,0.38849814240459557,"[0, 1, 0, 0, 1, 0, 1, 0, 1, 0]"
10350,2,2,4,0.8892340888631467,"[1, 0, 0, 0, 1, 1, 0, 1, 0, 1]"
10351,1,1,2,0.769882456577421,"[1, 0, 0, 1, 0, 1, 1, 0, 0, 1]"
10352,1,1,2,0.49562292685295195,"[1, 0, 0, 1, 1, 0, 1, 0, 1, 0]"
10353,1,1,2,0.6989264542580048,"[1, 1, 0, 0, 0, 1, 0, 1, 1, 0]"
10354,1,1,2,0.9844995772775103,"[0, 0, 0, 0, 1, 0, 1, 0, 1, 0]"
10355,1,1,2,0.5042507583926681,"[0, 0, 1, 0, 1, 0, 1, 1, 1, 1]"
10356,1,1,2,0.23258878884557355,"[0, 1, 1, 1, 1, 1, 1, 0, 0, 1]"
10357,2,2,4,0.04005707722668317,"[1, 0, 1, 1, 1, 0, 0, 0, 1, 0]"
10358,2,2,4,0.623389420613708,"[0, 1, 1, 1, 0, 1, 1, 0, 1, 0]"
10359,1,1,2,0.5617817236661852,"[0, 1, 0, 0, 1, 0, 0, 0, 1, 0]"
10360,1,1,2,0.20893798421524878,"[0, 1, 1, 0, 0, 0, 1, 0, 0, 1]"
10361,2,2,4,0.9167576042469241,"[0, 0, 1, 1, 1, 0, 1, 0, 1, 1]"
10362,4,4,8,0.09046057472323177,"[0, 1, 1, 1, 0, 0, 1, 1, 1, 0]"
10363,1,1,2,0.1389246226860188,"[0, 0, 1, 0, 0, 0, 1, 0, 0, 1]"
10364,2,2,4,0.2176005989333547,"[0, 0, 1, 0, 0, 0, 0, 1, 1, 1]"
10365,2,2,4,0.731627314501637,"[1, 0, 0, 0, 0, 1, 1, 0, 1, 1]"
10366,1,1,2,0.8062667766734313,"[0, 1, 0, 0, 0, 0, 0, 0, 1, 0]"
10367,1,1,2,0.5051592830590963,"[0, 0, 0, 1, 1, 0, 0, 1, 0, 1]"
10368,1,1,2,0.38514344147090995,"[1, 1, 0, 1, 1, 0, 1, 0, 1, 0]"
10369,2,2,4,0.5773641216146064,"[1, 0, 0, 1, 0, 1, 1, 1, 0, 0]"
10370,1,1,2,0.8740200496118855,"[0, 0, 0, 0, 0, 0, 0, 0, 1, 0]"
10371,1,1,2,0.6395523491637797,"[0, 1, 0, 1, 0, 1, 0, 1, 1, 0]"
10372,3,3,6,0.9481635148488458,"[0, 0, 0, 1, 1, 0, 1, 1, 1, 1]"
10373,1,1,2,0.8062533152109361,"[1, 0, 1, 0, 0, 0, 1, 0, 0, 1]"
10374,2,2,4,0.9421769141643669,"[0, 1, 1, 0, 1, 0, 1, 1, 0, 1]"
10375,1,1,2,0.47636685345600915,"[1, 0, 1, 1, 1, 1, 0, 0, 0, 0]"
10376,1,1,2,0.12263648075805544,"[0, 0, 0, 1, 0, 1, 1, 0, 0, 1]"
10377,1,1,2,0.687274464506171,"[1, 1, 0, 1, 0, 0, 0, 0, 0, 0]"
10378,1,1,2,0.7875270811045617,"[0, 1, 1, 1, 1, 0, 0, 1, 1, 1]"
10379,1,1,2,0.4034555381038063,"[1, 0, 0, 0, 0, 0, 1, 1, 0, 1]"
10380,1,1,2,0.06285489367405395,"[0, 0, 1, 0, 0, 0, 0, 1, 0, 1]"
10381,3,3,6,0.5688739493411649,"[1, 1, 0, 1, 1, 1, 1, 1, 1, 0]"
10382,1,1,2,0.4136682792669022,"[1, 1, 0, 1, 0, 0, 0, 1, 0, 0]"
10383,1,1,2,0.6798933555284739,"[0, 1, 0, 0, 1, 0, 0, 1, 1, 0]"
10384,1,1,2,0.4733311672783487,"[1, 0, 1, 1, 1, 0, 0, 0, 0, 0]"
10385,1,1,2,0.36017878688279414,"[0, 1, 1, 0, 0, 0, 0, 0, 1, 0]"
10386,2,2,4,0.6574461846502134,"[1, 0, 1, 0, 0, 1, 1, 1, 0, 1]"
10387,2,2,4,0.21146052156499917,"[1, 1, 0, 0, 1, 0, 1, 1, 0, 0]"
10388,1,1,2,0.5597461103555414,"[1, 1, 0, 0, 0, 1, 1, 0, 1, 0]"
10389,1,1,2,0.20708888614792864,"[0, 1, 1, 1, 1, 0, 0, 1, 0, 0]"
10390,2,2,4,0.002240731590574141,"[0, 1, 0, 1, 0, 0, 0, 1, 1, 1]"
10391,4,4,8,0.6875566231685775,"[1, 0, 1, 0, 1, 0, 1, 0, 1, 0]"
10392,1,1,2,0.8370223747765714,"[1, 0, 0, 0, 1, 0, 1, 1, 0, 1]"
10393,1,1,2,0.025168917985472494,"[0, 1, 0, 1, 1, 1, 0, 1, 0, 1]"
10394,4,4,8,0.07810973910584973,"[1, 0, 1, 1, 0, 0, 1, 0, 1, 1]"
10395,1,1,2,0.24141266028602038,"[0, 0, 1, 1, 0, 1, 1, 0, 0, 0]"
10396,1,1,2,0.5261454544433966,"[1, 0, 1, 0, 0, 0, 1, 0, 0, 0]"
10397,1,1,2,0.5850083600764053,"[1, 0, 0, 0, 0, 0, 1, 0, 0, 0]"
10398,1,1,2,0.9599476336894341,"[0, 1, 0, 1, 0, 0, 0, 0, 1, 0]"
10399,1,1,2,0.759809204415729,"[0, 0, 0, 1, 1, 1, 0, 1, 0, 1]"
10400,1,1,2,0.42022062152316153,"[0, 1, 1, 0, 0, 1, 1, 1, 1, 0]"
10401,2,2,4,0.5358814484818809,"[1, 1, 1, 0, 0, 1, 0, 1, 1, 1]"
10402,1,1,2,0.7557765127466765,"[0, 0, 1, 0, 0, 1, 0, 1, 1, 1]"
10403,1,1,2,0.4568963109824783,"[1, 0, 1, 1, 0, 0, 0, 1, 0, 0]"
10404,1,1,2,0.7698264697940883,"[0, 0, 0, 1, 0, 0, 1, 0, 0, 1]"
10405,1,1,2,0.3647248925130899,"[0, 0, 0, 0, 1, 1, 0, 0, 1, 0]"
10406,1,1,2,0.27066596101426055,"[0, 1, 1, 1, 0, 1, 0, 1, 0, 0]"
10407,1,1,2,0.9444295265093959,"[0, 0, 0, 0, 0, 1, 1, 1, 0, 1]"
10408,1,1,2,0.9455295372213826,"[0, 0, 1, 1, 1, 0, 1, 1, 1, 0]"
10409,1,1,2,0.11157024826204531,"[1, 0, 1, 1, 1, 1, 1, 0, 1, 0]"
10410,2,2,4,0.6963562777541181,"[0, 1, 1, 1, 1, 1, 1, 0, 0, 0]"
10411,2,2,4,0.8831536570756863,"[1, 0, 0, 0, 1, 1, 0, 1, 1, 1]"
10412,1,1,2,0.12522549750272438,"[0, 1, 1, 0, 1, 0, 0, 0, 0, 0]"
10413,1,1,2,0.6068252022827156,"[1, 1, 1, 1, 1, 0, 1, 1, 0, 0]"
10414,1,1,2,0.5942967194276728,"[0, 1, 0, 0, 1, 0, 0, 0, 1, 1]"
10415,1,1,2,0.6644752756746561,"[1, 1, 1, 1, 0, 0, 1, 0, 0, 0]"
10416,1,1,2,0.3927919017704945,"[0, 1, 0, 1, 1, 0, 0, 1, 0, 0]"
10417,1,1,2,0.2423761326752445,"[1, 0, 0, 0, 1, 0, 1, 0, 0, 1]"
10418,1,1,2,0.9713518484248913,"[0, 0, 1, 0, 0, 0, 0, 1, 0, 0]"
10419,1,1,2,0.05919905729676411,"[1, 1, 0, 0, 1, 0, 0, 0, 1, 0]"
10420,1,1,2,0.27557339030398864,"[0, 0, 0, 0, 0, 0, 0, 0, 0, 0]"
10421,1,1,2,0.2967766805332408,"[1, 1, 0, 1, 0, 0, 0, 0, 0, 0]"
10422,1,1,2,0.6831418080595986,"[0, 1, 0, 1, 1, 1, 1, 1, 1, 0]"
10423,3,3,6,0.726126172305938,"[0, 0, 1, 0, 1, 1, 0, 1, 1, 0]"
10424,1,1,2,0.32304341437612794,"[0, 0, 0, 0, 0, 1, 0, 1, 1, 0]"
10425,3,3,6,0.1664573740645401,"[0, 0, 1, 1, 0, 1, 0, 1, 0, 0]"
10426,3,3,6,0.5268340363031445,"[1, 0, 0, 1, 1, 1, 0, 1, 1, 0]"
10427,1,1,2,0.1520492734362867,"[0, 0, 1, 0, 0, 0, 0, 1, 0, 0]"
10428,1,1,2,0.6875176358090643,"[0, 1, 0, 0, 1, 0, 1, 1, 1, 0]"
10429,1,1,2,0.29290131721613455,"[0, 1, 1, 1, 0, 0, 1, 0, 1, 1]"
10430,1,1,2,0.0691425858419179,"[1, 0, 0, 0, 1, 0, 1, 1, 0, 1]"
10431,2,2,4,0.8783996333879396,"[0, 1, 1, 0, 0, 1, 1, 1, 1, 1]"
10432,1,1,2,0.5803419131308333,"[0, 1, 0, 0, 0, 0, 1, 0, 1, 0]"
10433,1,1,2,0.4587429444042668,"[1, 0, 0, 1, 1, 0, 0, 0, 1, 0]"
10434,1,1,2,0.022628186973368436,"[0, 1, 0, 0, 0, 0, 1, 0, 1, 1]"
10435,2,2,4,0.43204256094860893,"[0, 0, 0, 0, 1, 1, 0, 1, 1, 0]"
10436,1,1,2,0.8602091604343052,"[1, 0, 0, 0, 1, 0, 1, 1, 1, 0]"
10437,1,1,2,0.8383892248497835,"[1, 0, 0, 1, 1, 0, 0, 0, 0, 1]"
10438,1,1,2,0.7141306787441488,"[1, 0, 1, 0, 0, 0, 0, 1, 0, 0]"
10439,2,2,4,0.967411617910046,"[1, 1, 1, 1, 1, 0, 1, 1, 1, 1]"
10440,1,1,2,0.4421957741928224,"[0, 1, 0, 0, 1, 0, 1, 0, 1, 0]"
10441,2,2,4,0.7009246667746357,"[1, 1, 1, 1, 1, 0, 0, 1, 0, 0]"
10442,1,1,2,0.8150524098328865,"[0, 1, 1, 1, 1, 0, 1, 0, 1, 0]"
10443,1,1,2,0.612664240589143,"[1, 1, 0, 1, 1, 0, 0, 1, 1, 0]"
10444,1,1,2,0.2303334011939866,"[1, 0, 0, 1, 0, 0, 1, 0, 0, 1]"
10445,3,3,6,0.06746642215021936,"[1, 1, 1, 1, 1, 1, 0, 1, 1, 1]"
10446,1,1,2,0.5710835587698028,"[1, 1, 0, 1, 1, 1, 1, 1, 0, 0]"
10447,1,1,2,0.5453414548056433,"[1, 0, 0, 0, 0, 1, 0, 0, 0, 0]"
10448,1,1,2,0.7590089879845197,"[1, 0, 0, 1, 1, 0, 0, 0, 1, 0]"
10449,1,1,2,0.46725558792310795,"[0, 1, 0, 1, 1, 0, 1, 1, 0, 0]"
10450,1,1,2,0.9548431322977304,"[1, 1, 0, 0, 0, 0, 1, 0, 0, 1]"
10451,2,2,4,0.3212329966607693,"[0, 1, 1, 1, 0, 0, 0, 0, 0, 1]"
10452,1,1,2,0.2435755342191298,"[1, 0, 1, 0, 1, 0, 1, 1, 0, 1]"
10453,2,2,4,0.6560356756687555,"[1, 1, 0, 1, 1, 1, 0, 1, 0, 1]"
10454,1,1,2,0.9479027605465927,"[0, 0, 1, 0, 0, 0, 0, 1, 0, 0]"
10455,1,1,2,0.6952315600485325,"[0, 0, 1, 1, 0, 1, 0, 1, 1, 0]"
10456,1,1,2,0.7308374250664811,"[0, 0, 0, 0, 1, 0, 1, 1, 0, 1]"
10457,1,1,2,0.810577404247031,"[0, 0, 0, 1, 0, 0, 1, 1, 1, 1]"
10458,1,1,2,0.36436926065380915,"[1, 1, 1, 0, 0, 0, 0, 0, 0, 1]"
10459,1,1,2,0.6572872532294557,"[0, 0, 1, 1, 1, 0, 1, 0, 0, 1]"
10460,1,1,2,0.6960438550839758,"[0, 1, 0, 0, 0, 0, 0, 1, 0, 0]"
10461,1,1,2,0.2637108227535412,"[0, 0, 1, 0, 1, 0, 0, 1, 1, 1]"
10462,1,1,2,0.2863407823173103,"[1, 1, 0, 0, 1, 0, 1, 1, 1, 1]"
10463,1,1,2,0.17221375813721773,"[1, 0, 1, 0, 1, 1, 1, 1, 1, 0]"
10464,1,1,2,0.22193612060805068,"[1, 1, 1, 0, 1, 0, 0, 1, 0, 1]"
10465,1,1,2,0.18472307016370504,"[0, 1, 0, 0, 0, 1, 0, 1, 0, 1]"
10466,1,1,2,0.6530532748024712,"[1, 0, 0, 1, 1, 0, 0, 1, 0, 0]"
10467,3,3,6,0.08514760387496823,"[1, 0, 0, 1, 0, 1, 1, 0, 0, 1]"
10468,1,1,2,0.1628450731592065,"[1, 0, 1, 0, 0, 1, 1, 0, 1, 0]"
10469,1,1,2,0.18788938002750755,"[1, 0, 0, 1, 0, 0, 0, 0, 0, 1]"
10470,1,1,2,0.3862307266693581,"[0, 1, 1, 0, 1, 0, 1, 0, 0, 0]"
10471,1,1,2,0.055902624682775626,"[1, 0, 0, 0, 1, 0, 1, 0, 1, 1]"
10472,1,1,2,0.3408025995516516,"[1, 0, 1, 0, 1, 1, 1, 0, 1, 1]"
10473,1,1,2,0.30798443475052284,"[0, 0, 1, 1, 0, 1, 1, 0, 0, 0]"
10474,1,1,2,0.10701637752825655,"[0, 1, 1, 1, 0, 0, 1, 0, 1, 1]"
10475,2,2,4,0.5038736887570651,"[1, 0, 1, 1, 0, 0, 0, 1, 1, 0]"
10476,2,2,4,0.5650162628644375,"[1, 0, 1, 0, 0, 0, 0, 1, 0, 0]"
10477,1,1,2,0.19656541721420318,"[0, 0, 1, 0, 0, 1, 1, 1, 0, 1]"
10478,1,1,2,0.09992700418219491,"[0, 0, 0, 1, 0, 0, 0, 0, 1, 0]"
10479,1,1,2,0.9976183018101779,"[1, 0, 1, 1, 1, 1, 0, 1, 1, 0]"
10480,2,2,4,0.018173131041042456,"[1, 1, 0, 1, 1, 1, 0, 1, 0, 1]"
10481,1,1,2,0.18140038457212437,"[0, 0, 0, 1, 0, 1, 1, 0, 1, 0]"
10482,1,1,2,0.9387138887723725,"[1, 1, 1, 1, 1, 1, 1, 0, 0, 0]"
10483,1,1,2,0.43660365575840954,"[0, 1, 0, 0, 1, 1, 1, 1, 0, 0]"
10484,1,1,2,0.3785103470136747,"[1, 1, 1, 0, 0, 0, 0, 0, 0, 1]"
10485,1,1,2,0.9378148348797758,"[1, 1, 1, 1, 1, 1, 1, 1, 0, 1]"
10486,1,1,2,0.9519319855594062,"[1, 1, 1, 0, 1, 1, 1, 1, 0, 0]"
10487,2,2,4,0.29754593141064056,"[1, 1, 1, 1, 1, 1, 0, 1, 0, 1]"
10488,1,1,2,0.040720578356875925,"[1, 0, 1, 1, 0, 0, 0, 1, 0, 1]"
10489,2,2,4,0.5524331679596102,"[0, 1, 1, 1, 0, 0, 1, 0, 0, 0]"
10490,2,2,4,0.6655525781254114,"[0, 1, 0, 0, 0, 1, 0, 0, 1, 1]"
10491,1,1,2,0.6294734338422538,"[0, 0, 1, 0, 1, 0, 0, 0, 0, 1]"
10492,1,1,2,0.6667029272117423,"[1, 1, 1, 1, 1, 1, 1, 1, 1, 1]"
10493,1,1,2,0.44426701795694834,"[0, 1, 1, 0, 0, 1, 1, 0, 0, 1]"
10494,1,1,2,0.20465387477225683,"[1, 1, 1, 1, 1, 1, 0, 1, 1, 1]"
10495,1,1,2,0.20376653861179073,"[0, 0, 1, 1, 1, 1, 1, 0, 1, 1]"
10496,1,1,2,0.20691321402217688,"[0, 1, 0, 0, 1, 0, 0, 1, 0, 1]"
10497,1,1,2,0.9858348862295805,"[0, 1, 0, 0, 1, 1, 1, 1, 0, 0]"
10498,1,1,2,0.9519535790931075,"[0, 1, 1, 0, 0, 1, 1, 1, 0, 1]"
10499,1,1,2,0.7695438616296655,"[0, 0, 0, 1, 0, 1, 1, 0, 0, 1]"
10500,6,6,12,0.5304649352468507,"[0, 0, 1, 1, 1, 1, 1, 1, 1, 1]"
10501,3,3,6,0.7178268391483812,"[0, 0, 1, 1, 1, 1, 0, 1, 1, 0]"
10502,2,2,4,0.233572365222387,"[1, 1, 0, 0, 0, 1, 0, 0, 1, 0]"
10503,3,3,6,0.766059559785007,"[1, 1, 1, 1, 1, 0, 0, 0, 1, 1]"
10504,1,1,2,0.2506129561583592,"[0, 1, 0, 1, 0, 0, 0, 0, 0, 0]"
10505,1,1,2,0.9421031443314188,"[0, 1, 0, 0, 0, 0, 0, 0, 1, 1]"
10506,2,2,4,0.05780546050846014,"[0, 0, 1, 0, 0, 1, 1, 0, 0, 1]"
10507,2,2,4,0.7627131079447342,"[0, 0, 0, 0, 1, 1, 0, 0, 1, 0]"
10508,1,1,2,0.6451310358826945,"[1, 1, 1, 0, 0, 0, 0, 0, 1, 0]"
10509,1,1,2,0.9026328048744148,"[0, 0, 1, 0, 1, 1, 0, 1, 1, 1]"
10510,2,2,4,0.8364524380260677,"[1, 0, 0, 0, 1, 0, 1, 1, 1, 0]"
10511,1,1,2,0.20462648469178557,"[0, 1, 1, 1, 0, 0, 0, 1, 1, 0]"
10512,1,1,2,0.6588163277238966,"[0, 1, 0, 1, 1, 0, 1, 0, 0, 0]"
10513,1,1,2,0.7318733766611213,"[1, 1, 0, 0, 0, 1, 0, 0, 0, 0]"
10514,1,1,2,0.6394163831353978,"[0, 0, 0, 1, 1, 0, 0, 0, 1, 1]"
10515,2,2,4,0.40166934641937035,"[0, 0, 1, 1, 1, 1, 0, 0, 0, 0]"
10516,1,1,2,0.29011271138231864,"[0, 0, 0, 0, 1, 0, 1, 0, 1, 1]"
10517,1,1,2,0.5938665308200165,"[1, 0, 1, 0, 0, 0, 1, 1, 1, 1]"
10518,2,2,4,0.03835910068067483,"[0, 1, 1, 0, 0, 1, 0, 0, 0, 0]"
10519,1,1,2,0.7603218108434484,"[0, 1, 1, 1, 0, 1, 1, 1, 1, 1]"
10520,1,1,2,0.19433468269460852,"[0, 1, 1, 1, 0, 1, 1, 0, 0, 0]"
10521,3,3,6,0.9999702381172695,"[1, 1, 1, 0, 0, 0, 1, 1, 1, 0]"
10522,1,1,2,0.9839611251084557,"[1, 0, 0, 0, 1, 1, 0, 1, 1, 1]"
10523,2,2,4,0.6276296770223339,"[0, 1, 0, 1, 0, 1, 1, 0, 0, 0]"
10524,1,1,2,0.6912726874221252,"[1, 1, 1, 0, 1, 0, 0, 0, 1, 0]"
10525,1,1,2,0.11049011153844601,"[0, 1, 1, 1, 0, 1, 0, 1, 0, 1]"
10526,1,1,2,0.4837540443463234,"[1, 0, 1, 1, 1, 0, 0, 0, 1, 0]"
10527,1,1,2,0.35833314983196485,"[0, 0, 0, 0, 1, 1, 1, 0, 1, 1]"
10528,3,3,6,0.8654947472893714,"[1, 1, 1, 1, 1, 1, 1, 0, 1, 0]"
10529,1,1,2,0.9212712805876824,"[0, 1, 0, 0, 0, 0, 1, 1, 1, 0]"
10530,2,2,4,0.5529793810309678,"[1, 1, 0, 0, 0, 1, 0, 1, 1, 0]"
10531,1,1,2,0.9901121137064084,"[0, 0, 0, 1, 0, 1, 1, 1, 0, 1]"
10532,1,1,2,0.004761551372331807,"[1, 1, 0, 0, 0, 1, 0, 0, 0, 1]"
10533,1,1,2,0.09365464129109846,"[0, 0, 0, 1, 0, 1, 0, 1, 1, 1]"
10534,1,1,2,0.978269383445289,"[0, 1, 0, 0, 1, 0, 1, 1, 0, 0]"
10535,1,1,2,0.5630129426981786,"[1, 0, 0, 0, 0, 0, 1, 0, 1, 1]"
10536,1,1,2,0.9532210532615797,"[1, 0, 1, 0, 0, 1, 1, 1, 1, 0]"
10537,3,3,6,0.4896998614672843,"[0, 1, 1, 0, 0, 1, 0, 1, 0, 1]"
10538,2,2,4,0.7194756468743669,"[0, 0, 1, 0, 0, 1, 1, 1, 0, 0]"
10539,1,1,2,0.8040347270398533,"[0, 0, 0, 1, 0, 0, 0, 1, 1, 0]"
10540,1,1,2,0.5470104735674407,"[0, 0, 0, 0, 0, 1, 1, 0, 1, 1]"
10541,1,1,2,0.9561745553972696,"[0, 0, 0, 0, 0, 0, 0, 0, 0, 0]"
10542,1,1,2,0.12434670241452772,"[0, 0, 0, 1, 1, 1, 0, 0, 0, 0]"
10543,2,2,4,0.5379112519697034,"[0, 1, 0, 1, 0, 0, 1, 1, 1, 0]"
10544,1,1,2,0.5924482661299382,"[1, 1, 1, 1, 1, 1, 1, 0, 0, 0]"
10545,1,1,2,0.16407964745486792,"[1, 0, 0, 1, 0, 1, 1, 0, 0, 0]"
10546,1,1,2,0.8376839900276714,"[1, 1, 0, 0, 1, 1, 0, 1, 1, 0]"
10547,1,1,2,0.1510583427700778,"[1, 1, 0, 1, 1, 0, 1, 1, 1, 1]"
10548,1,1,2,0.2755120689877648,"[1, 1, 1, 1, 1, 1, 1, 0, 1, 0]"
10549,1,1,2,0.5070544791894127,"[0, 1, 1, 1, 1, 1, 0, 0, 0, 0]"
10550,1,1,2,0.4432954232323125,"[1, 0, 0, 0, 1, 0, 1, 0, 0, 0]"
10551,1,1,2,0.31088834106687446,"[1, 0, 0, 1, 1, 0, 0, 1, 0, 0]"
10552,1,1,2,0.42226160831436954,"[0, 1, 0, 0, 1, 0, 0, 0, 0, 1]"
10553,1,1,2,0.4688228436564714,"[1, 1, 1, 0, 0, 0, 0, 0, 0, 1]"
10554,1,1,2,0.4476022986580881,"[0, 0, 1, 1, 1, 1, 0, 1, 0, 1]"
10555,1,1,2,0.3193406863941045,"[1, 0, 1, 1, 1, 0, 0, 0, 1, 0]"
10556,1,1,2,0.5834559454149505,"[0, 0, 0, 0, 0, 1, 1, 0, 1, 1]"
10557,1,1,2,0.5587516349393288,"[1, 1, 0, 1, 0, 0, 0, 1, 0, 0]"
10558,2,2,4,0.24220949097743416,"[1, 1, 1, 1, 0, 0, 0, 0, 1, 0]"
10559,2,2,4,0.2201873614356179,"[0, 0, 0, 1, 1, 0, 0, 0, 0, 0]"
10560,1,1,2,0.06251852196850671,"[0, 0, 0, 0, 0, 1, 0, 0, 1, 0]"
10561,2,2,4,0.38553629580853066,"[1, 0, 0, 0, 1, 1, 1, 0, 1, 0]"
10562,1,1,2,0.7293728595732958,"[1, 1, 0, 0, 0, 0, 1, 0, 0, 1]"
10563,1,1,2,0.5794825621672575,"[1, 1, 1, 1, 0, 0, 1, 0, 0, 0]"
10564,3,3,6,0.6077900761334966,"[1, 1, 1, 1, 1, 1, 1, 1, 1, 0]"
10565,2,2,4,0.8564657596792125,"[1, 1, 1, 0, 0, 0, 1, 0, 1, 1]"
10566,1,1,2,0.35540721863511904,"[1, 0, 1, 1, 0, 1, 0, 1, 1, 0]"
10567,1,1,2,0.6844369280507979,"[0, 0, 0, 0, 0, 0, 1, 1, 0, 0]"
10568,1,1,2,0.25331234014388904,"[1, 1, 1, 1, 1, 0, 0, 1, 1, 1]"
10569,1,1,2,0.21297688019140237,"[0, 1, 1, 1, 0, 0, 0, 1, 0, 0]"
10570,1,1,2,0.6753260352987978,"[1, 1, 0, 1, 1, 0, 0, 1, 1, 1]"
10571,2,2,4,0.4000153090110308,"[1, 1, 0, 1, 1, 0, 1, 0, 1, 1]"
10572,1,1,2,0.06531760415925203,"[1, 0, 1, 0, 1, 1, 1, 1, 1, 0]"
10573,2,2,4,0.7213367346999119,"[0, 0, 1, 0, 0, 0, 1, 1, 1, 0]"
10574,1,1,2,0.5786268986242199,"[0, 1, 1, 0, 1, 0, 1, 1, 1, 1]"
10575,1,1,2,0.29164464462537765,"[1, 0, 1, 0, 1, 1, 1, 0, 1, 1]"
10576,1,1,2,0.19902474960480654,"[0, 1, 0, 0, 1, 0, 0, 0, 0, 0]"
10577,1,1,2,0.36135190025272035,"[1, 0, 1, 0, 1, 0, 0, 0, 1, 0]"
10578,1,1,2,0.35137544099429263,"[0, 0, 0, 0, 1, 0, 0, 1, 0, 1]"
10579,4,4,8,0.4981811107494344,"[1, 1, 1, 1, 1, 1, 0, 1, 1, 0]"
10580,1,1,2,0.33540992745694764,"[0, 1, 1, 1, 0, 0, 1, 0, 1, 1]"
10581,5,5,10,0.8093981514587036,"[1, 0, 1, 1, 1, 1, 0, 0, 0, 1]"
10582,1,1,2,0.7118473879055841,"[1, 1, 1, 1, 1, 0, 1, 0, 1, 1]"
10583,1,1,2,0.1596886789367049,"[0, 0, 1, 1, 1, 1, 1, 1, 0, 1]"
10584,1,1,2,0.5327193723223091,"[0, 1, 0, 1, 0, 1, 0, 1, 0, 1]"
10585,3,3,6,0.5323866953230435,"[1, 1, 1, 1, 0, 1, 0, 1, 1, 1]"
10586,3,3,6,0.38641338817403426,"[0, 1, 0, 1, 1, 1, 1, 1, 1, 0]"
10587,2,2,4,0.053253445032743985,"[0, 1, 0, 0, 1, 0, 1, 0, 0, 0]"
10588,1,1,2,0.2375196748379247,"[1, 1, 1, 1, 0, 1, 0, 1, 0, 1]"
10589,1,1,2,0.11363298593370386,"[0, 0, 1, 0, 1, 1, 1, 0, 0, 1]"
10590,1,1,2,0.00793866305999169,"[0, 0, 0, 1, 1, 1, 0, 1, 1, 0]"
10591,1,1,2,0.1888051938741323,"[1, 0, 0, 1, 0, 0, 0, 0, 0, 0]"
10592,1,1,2,0.11719737270122599,"[1, 1, 0, 0, 1, 0, 1, 0, 1, 0]"
10593,2,2,4,0.08746812405018567,"[1, 0, 0, 1, 1, 1, 0, 1, 0, 1]"
10594,3,3,6,0.751960768484346,"[0, 0, 0, 0, 0, 0, 1, 1, 1, 0]"
10595,1,1,2,0.879980202348156,"[1, 1, 0, 0, 1, 1, 1, 1, 1, 1]"
10596,1,1,2,0.9097623517200412,"[0, 0, 1, 1, 1, 0, 1, 1, 0, 0]"
10597,1,1,2,0.6197464804003676,"[0, 1, 0, 0, 1, 0, 0, 0, 1, 1]"
10598,2,2,4,0.7851181505960737,"[0, 1, 1, 0, 0, 1, 1, 0, 1, 1]"
10599,2,2,4,0.9967685807107545,"[0, 1, 1, 1, 0, 1, 1, 1, 0, 1]"
10600,1,1,2,0.3450750103782626,"[0, 0, 1, 1, 1, 1, 1, 0, 1, 0]"
10601,1,1,2,0.31938393256990016,"[1, 1, 1, 1, 1, 0, 0, 0, 0, 1]"
10602,1,1,2,0.3022539232732637,"[1, 0, 1, 0, 1, 1, 0, 0, 0, 0]"
10603,1,1,2,0.6309532293868686,"[0, 1, 0, 1, 0, 1, 0, 1, 0, 1]"
10604,1,1,2,0.21623520876639124,"[0, 1, 1, 0, 0, 0, 0, 0, 0, 0]"
10605,2,2,4,0.8357726681977098,"[0, 0, 0, 1, 0, 1, 1, 1, 0, 1]"
10606,1,1,2,0.9258602747485843,"[0, 0, 1, 1, 1, 1, 1, 0, 0, 0]"
10607,1,1,2,0.5151453665244092,"[1, 0, 0, 0, 1, 0, 1, 0, 1, 1]"
10608,2,2,4,0.08160059788887619,"[1, 0, 1, 1, 1, 1, 1, 1, 1, 0]"
10609,1,1,2,0.8533216394826729,"[1, 1, 1, 1, 0, 0, 0, 1, 1, 0]"
10610,1,1,2,0.5272784155460494,"[1, 0, 0, 0, 0, 1, 0, 1, 0, 0]"
10611,2,2,4,0.8432336864460503,"[1, 1, 0, 0, 0, 1, 0, 0, 1, 1]"
10612,1,1,2,0.7394446995017709,"[1, 0, 0, 1, 1, 0, 0, 0, 0, 1]"
10613,1,1,2,0.43633271672928997,"[0, 0, 0, 0, 0, 0, 1, 1, 0, 0]"
10614,1,1,2,0.9594707235630634,"[0, 1, 0, 0, 1, 1, 0, 0, 1, 0]"
10615,2,2,4,0.9649417633891744,"[1, 0, 1, 1, 1, 1, 0, 0, 0, 1]"
10616,4,4,8,0.8063578435839458,"[1, 0, 1, 0, 1, 1, 1, 0, 0, 1]"
10617,1,1,2,0.038316867156242274,"[0, 1, 1, 0, 0, 1, 0, 0, 0, 1]"
10618,1,1,2,0.04028035551098652,"[1, 1, 1, 0, 0, 1, 0, 1, 0, 0]"
10619,1,1,2,0.8525611850627861,"[1, 1, 1, 1, 0, 0, 0, 1, 1, 1]"
10620,1,1,2,0.7952853521680727,"[0, 1, 0, 0, 1, 1, 0, 1, 0, 1]"
10621,1,1,2,0.5763197994471523,"[0, 0, 0, 1, 0, 0, 1, 0, 1, 1]"
10622,1,1,2,0.3253447366705695,"[1, 1, 0, 1, 0, 1, 1, 1, 0, 1]"
10623,1,1,2,0.7157842679576722,"[0, 0, 0, 1, 1, 1, 0, 1, 1, 0]"
10624,1,1,2,0.583335099942105,"[0, 0, 1, 0, 0, 1, 0, 1, 1, 0]"
10625,1,1,2,0.5081606158700731,"[1, 0, 0, 1, 1, 1, 0, 1, 0, 0]"
10626,1,1,2,0.8435978269184478,"[0, 0, 1, 1, 0, 0, 0, 1, 0, 1]"
10627,1,1,2,0.6864362326384789,"[1, 0, 0, 1, 0, 0, 1, 0, 1, 0]"
10628,2,2,4,0.7350861344971442,"[0, 1, 1, 0, 1, 0, 0, 0, 1, 1]"
10629,1,1,2,0.7387339865827158,"[1, 0, 0, 1, 0, 1, 1, 1, 0, 1]"
10630,2,2,4,0.6286042876084156,"[1, 0, 1, 1, 0, 1, 0, 0, 1, 0]"
10631,2,2,4,0.7687780522567773,"[1, 1, 0, 1, 1, 1, 1, 0, 0, 1]"
10632,1,1,2,0.9983293222444631,"[1, 1, 1, 0, 1, 0, 0, 1, 0, 1]"
10633,1,1,2,0.05421382963879662,"[0, 0, 0, 0, 1, 0, 0, 1, 1, 0]"
10634,1,1,2,0.49746600577739497,"[1, 0, 0, 1, 1, 1, 1, 0, 0, 0]"
10635,1,1,2,0.7542457385634085,"[1, 1, 1, 0, 0, 0, 0, 1, 1, 1]"
10636,1,1,2,0.41295626963289156,"[1, 1, 0, 0, 0, 1, 1, 1, 0, 1]"
10637,1,1,2,0.8199606243732368,"[0, 1, 1, 0, 1, 1, 0, 0, 1, 0]"
10638,1,1,2,0.8462019316984806,"[1, 0, 1, 0, 0, 0, 1, 1, 0, 0]"
10639,1,1,2,0.6076362697825842,"[0, 0, 1, 0, 0, 0, 0, 0, 0, 0]"
10640,1,1,2,0.45273512223173085,"[0, 0, 1, 0, 1, 1, 1, 1, 0, 0]"
10641,1,1,2,0.1750549139778812,"[0, 0, 0, 1, 0, 0, 1, 1, 1, 0]"
10642,1,1,2,0.25708567535415516,"[1, 0, 0, 0, 1, 0, 1, 1, 1, 0]"
10643,1,1,2,0.027911666332612328,"[0, 0, 1, 1, 0, 0, 1, 1, 0, 1]"
10644,1,1,2,0.18230314600366193,"[0, 0, 0, 1, 0, 0, 1, 0, 1, 1]"
10645,1,1,2,0.7562213189714119,"[0, 0, 0, 0, 0, 0, 0, 1, 0, 0]"
10646,1,1,2,0.9179172034782209,"[1, 0, 1, 0, 0, 0, 0, 0, 1, 0]"
10647,1,1,2,0.1902828608424466,"[1, 0, 1, 1, 1, 1, 1, 0, 0, 1]"
10648,2,2,4,0.3756413203111667,"[0, 0, 0, 0, 0, 0, 1, 0, 1, 0]"
10649,1,1,2,0.8557586140206982,"[1, 0, 0, 0, 0, 0, 0, 1, 0, 0]"
10650,4,4,8,0.9615019628003676,"[0, 0, 0, 0, 1, 1, 0, 1, 1, 1]"
10651,1,1,2,0.2165281014928494,"[1, 1, 0, 0, 1, 0, 0, 1, 1, 0]"
10652,1,1,2,0.6062323510736595,"[0, 1, 0, 1, 1, 0, 0, 1, 0, 1]"
10653,1,1,2,0.1329655199385935,"[1, 1, 1, 0, 1, 0, 0, 1, 1, 1]"
10654,1,1,2,0.46481260008265834,"[1, 1, 0, 0, 1, 0, 1, 1, 0, 0]"
10655,1,1,2,0.6442335600374439,"[1, 1, 1, 1, 1, 1, 1, 0, 0, 0]"
10656,3,3,6,0.5497083591379434,"[0, 1, 1, 0, 1, 1, 1, 1, 0, 1]"
10657,2,2,4,0.5258394812394147,"[1, 0, 1, 0, 0, 1, 0, 1, 1, 1]"
10658,1,1,2,0.09587023892790514,"[0, 0, 1, 0, 1, 0, 0, 0, 1, 1]"
10659,1,1,2,0.5653481543737239,"[0, 1, 0, 1, 0, 1, 0, 1, 1, 0]"
10660,2,2,4,0.6365224431929263,"[0, 0, 1, 0, 1, 1, 1, 0, 1, 0]"
10661,2,2,4,0.6677406382458094,"[1, 0, 0, 0, 1, 0, 0, 1, 0, 0]"
10662,1,1,2,0.5988327030889451,"[0, 0, 0, 1, 1, 0, 1, 0, 1, 1]"
10663,1,1,2,0.21649154148980765,"[1, 0, 0, 0, 0, 0, 1, 0, 0, 0]"
10664,1,1,2,0.8992302820556755,"[0, 1, 0, 1, 1, 1, 0, 0, 1, 0]"
10665,2,2,4,0.20942525144112623,"[0, 1, 0, 0, 1, 1, 1, 0, 0, 0]"
10666,1,1,2,0.6717205266751761,"[1, 0, 1, 1, 1, 1, 1, 1, 1, 1]"
10667,1,1,2,0.5522901060824077,"[1, 0, 0, 0, 1, 0, 1, 0, 1, 1]"
10668,2,2,4,0.18173826151027894,"[1, 1, 1, 0, 0, 1, 0, 1, 0, 0]"
10669,1,1,2,0.055132978762632345,"[0, 0, 0, 0, 1, 0, 0, 1, 0, 1]"
10670,1,1,2,0.8158444089414383,"[1, 1, 0, 1, 1, 0, 0, 0, 0, 1]"
10671,1,1,2,0.712904437574306,"[1, 0, 1, 1, 0, 0, 0, 0, 1, 0]"
10672,3,3,6,0.9040050135794252,"[1, 1, 1, 1, 0, 1, 0, 0, 0, 1]"
10673,2,2,4,0.3700697936061368,"[0, 0, 1, 0, 1, 1, 1, 1, 1, 0]"
10674,2,2,4,0.8562901285622115,"[1, 0, 0, 0, 0, 0, 0, 1, 1, 1]"
10675,1,1,2,0.4846760192062747,"[0, 1, 1, 1, 1, 0, 1, 0, 1, 1]"
10676,1,1,2,0.6965195083887757,"[1, 0, 1, 0, 1, 0, 0, 0, 0, 1]"
10677,1,1,2,0.868259023746144,"[1, 1, 1, 0, 1, 1, 0, 1, 0, 1]"
10678,1,1,2,0.3763036662042989,"[0, 1, 1, 1, 1, 1, 0, 0, 1, 0]"
10679,2,2,4,0.05224214161022922,"[1, 0, 0, 1, 0, 1, 0, 1, 1, 1]"
10680,1,1,2,0.7662793764420687,"[0, 1, 0, 0, 0, 1, 0, 1, 1, 1]"
10681,1,1,2,0.9550239377087877,"[1, 1, 1, 0, 1, 1, 0, 1, 1, 0]"
10682,1,1,2,0.10425673009656655,"[1, 1, 0, 1, 0, 0, 1, 0, 0, 1]"
10683,1,1,2,0.7094657598289192,"[1, 0, 0, 1, 0, 0, 0, 0, 0, 0]"
10684,2,2,4,0.49804573032882005,"[0, 1, 0, 0, 1, 0, 1, 1, 0, 0]"
10685,1,1,2,0.5771387187115503,"[0, 1, 0, 1, 1, 1, 1, 0, 1, 0]"
10686,1,1,2,0.8541622868536215,"[0, 0, 1, 0, 1, 0, 1, 1, 1, 1]"
10687,2,2,4,0.001385475689589688,"[0, 1, 1, 1, 1, 0, 1, 1, 0, 0]"
10688,1,1,2,0.023441493541296654,"[0, 0, 0, 1, 1, 1, 1, 0, 0, 0]"
10689,1,1,2,0.9888590320153546,"[0, 0, 0, 1, 0, 1, 0, 0, 0, 1]"
10690,3,3,6,0.7031629362120181,"[1, 1, 0, 1, 0, 0, 1, 1, 1, 0]"
10691,1,1,2,0.033121564868675124,"[0, 0, 1, 1, 0, 1, 0, 0, 0, 0]"
10692,2,2,4,0.454983586860395,"[0, 0, 0, 0, 1, 1, 0, 0, 0, 1]"
10693,1,1,2,0.5817700130797743,"[1, 1, 0, 1, 1, 1, 1, 1, 0, 0]"
10694,2,2,4,0.6310360803079255,"[1, 1, 1, 1, 0, 0, 0, 1, 0, 1]"
10695,2,2,4,0.812667453071012,"[0, 1, 0, 0, 1, 1, 0, 1, 0, 1]"
10696,2,2,4,0.3582253898325575,"[0, 0, 1, 0, 0, 1, 1, 0, 0, 1]"
10697,1,1,2,0.965185071105445,"[0, 1, 0, 0, 1, 0, 1, 1, 0, 1]"
10698,1,1,2,0.5876632390311479,"[1, 0, 0, 1, 0, 0, 0, 1, 0, 0]"
10699,1,1,2,0.14729511072784407,"[0, 0, 0, 0, 0, 0, 1, 0, 0, 1]"
10700,1,1,2,0.11654468073610647,"[0, 0, 1, 0, 0, 0, 0, 0, 1, 1]"
10701,1,1,2,0.5711787174095876,"[0, 0, 0, 0, 1, 1, 1, 0, 1, 0]"
10702,1,1,2,0.09771645778516902,"[0, 1, 0, 1, 0, 1, 0, 1, 0, 0]"
10703,1,1,2,0.5479490445864976,"[1, 1, 1, 1, 0, 1, 1, 1, 1, 0]"
10704,1,1,2,0.927947791846744,"[0, 1, 0, 1, 0, 1, 0, 0, 0, 1]"
10705,1,1,2,0.5685942556756466,"[1, 0, 0, 0, 0, 0, 1, 0, 0, 0]"
10706,1,1,2,0.27125979042801907,"[0, 1, 0, 1, 0, 1, 0, 0, 1, 0]"
10707,1,1,2,0.7418927615386949,"[1, 1, 1, 0, 1, 0, 0, 0, 1, 1]"
10708,1,1,2,0.3392944225557565,"[0, 0, 0, 0, 0, 1, 1, 0, 0, 0]"
10709,1,1,2,0.608511870736512,"[0, 0, 1, 1, 0, 1, 1, 0, 0, 1]"
10710,2,2,4,0.8496161061967671,"[0, 1, 1, 0, 1, 1, 1, 1, 1, 1]"
10711,2,2,4,0.5295875668382094,"[1, 0, 0, 1, 0, 0, 0, 1, 0, 0]"
10712,1,1,2,0.6703910821356636,"[1, 1, 1, 0, 1, 0, 0, 0, 1, 1]"
10713,1,1,2,0.8576397959311248,"[0, 1, 0, 1, 1, 0, 0, 1, 0, 1]"
10714,4,4,8,0.21439306243093847,"[1, 1, 1, 1, 1, 1, 1, 0, 1, 0]"
10715,1,1,2,0.6389109707522082,"[0, 0, 0, 1, 0, 0, 1, 0, 1, 0]"
10716,2,2,4,0.0980084715654036,"[0, 0, 1, 1, 0, 0, 0, 0, 1, 0]"
10717,1,1,2,0.40531847177114155,"[0, 0, 1, 0, 1, 0, 1, 1, 1, 0]"
10718,1,1,2,0.9036244222484995,"[1, 1, 0, 1, 1, 0, 1, 1, 1, 1]"
10719,1,1,2,0.17137997953408046,"[0, 0, 1, 1, 1, 0, 0, 0, 1, 1]"
10720,1,1,2,0.43571865388031095,"[0, 0, 0, 1, 1, 0, 0, 0, 0, 0]"
10721,1,1,2,0.6920956505922911,"[0, 0, 1, 0, 1, 1, 0, 0, 1, 0]"
10722,1,1,2,0.12552072340075604,"[0, 0, 1, 1, 0, 1, 0, 1, 1, 0]"
10723,1,1,2,0.3811210113859623,"[1, 0, 1, 0, 0, 1, 1, 0, 1, 1]"
10724,1,1,2,0.0908129249401195,"[0, 1, 0, 0, 0, 1, 1, 0, 0, 1]"
10725,1,1,2,0.27412325360434864,"[0, 0, 1, 1, 1, 1, 1, 0, 0, 1]"
10726,1,1,2,0.26042463767178103,"[1, 0, 1, 0, 0, 0, 1, 0, 1, 1]"
10727,1,1,2,0.050259561524446106,"[0, 0, 0, 0, 0, 1, 0, 1, 1, 1]"
10728,1,1,2,0.029046419367345644,"[1, 0, 1, 1, 1, 1, 0, 1, 0, 1]"
10729,1,1,2,0.11766455020442734,"[1, 1, 0, 0, 1, 0, 0, 0, 0, 1]"
10730,1,1,2,0.006088940529571207,"[0, 1, 1, 0, 0, 0, 1, 1, 0, 0]"
10731,1,1,2,0.14006761784511912,"[0, 1, 0, 1, 1, 0, 0, 1, 0, 0]"
10732,2,2,4,0.884715066904815,"[0, 0, 1, 1, 1, 0, 1, 0, 1, 1]"
10733,1,1,2,0.2680677255139823,"[0, 1, 0, 1, 0, 1, 0, 1, 1, 0]"
10734,1,1,2,0.31891865506915884,"[0, 1, 0, 0, 0, 0, 1, 1, 0, 0]"
10735,1,1,2,0.68589500238242,"[1, 0, 1, 1, 0, 1, 0, 1, 0, 1]"
10736,2,2,4,0.4862419487083285,"[0, 1, 1, 1, 1, 0, 1, 1, 0, 1]"
10737,1,1,2,0.3629842513956725,"[0, 0, 0, 1, 1, 0, 0, 0, 0, 0]"
10738,2,2,4,0.7453194504494732,"[1, 0, 1, 1, 1, 0, 0, 0, 1, 1]"
10739,1,1,2,0.5133886150006379,"[1, 0, 1, 1, 1, 0, 0, 1, 1, 0]"
10740,2,2,4,0.9281562148559075,"[1, 0, 0, 0, 1, 1, 0, 0, 1, 0]"
10741,1,1,2,0.2525522528606069,"[0, 1, 0, 1, 1, 1, 1, 1, 0, 0]"
10742,1,1,2,0.029263539178389975,"[0, 0, 0, 0, 0, 1, 1, 0, 1, 0]"
10743,1,1,2,0.2516205914574162,"[1, 1, 0, 1, 1, 0, 0, 1, 1, 0]"
10744,2,2,4,0.9192915156569722,"[0, 1, 0, 0, 1, 1, 1, 1, 0, 0]"
10745,1,1,2,0.6826763683122731,"[1, 0, 0, 1, 0, 0, 0, 0, 0, 1]"
10746,1,1,2,0.47585229970650056,"[0, 1, 0, 0, 0, 1, 0, 1, 1, 0]"
10747,1,1,2,0.5053577434251644,"[0, 1, 0, 1, 0, 0, 1, 0, 0, 0]"
10748,5,5,10,0.16977295541203785,"[0, 1, 0, 1, 1, 1, 0, 1, 1, 1]"
10749,1,1,2,0.9298061411190061,"[1, 0, 1, 0, 1, 1, 1, 0, 0, 0]"
10750,1,1,2,0.5294018952804049,"[0, 1, 0, 0, 1, 1, 0, 1, 1, 1]"
10751,2,2,4,0.7635889532177476,"[0, 0, 1, 1, 0, 0, 1, 1, 0, 1]"
10752,1,1,2,0.9342380169120179,"[0, 0, 1, 1, 1, 1, 1, 0, 0, 0]"
10753,1,1,2,0.06352039253830111,"[1, 1, 0, 1, 1, 0, 0, 0, 1, 0]"
10754,1,1,2,0.6513551296749225,"[0, 0, 0, 0, 0, 1, 1, 0, 1, 1]"
10755,1,1,2,0.956284222433535,"[1, 0, 0, 0, 0, 0, 1, 1, 0, 0]"
10756,1,1,2,0.8225701073120781,"[0, 1, 0, 1, 1, 0, 0, 1, 0, 1]"
10757,1,1,2,0.1144353519197373,"[0, 0, 1, 0, 0, 1, 1, 0, 0, 0]"
10758,1,1,2,0.12813245515905425,"[0, 1, 0, 0, 1, 0, 1, 0, 1, 0]"
10759,3,3,6,0.6516806254258228,"[0, 1, 1, 1, 1, 0, 1, 0, 1, 1]"
10760,1,1,2,0.8330849234466069,"[0, 0, 1, 1, 0, 0, 1, 1, 0, 0]"
10761,1,1,2,0.46212105587985897,"[0, 1, 0, 1, 1, 1, 1, 1, 1, 0]"
10762,1,1,2,0.2317109321008396,"[0, 1, 1, 1, 0, 1, 1, 0, 0, 1]"
10763,1,1,2,0.1838195872741587,"[1, 0, 0, 1, 0, 1, 1, 1, 0, 0]"
10764,1,1,2,0.6129283431336046,"[0, 0, 0, 1, 1, 1, 1, 1, 1, 0]"
10765,2,2,4,0.14691380356011496,"[1, 1, 0, 1, 1, 1, 1, 1, 1, 1]"
10766,1,1,2,0.33967565938636435,"[1, 1, 0, 1, 0, 1, 0, 1, 0, 0]"
10767,1,1,2,0.6275011910904945,"[1, 1, 1, 1, 1, 1, 1, 0, 1, 0]"
10768,1,1,2,0.03908903532409824,"[0, 1, 0, 0, 1, 0, 0, 0, 0, 1]"
10769,1,1,2,0.9015989210624036,"[0, 0, 0, 0, 1, 1, 0, 0, 0, 1]"
10770,1,1,2,0.7518532000603597,"[1, 1, 1, 0, 0, 1, 1, 1, 1, 0]"
10771,1,1,2,0.5218957776167102,"[1, 1, 1, 1, 1, 0, 0, 0, 0, 1]"
10772,1,1,2,0.6733975287265832,"[0, 1, 0, 1, 1, 0, 0, 0, 0, 0]"
10773,2,2,4,0.9555881486059794,"[1, 0, 0, 0, 0, 1, 0, 0, 0, 0]"
10774,1,1,2,0.5142910154119918,"[0, 0, 0, 0, 0, 1, 1, 0, 1, 1]"
10775,1,1,2,0.6251639055126473,"[1, 1, 1, 1, 1, 1, 0, 1, 1, 0]"
10776,1,1,2,0.5305771041527699,"[1, 1, 0, 1, 0, 1, 0, 1, 0, 0]"
10777,2,2,4,0.6147049768924168,"[0, 1, 0, 0, 0, 0, 1, 1, 1, 0]"
10778,1,1,2,0.5853180417397522,"[1, 0, 0, 0, 0, 1, 1, 0, 0, 0]"
10779,1,1,2,0.33368413076983905,"[1, 1, 0, 0, 0, 1, 0, 0, 1, 1]"
10780,3,3,6,0.8439587333856651,"[1, 0, 0, 1, 0, 0, 1, 1, 0, 0]"
10781,1,1,2,0.5303313478197654,"[0, 1, 0, 1, 0, 0, 1, 0, 0, 1]"
10782,1,1,2,0.872416597571509,"[0, 1, 0, 0, 1, 1, 0, 0, 0, 0]"
10783,1,1,2,0.11796629019821103,"[1, 1, 0, 1, 1, 0, 1, 1, 1, 0]"
10784,3,3,6,0.22763188811693758,"[1, 0, 1, 0, 1, 1, 0, 0, 1, 0]"
10785,3,3,6,0.3296171028351971,"[1, 1, 1, 1, 1, 1, 0, 0, 1, 1]"
10786,2,2,4,0.19508132814287604,"[0, 0, 0, 0, 1, 1, 0, 1, 0, 0]"
10787,1,1,2,0.7211628434145144,"[0, 0, 1, 1, 1, 0, 1, 0, 0, 0]"
10788,1,1,2,0.7054218193912593,"[0, 1, 0, 0, 1, 1, 0, 1, 1, 0]"
10789,2,2,4,0.5308728164501563,"[1, 1, 0, 0, 1, 1, 0, 1, 1, 1]"
10790,4,4,8,0.7846402914586625,"[0, 1, 1, 0, 0, 1, 1, 1, 1, 1]"
10791,1,1,2,0.014415174513205176,"[1, 1, 1, 1, 1, 0, 0, 1, 0, 1]"
10792,3,3,6,0.6549229481501317,"[1, 0, 1, 0, 0, 0, 1, 1, 1, 1]"
10793,1,1,2,0.778891908082584,"[1, 0, 1, 1, 0, 1, 0, 1, 0, 1]"
10794,1,1,2,0.019722020922892214,"[1, 0, 0, 0, 0, 0, 1, 1, 1, 1]"
10795,1,1,2,0.7098492352865777,"[0, 1, 1, 1, 0, 0, 0, 1, 1, 0]"
10796,1,1,2,0.7985252115709626,"[0, 0, 0, 0, 1, 1, 1, 0, 0, 0]"
10797,3,3,6,0.9485551201142218,"[1, 1, 1, 1, 0, 1, 0, 0, 1, 0]"
10798,1,1,2,0.5659688964724405,"[0, 0, 0, 0, 0, 1, 1, 0, 0, 1]"
10799,1,1,2,0.6959715699465417,"[1, 1, 1, 1, 1, 1, 1, 0, 0, 1]"
10800,1,1,2,0.4457303727843087,"[1, 1, 0, 0, 0, 1, 1, 1, 0, 1]"
10801,1,1,2,0.45136459209723334,"[1, 0, 0, 1, 1, 0, 0, 0, 1, 0]"
10802,1,1,2,0.19146137516492967,"[1, 0, 1, 1, 0, 0, 1, 1, 1, 1]"
10803,1,1,2,0.10519243793282185,"[0, 1, 0, 0, 0, 0, 1, 1, 1, 0]"
10804,1,1,2,0.1121839329433112,"[0, 0, 0, 0, 0, 0, 0, 1, 1, 0]"
10805,1,1,2,0.507399346695175,"[1, 1, 1, 0, 0, 0, 1, 1, 1, 0]"
10806,1,1,2,0.4331668896338253,"[1, 1, 1, 1, 0, 1, 0, 0, 1, 1]"
10807,1,1,2,0.28301152210973657,"[1, 1, 1, 1, 0, 0, 1, 0, 0, 1]"
10808,1,1,2,0.025016406025685,"[1, 0, 0, 1, 0, 1, 0, 0, 0, 0]"
10809,1,1,2,0.7076908815758677,"[1, 0, 0, 0, 1, 0, 0, 0, 0, 1]"
10810,1,1,2,0.34858064950910994,"[0, 1, 0, 0, 0, 1, 1, 1, 1, 0]"
10811,1,1,2,0.02218604749352382,"[0, 1, 0, 1, 0, 0, 1, 0, 0, 0]"
10812,1,1,2,0.2865084812575309,"[0, 0, 0, 1, 1, 1, 0, 0, 0, 0]"
10813,1,1,2,0.3500685588862381,"[1, 1, 0, 0, 1, 0, 0, 0, 1, 0]"
10814,1,1,2,0.5681096214122674,"[1, 0, 0, 1, 1, 1, 0, 1, 0, 1]"
10815,1,1,2,0.004017980292033374,"[1, 0, 1, 0, 1, 1, 1, 1, 0, 1]"
10816,1,1,2,0.32644029172588207,"[0, 0, 1, 0, 0, 1, 1, 1, 0, 1]"
10817,1,1,2,0.74582569950148,"[0, 1, 0, 1, 0, 0, 1, 1, 1, 1]"
10818,2,2,4,0.08173273822673399,"[1, 1, 1, 0, 1, 0, 0, 1, 0, 1]"
10819,1,1,2,0.9186349728254186,"[1, 0, 1, 1, 0, 1, 0, 1, 1, 1]"
10820,1,1,2,0.46571942958365264,"[1, 1, 0, 0, 0, 1, 0, 0, 1, 0]"
10821,1,1,2,0.2706175149946587,"[1, 1, 0, 0, 1, 0, 1, 1, 0, 0]"
10822,1,1,2,0.28597259151529564,"[0, 0, 1, 0, 1, 1, 1, 0, 1, 1]"
10823,1,1,2,0.01622601142451785,"[0, 1, 0, 1, 0, 1, 1, 0, 0, 1]"
10824,1,1,2,0.5994448724064004,"[0, 1, 0, 1, 1, 1, 0, 0, 1, 1]"
10825,1,1,2,0.43324646863714866,"[0, 1, 1, 1, 1, 0, 1, 0, 0, 1]"
10826,1,1,2,0.10420291403954185,"[0, 0, 0, 0, 0, 1, 0, 1, 0, 0]"
10827,1,1,2,0.792949966399102,"[1, 1, 0, 0, 1, 0, 1, 1, 1, 1]"
10828,1,1,2,0.1492120289758493,"[1, 0, 0, 0, 1, 0, 1, 1, 1, 1]"
10829,1,1,2,0.6069371683529315,"[0, 1, 1, 0, 0, 1, 0, 0, 1, 0]"
10830,1,1,2,0.43226638126509376,"[0, 0, 1, 0, 1, 1, 1, 0, 1, 1]"
10831,1,1,2,0.7241742594827016,"[1, 0, 1, 1, 0, 0, 1, 1, 1, 0]"
10832,1,1,2,0.832832291076636,"[0, 1, 0, 0, 1, 0, 0, 0, 1, 0]"
10833,1,1,2,0.07342558220472062,"[0, 1, 0, 1, 0, 0, 0, 0, 1, 0]"
10834,1,1,2,0.5004877482010505,"[1, 1, 1, 0, 1, 1, 0, 1, 0, 0]"
10835,2,2,4,0.4324415354482759,"[1, 0, 0, 1, 1, 1, 1, 0, 1, 1]"
10836,1,1,2,0.5859107766336865,"[1, 0, 1, 1, 1, 1, 0, 1, 0, 1]"
10837,1,1,2,0.607891279724738,"[1, 1, 0, 1, 0, 0, 0, 1, 1, 1]"
10838,1,1,2,0.6183002822035674,"[0, 1, 1, 0, 0, 0, 0, 1, 1, 0]"
10839,1,1,2,0.8077218992788998,"[1, 0, 1, 1, 1, 1, 0, 0, 0, 0]"
10840,1,1,2,0.2996670543781682,"[1, 0, 0, 1, 0, 0, 0, 1, 1, 0]"
10841,1,1,2,0.37942006301997255,"[0, 0, 0, 1, 1, 0, 0, 0, 0, 0]"
10842,1,1,2,0.3781577517728534,"[1, 0, 1, 0, 1, 1, 0, 1, 1, 0]"
10843,2,2,4,0.8152079304038663,"[1, 1, 1, 1, 0, 0, 1, 0, 1, 0]"
10844,1,1,2,0.19068834090260434,"[1, 1, 1, 1, 0, 0, 1, 1, 0, 1]"
10845,1,1,2,0.2553304520954093,"[0, 0, 0, 1, 1, 0, 0, 1, 1, 0]"
10846,2,2,4,0.904849732055631,"[0, 1, 0, 1, 1, 1, 1, 1, 0, 1]"
10847,2,2,4,0.034147351367639356,"[0, 1, 1, 0, 1, 1, 1, 1, 1, 0]"
10848,1,1,2,0.26479728436833583,"[0, 1, 0, 0, 1, 1, 0, 0, 0, 0]"
10849,1,1,2,0.7394972417576113,"[0, 1, 0, 1, 0, 0, 1, 0, 0, 1]"
10850,1,1,2,0.8731505936764162,"[1, 1, 0, 1, 1, 1, 1, 1, 1, 1]"
10851,1,1,2,0.6792059278921311,"[1, 1, 0, 1, 0, 1, 1, 1, 0, 0]"
10852,3,3,6,0.673852942943472,"[0, 1, 1, 1, 0, 1, 0, 1, 0, 0]"
10853,1,1,2,0.6994724272276627,"[0, 1, 0, 0, 1, 0, 0, 1, 1, 0]"
10854,1,1,2,0.08807697394011371,"[1, 1, 0, 0, 0, 1, 0, 1, 0, 0]"
10855,2,2,4,0.29832997110896153,"[0, 1, 0, 0, 1, 0, 1, 0, 1, 1]"
10856,1,1,2,0.820177707939753,"[1, 0, 0, 0, 1, 0, 0, 0, 1, 0]"
10857,1,1,2,0.09648412079313351,"[1, 0, 1, 1, 0, 0, 1, 1, 1, 0]"
10858,1,1,2,0.4242771089552104,"[0, 1, 1, 0, 0, 0, 1, 0, 0, 0]"
10859,1,1,2,0.09730226224084204,"[1, 0, 1, 1, 1, 0, 0, 1, 1, 0]"
10860,1,1,2,0.2371758541491279,"[1, 0, 1, 0, 1, 0, 1, 1, 1, 0]"
10861,2,2,4,0.6213425754257701,"[0, 0, 1, 1, 0, 0, 0, 0, 0, 0]"
10862,1,1,2,0.26483092787008755,"[1, 0, 1, 1, 1, 0, 0, 1, 1, 0]"
10863,1,1,2,0.42777259729340655,"[1, 1, 0, 0, 0, 0, 1, 1, 0, 1]"
10864,1,1,2,0.4401677861862354,"[0, 0, 1, 0, 1, 1, 1, 0, 1, 0]"
10865,1,1,2,0.3789165277229436,"[0, 1, 1, 0, 1, 1, 1, 1, 1, 0]"
10866,1,1,2,0.6476882792243548,"[1, 0, 1, 1, 0, 1, 0, 0, 1, 1]"
10867,1,1,2,0.5703679591822178,"[1, 1, 0, 1, 1, 1, 0, 0, 1, 0]"
10868,1,1,2,0.8043083596494746,"[1, 0, 1, 1, 0, 0, 1, 1, 0, 1]"
10869,1,1,2,0.862449455889975,"[1, 1, 1, 0, 1, 1, 0, 1, 0, 0]"
10870,1,1,2,0.01309766056814543,"[1, 1, 0, 1, 0, 0, 0, 0, 0, 0]"
10871,1,1,2,0.6528321325812939,"[0, 0, 1, 1, 0, 1, 0, 1, 0, 1]"
10872,1,1,2,0.0587836627821281,"[0, 1, 0, 0, 0, 1, 1, 1, 1, 1]"
10873,1,1,2,0.4096569212414831,"[0, 0, 1, 1, 0, 1, 1, 1, 0, 0]"
10874,1,1,2,0.8376951428514555,"[0, 1, 0, 1, 0, 0, 0, 1, 0, 0]"
10875,1,1,2,0.9969046009443727,"[0, 0, 0, 0, 1, 0, 0, 1, 1, 0]"
10876,1,1,2,0.14532958108127758,"[0, 1, 0, 0, 1, 0, 0, 1, 0, 1]"
10877,1,1,2,0.09211462659018377,"[0, 0, 1, 1, 1, 0, 0, 0, 1, 0]"
10878,2,2,4,0.1514453724089807,"[0, 1, 1, 1, 1, 1, 1, 1, 1, 1]"
10879,1,1,2,0.22859242917586708,"[0, 1, 1, 1, 1, 1, 1, 1, 0, 0]"
10880,1,1,2,0.9634489232705115,"[1, 0, 0, 1, 1, 0, 0, 1, 0, 0]"
10881,1,1,2,0.501403983427739,"[0, 1, 0, 1, 0, 1, 1, 1, 1, 0]"
10882,4,4,8,0.5843124942110178,"[1, 1, 1, 0, 1, 1, 1, 0, 0, 0]"
10883,1,1,2,0.3637349144749912,"[1, 0, 1, 1, 0, 0, 1, 0, 0, 1]"
10884,1,1,2,0.3480963738973195,"[0, 1, 1, 0, 0, 0, 1, 1, 0, 1]"
10885,1,1,2,0.20825197117358218,"[1, 0, 0, 0, 1, 0, 0, 1, 1, 1]"
10886,1,1,2,0.6289887341122208,"[0, 1, 0, 0, 0, 0, 0, 1, 1, 1]"
10887,1,1,2,0.08985953992970797,"[0, 1, 1, 0, 1, 1, 0, 0, 1, 0]"
10888,4,4,8,0.43914867968371796,"[1, 0, 1, 1, 1, 1, 0, 1, 0, 0]"
10889,2,2,4,0.31281623675102466,"[1, 1, 0, 0, 1, 0, 1, 1, 0, 0]"
10890,2,2,4,0.8109953460062954,"[1, 0, 0, 1, 1, 1, 1, 0, 1, 0]"
10891,2,2,4,0.4254709783972034,"[1, 0, 0, 0, 1, 0, 1, 0, 1, 0]"
10892,1,1,2,0.211790778121983,"[0, 0, 1, 0, 1, 0, 1, 1, 0, 0]"
10893,1,1,2,0.5738959364143479,"[1, 1, 0, 1, 1, 1, 0, 0, 0, 1]"
10894,1,1,2,0.5493009047839668,"[0, 0, 0, 1, 0, 0, 1, 0, 0, 1]"
10895,1,1,2,0.0012063808603972603,"[0, 0, 0, 0, 0, 1, 0, 1, 1, 0]"
10896,1,1,2,0.8261025433703963,"[1, 1, 1, 1, 0, 1, 1, 1, 0, 1]"
10897,1,1,2,0.23022385695516112,"[1, 1, 1, 0, 1, 0, 1, 0, 1, 0]"
10898,1,1,2,0.6173473683993939,"[1, 1, 1, 0, 1, 0, 0, 1, 0, 1]"
10899,3,3,6,0.3205367358891462,"[1, 0, 0, 0, 1, 0, 1, 1, 0, 1]"
10900,3,3,6,0.17330948273290814,"[0, 1, 0, 1, 1, 0, 1, 0, 1, 0]"
10901,1,1,2,0.33816487743615775,"[1, 0, 0, 1, 1, 1, 1, 1, 1, 1]"
10902,1,1,2,0.07058206077504703,"[1, 0, 1, 0, 0, 1, 1, 0, 0, 0]"
10903,1,1,2,0.5494950302295655,"[0, 0, 0, 0, 0, 0, 0, 1, 1, 0]"
10904,1,1,2,0.8358271229420215,"[1, 0, 1, 0, 1, 0, 0, 1, 0, 0]"
10905,1,1,2,0.02341549430049572,"[1, 1, 1, 1, 0, 0, 0, 1, 0, 1]"
10906,1,1,2,0.6003257256548754,"[1, 1, 0, 1, 0, 1, 1, 1, 1, 1]"
10907,1,1,2,0.17010208865604826,"[1, 1, 0, 1, 0, 1, 1, 0, 1, 0]"
10908,1,1,2,0.20510969387163613,"[1, 0, 1, 0, 1, 1, 1, 1, 0, 0]"
10909,3,3,6,0.7035151713834263,"[0, 1, 1, 1, 0, 1, 1, 0, 1, 1]"
10910,1,1,2,0.3536714078236525,"[1, 1, 1, 0, 1, 0, 0, 1, 0, 0]"
10911,1,1,2,0.4026405054442883,"[0, 1, 1, 0, 0, 0, 0, 1, 0, 1]"
10912,1,1,2,0.842897548716947,"[1, 1, 0, 1, 0, 1, 0, 0, 1, 0]"
10913,1,1,2,0.07441447713070226,"[1, 0, 1, 0, 0, 1, 1, 0, 0, 0]"
10914,1,1,2,0.21245518969145316,"[1, 1, 1, 0, 1, 1, 1, 0, 1, 1]"
10915,1,1,2,0.05665933130693168,"[0, 0, 0, 0, 1, 1, 0, 0, 0, 0]"
10916,1,1,2,0.10041719685744921,"[1, 1, 0, 1, 0, 1, 0, 1, 1, 0]"
10917,1,1,2,0.4319289361141394,"[0, 0, 1, 0, 0, 1, 1, 1, 1, 0]"
10918,1,1,2,0.17803172977695336,"[0, 0, 1, 1, 1, 0, 0, 0, 1, 0]"
10919,1,1,2,0.28885691391787927,"[1, 1, 0, 0, 0, 1, 0, 1, 0, 1]"
10920,1,1,2,0.03857019626724312,"[0, 0, 1, 0, 1, 1, 1, 0, 0, 0]"
10921,1,1,2,0.46092146234903353,"[0, 1, 0, 0, 1, 0, 1, 1, 1, 0]"
10922,2,2,4,0.3886173820946621,"[1, 0, 0, 1, 1, 0, 0, 1, 1, 0]"
10923,1,1,2,0.6413036262881106,"[0, 1, 1, 1, 0, 1, 0, 0, 0, 1]"
10924,2,2,4,0.22454347298940003,"[0, 0, 1, 0, 0, 0, 1, 1, 0, 1]"
10925,1,1,2,0.02182406223211586,"[0, 1, 0, 0, 1, 0, 1, 1, 1, 0]"
10926,1,1,2,0.9766837902299759,"[1, 0, 1, 1, 1, 1, 1, 1, 0, 0]"
10927,1,1,2,0.7115799553356206,"[0, 1, 0, 1, 1, 0, 0, 1, 0, 0]"
10928,2,2,4,0.6451424967199608,"[0, 1, 1, 1, 0, 0, 1, 1, 1, 0]"
10929,2,2,4,0.555689453803179,"[1, 1, 0, 0, 1, 1, 1, 0, 0, 0]"
10930,1,1,2,0.3457381055091707,"[0, 1, 0, 0, 0, 1, 0, 1, 1, 0]"
10931,1,1,2,0.6310115468808749,"[1, 1, 1, 0, 1, 0, 1, 1, 1, 1]"
10932,2,2,4,0.8686246971717788,"[1, 0, 0, 0, 1, 1, 0, 1, 1, 0]"
10933,1,1,2,0.8593242217612349,"[1, 1, 0, 0, 0, 0, 1, 0, 0, 0]"
10934,2,2,4,0.16355592360397342,"[1, 1, 1, 0, 0, 0, 0, 0, 1, 1]"
10935,1,1,2,0.0279338589658108,"[1, 0, 0, 1, 1, 0, 1, 0, 1, 0]"
10936,1,1,2,0.13363364537832767,"[1, 0, 0, 0, 0, 0, 1, 1, 0, 0]"
10937,1,1,2,0.4443637016173757,"[1, 1, 1, 1, 1, 0, 1, 0, 0, 1]"
10938,1,1,2,0.31957418840948015,"[0, 0, 0, 0, 1, 1, 1, 1, 0, 1]"
10939,1,1,2,0.37640515871278046,"[1, 0, 0, 1, 1, 0, 1, 0, 1, 0]"
10940,5,5,10,0.5058624591566058,"[1, 1, 1, 0, 0, 1, 1, 1, 0, 1]"
10941,1,1,2,0.024994670190689128,"[0, 0, 1, 0, 0, 1, 0, 1, 0, 1]"
10942,2,2,4,0.6874961085510332,"[0, 0, 1, 1, 1, 0, 0, 1, 1, 1]"
10943,4,4,8,0.08196745517452142,"[1, 0, 1, 1, 1, 0, 0, 0, 1, 1]"
10944,2,2,4,0.39110692006190706,"[1, 0, 0, 0, 0, 1, 1, 0, 0, 0]"
10945,2,2,4,0.23753516926607976,"[0, 1, 1, 1, 0, 1, 1, 0, 0, 0]"
10946,3,3,6,0.023154199069659653,"[1, 0, 0, 1, 0, 1, 1, 0, 0, 1]"
10947,1,1,2,0.010644335329737853,"[1, 1, 0, 0, 0, 0, 0, 0, 0, 1]"
10948,1,1,2,0.8056601479166818,"[0, 0, 1, 0, 0, 0, 0, 0, 1, 1]"
10949,2,2,4,0.7367086491303951,"[1, 1, 1, 1, 0, 1, 1, 0, 1, 1]"
10950,1,1,2,0.4666330490587184,"[0, 0, 0, 0, 1, 0, 1, 1, 1, 0]"
10951,1,1,2,0.6472019047322441,"[1, 0, 0, 0, 0, 1, 1, 1, 1, 0]"
10952,1,1,2,0.17084625623104954,"[1, 0, 0, 1, 1, 0, 0, 0, 1, 0]"
10953,1,1,2,0.8911614914235207,"[1, 0, 1, 1, 1, 1, 1, 0, 0, 1]"
10954,1,1,2,0.9740277227062953,"[0, 0, 1, 1, 1, 0, 0, 0, 0, 0]"
10955,1,1,2,0.8688859078737742,"[0, 1, 1, 1, 1, 1, 0, 0, 0, 0]"
10956,1,1,2,0.9494231551346913,"[0, 1, 1, 0, 1, 1, 1, 1, 0, 0]"
10957,1,1,2,0.6881895482808462,"[0, 0, 0, 0, 0, 0, 0, 0, 1, 1]"
10958,1,1,2,0.04444269723315142,"[1, 0, 1, 0, 1, 0, 0, 0, 1, 1]"
10959,1,1,2,0.5378728676232379,"[0, 1, 1, 1, 1, 0, 1, 0, 0, 1]"
10960,1,1,2,0.4404150983063462,"[0, 1, 1, 0, 0, 0, 0, 0, 1, 0]"
10961,3,3,6,0.22745092179563475,"[1, 0, 1, 1, 0, 0, 1, 0, 0, 1]"
10962,1,1,2,0.646833198742155,"[1, 0, 0, 1, 1, 0, 0, 1, 0, 0]"
10963,1,1,2,0.9052907908740017,"[0, 1, 1, 0, 0, 0, 0, 1, 0, 0]"
10964,1,1,2,0.8990864158694527,"[1, 0, 1, 1, 1, 0, 1, 0, 0, 1]"
10965,1,1,2,0.35330039238204713,"[0, 1, 0, 1, 0, 0, 0, 0, 1, 1]"
10966,1,1,2,0.5908082472082968,"[0, 1, 1, 0, 1, 0, 0, 0, 0, 0]"
10967,1,1,2,0.9897947855136406,"[1, 1, 1, 0, 1, 0, 0, 1, 0, 0]"
10968,1,1,2,0.18070850462186094,"[0, 0, 0, 1, 1, 0, 0, 1, 0, 0]"
10969,1,1,2,0.11643030451444603,"[0, 0, 1, 0, 1, 1, 0, 1, 0, 0]"
10970,1,1,2,0.560842944164532,"[0, 0, 1, 1, 1, 0, 1, 1, 1, 1]"
10971,1,1,2,0.47226172178258174,"[0, 1, 1, 0, 0, 0, 1, 1, 0, 0]"
10972,4,4,8,0.3625231831547838,"[1, 1, 1, 0, 0, 1, 1, 1, 0, 1]"
10973,1,1,2,0.3846464195550213,"[0, 1, 0, 0, 1, 1, 1, 1, 1, 1]"
10974,2,2,4,0.7710136650027565,"[1, 1, 1, 0, 1, 0, 1, 1, 0, 1]"
10975,1,1,2,0.1851905140311596,"[0, 1, 0, 0, 0, 0, 1, 1, 0, 1]"
10976,1,1,2,0.20628706655363294,"[1, 1, 0, 0, 1, 1, 1, 0, 0, 0]"
10977,1,1,2,0.70519419094496,"[0, 0, 0, 1, 1, 0, 0, 0, 0, 0]"
10978,1,1,2,0.5518464443226928,"[0, 0, 0, 1, 1, 0, 0, 0, 1, 1]"
10979,1,1,2,0.5684777254042075,"[0, 0, 0, 1, 1, 0, 0, 0, 0, 0]"
10980,1,1,2,0.04715053391860091,"[0, 0, 1, 1, 1, 1, 0, 1, 1, 0]"
10981,1,1,2,0.4696799420747544,"[0, 1, 1, 0, 0, 1, 0, 0, 0, 0]"
10982,1,1,2,0.358329844255564,"[1, 1, 1, 0, 0, 0, 0, 0, 1, 0]"
10983,1,1,2,0.18056931699415923,"[1, 1, 0, 0, 0, 0, 0, 1, 0, 1]"
10984,2,2,4,0.06836351106165461,"[0, 1, 0, 0, 0, 0, 1, 0, 0, 1]"
10985,1,1,2,0.8183148652425372,"[1, 0, 1, 1, 1, 0, 1, 1, 0, 1]"
10986,2,2,4,0.90435016622133,"[0, 1, 0, 0, 0, 1, 1, 0, 1, 0]"
10987,1,1,2,0.8951601473772091,"[1, 0, 1, 0, 1, 1, 0, 0, 1, 0]"
10988,2,2,4,0.691471549755974,"[0, 1, 0, 1, 1, 1, 0, 0, 1, 0]"
10989,1,1,2,0.7856223733177445,"[0, 1, 0, 0, 0, 1, 1, 0, 1, 1]"
10990,2,2,4,0.038454199395744015,"[1, 1, 1, 1, 0, 0, 1, 1, 1, 0]"
10991,1,1,2,0.38182137609094935,"[1, 1, 0, 1, 0, 0, 1, 0, 0, 0]"
10992,2,2,4,0.7484791463920378,"[0, 0, 0, 0, 0, 0, 0, 0, 1, 1]"
10993,1,1,2,0.5680173586271189,"[0, 1, 0, 1, 1, 0, 0, 0, 0, 0]"
10994,5,5,10,0.5827344707589875,"[1, 1, 0, 1, 1, 0, 1, 1, 1, 1]"
10995,1,1,2,0.7029100147011117,"[0, 0, 0, 0, 0, 0, 0, 1, 1, 0]"
10996,2,2,4,0.6710894142808539,"[1, 0, 1, 1, 0, 1, 0, 0, 1, 1]"
10997,1,1,2,0.7230838621788552,"[1, 0, 1, 0, 1, 1, 0, 1, 0, 1]"
10998,1,1,2,0.16873888801336723,"[0, 1, 1, 0, 0, 0, 0, 0, 1, 0]"
10999,1,1,2,0.3524090562790394,"[1, 1, 0, 0, 0, 0, 0, 1, 0, 1]"
11000,1,1,2,0.5911766766539295,"[0, 1, 0, 0, 1, 1, 1, 0, 0, 0]"
11001,1,1,2,0.7820438827602083,"[0, 1, 1, 1, 0, 0, 0, 0, 0, 0]"
11002,1,1,2,0.920086725345519,"[1, 0, 1, 0, 1, 0, 0, 0, 1, 0]"
11003,1,1,2,0.5601993025581226,"[0, 0, 1, 1, 0, 0, 0, 0, 1, 0]"
11004,1,1,2,0.17813399871619096,"[0, 1, 0, 0, 1, 0, 0, 0, 1, 0]"
11005,1,1,2,0.39222578974224964,"[0, 1, 0, 0, 0, 1, 0, 1, 0, 0]"
11006,1,1,2,0.6266640056587859,"[1, 1, 0, 0, 1, 1, 1, 0, 0, 0]"
11007,1,1,2,0.4267809362487178,"[1, 1, 1, 1, 1, 1, 1, 1, 1, 1]"
11008,1,1,2,0.9050752769061853,"[1, 0, 0, 1, 0, 0, 1, 0, 0, 0]"
11009,1,1,2,0.20908968763441693,"[1, 1, 0, 0, 1, 1, 0, 0, 1, 0]"
11010,1,1,2,0.44109145381227544,"[1, 1, 1, 1, 0, 0, 0, 0, 0, 1]"
11011,1,1,2,0.15547364757482995,"[1, 0, 0, 1, 0, 0, 0, 0, 0, 0]"
11012,1,1,2,0.7559885754934232,"[1, 1, 1, 0, 1, 1, 0, 1, 1, 1]"
11013,1,1,2,0.8297216909410257,"[0, 1, 0, 0, 1, 1, 1, 1, 0, 0]"
11014,1,1,2,0.8153744197882622,"[1, 0, 1, 0, 0, 0, 1, 0, 0, 0]"
11015,1,1,2,0.7601776252879396,"[1, 0, 0, 0, 1, 0, 0, 0, 1, 1]"
11016,2,2,4,0.1635250590131342,"[0, 0, 0, 1, 1, 1, 0, 1, 0, 1]"
11017,1,1,2,0.6887863973136185,"[1, 0, 1, 0, 0, 1, 1, 1, 1, 0]"
11018,1,1,2,0.09863321395609448,"[1, 0, 0, 1, 0, 0, 0, 1, 1, 0]"
11019,1,1,2,0.23923943974520567,"[0, 0, 1, 0, 0, 0, 1, 0, 0, 1]"
11020,1,1,2,0.19789604402455463,"[0, 1, 0, 1, 1, 0, 0, 1, 0, 1]"
11021,1,1,2,0.6929656001937062,"[1, 1, 0, 1, 1, 0, 0, 0, 0, 1]"
11022,2,2,4,0.7430699720702003,"[1, 1, 1, 1, 0, 1, 0, 0, 1, 0]"
11023,1,1,2,0.33826888432275104,"[0, 1, 1, 0, 0, 1, 1, 1, 0, 0]"
11024,1,1,2,0.8404770577979324,"[1, 1, 1, 1, 1, 1, 1, 0, 1, 0]"
11025,1,1,2,0.257258654636599,"[1, 0, 1, 1, 0, 1, 1, 1, 1, 0]"
11026,1,1,2,0.4454900372334596,"[0, 1, 1, 0, 0, 1, 0, 0, 1, 0]"
11027,3,3,6,0.5319743481939124,"[0, 0, 1, 0, 0, 1, 0, 1, 1, 1]"
11028,1,1,2,0.16272840832531865,"[1, 0, 1, 0, 1, 1, 0, 1, 1, 0]"
11029,1,1,2,0.8089215641705176,"[0, 1, 1, 1, 0, 0, 1, 1, 0, 1]"
11030,1,1,2,0.5754228655813303,"[0, 1, 1, 0, 0, 1, 0, 1, 0, 0]"
11031,2,2,4,0.9541398814454992,"[1, 0, 0, 1, 1, 1, 0, 1, 1, 1]"
11032,3,3,6,0.9933231118217407,"[1, 0, 1, 1, 1, 1, 1, 1, 1, 0]"
11033,1,1,2,0.3436931371821188,"[0, 1, 0, 0, 0, 1, 1, 1, 0, 0]"
11034,2,2,4,0.866546948897222,"[1, 1, 0, 1, 1, 0, 0, 1, 0, 0]"
11035,1,1,2,0.4660720859462847,"[1, 1, 0, 1, 1, 0, 0, 1, 1, 1]"
11036,3,3,6,0.1480779246099525,"[1, 0, 0, 1, 0, 1, 1, 0, 0, 1]"
11037,2,2,4,0.04923866135955801,"[1, 0, 1, 0, 0, 0, 1, 1, 0, 0]"
11038,1,1,2,0.8699193706836726,"[1, 0, 1, 1, 0, 1, 0, 0, 0, 0]"
11039,1,1,2,0.21984494270597288,"[0, 1, 0, 1, 1, 0, 0, 1, 1, 1]"
11040,1,1,2,0.866743333120022,"[1, 0, 0, 1, 0, 1, 1, 1, 0, 0]"
11041,1,1,2,0.7405902833452058,"[0, 1, 0, 0, 0, 1, 0, 0, 1, 1]"
11042,1,1,2,0.1184652079016435,"[1, 1, 0, 0, 0, 0, 0, 0, 1, 1]"
11043,1,1,2,0.22770461033833012,"[1, 1, 1, 1, 0, 1, 0, 0, 1, 0]"
11044,1,1,2,0.4061582375364028,"[0, 1, 0, 1, 1, 0, 1, 1, 0, 0]"
11045,1,1,2,0.7924824399447552,"[0, 1, 0, 0, 1, 1, 1, 1, 0, 1]"
11046,1,1,2,0.34157034460449565,"[1, 0, 0, 1, 0, 1, 0, 0, 0, 1]"
11047,2,2,4,0.2434609572878702,"[1, 0, 1, 1, 1, 1, 0, 1, 1, 0]"
11048,1,1,2,0.3791970402615541,"[1, 1, 1, 0, 1, 1, 1, 0, 0, 0]"
11049,1,1,2,0.15351902081898394,"[1, 1, 0, 1, 0, 1, 0, 1, 1, 0]"
11050,1,1,2,0.5733971067960678,"[1, 0, 0, 0, 0, 0, 0, 0, 1, 1]"
11051,1,1,2,0.6598249275480192,"[1, 1, 1, 1, 1, 1, 1, 0, 0, 0]"
11052,1,1,2,0.6457550648849022,"[0, 0, 1, 0, 1, 0, 1, 1, 1, 0]"
11053,2,2,4,0.966370101231085,"[0, 0, 0, 1, 0, 0, 1, 0, 1, 0]"
11054,1,1,2,0.1171247845476513,"[0, 1, 0, 1, 1, 1, 0, 1, 0, 1]"
11055,1,1,2,0.636313710714722,"[1, 0, 1, 1, 0, 0, 0, 1, 1, 0]"
11056,1,1,2,0.2708966397500304,"[1, 0, 0, 0, 1, 1, 1, 0, 1, 1]"
11057,1,1,2,0.16433972060922886,"[1, 0, 0, 1, 1, 1, 1, 0, 1, 0]"
11058,1,1,2,0.04977776822671254,"[1, 1, 1, 0, 1, 1, 0, 1, 1, 1]"
11059,2,2,4,0.3885777290028244,"[0, 0, 1, 1, 1, 1, 1, 0, 0, 1]"
11060,1,1,2,0.827785057224034,"[1, 1, 0, 0, 1, 1, 0, 0, 1, 1]"
11061,1,1,2,0.868103409630913,"[1, 1, 1, 0, 0, 1, 0, 1, 1, 1]"
11062,1,1,2,0.7359748328040427,"[1, 0, 0, 1, 0, 0, 0, 0, 1, 1]"
11063,1,1,2,0.23374593878253824,"[0, 1, 1, 1, 1, 0, 1, 1, 0, 0]"
11064,1,1,2,0.48031320998672533,"[1, 0, 0, 0, 1, 0, 1, 1, 0, 1]"
11065,1,1,2,0.24624339551050822,"[0, 1, 0, 0, 0, 1, 1, 0, 1, 1]"
11066,2,2,4,0.9461831188907339,"[0, 1, 1, 1, 0, 0, 1, 1, 0, 0]"
11067,1,1,2,0.7316609374376004,"[0, 1, 0, 0, 1, 0, 0, 1, 0, 1]"
11068,1,1,2,0.8741540855605548,"[0, 1, 0, 1, 0, 0, 1, 0, 0, 0]"
11069,1,1,2,0.01163618971555469,"[0, 0, 1, 0, 1, 0, 1, 1, 1, 1]"
11070,1,1,2,0.576185024701874,"[1, 1, 1, 0, 0, 0, 0, 1, 1, 1]"
11071,2,2,4,0.5049125087458655,"[0, 1, 0, 0, 0, 0, 1, 0, 0, 0]"
11072,1,1,2,0.8011163753476337,"[0, 1, 0, 1, 1, 0, 1, 1, 1, 1]"
11073,1,1,2,0.07229054909664823,"[0, 1, 0, 1, 0, 0, 0, 0, 0, 1]"
11074,1,1,2,0.644566808470943,"[1, 0, 1, 1, 0, 0, 1, 0, 0, 0]"
11075,1,1,2,0.7944986627103152,"[0, 0, 1, 0, 0, 0, 1, 0, 0, 1]"
11076,1,1,2,0.5646894494786467,"[0, 1, 1, 1, 1, 1, 1, 1, 1, 0]"
11077,1,1,2,0.2758088342122359,"[0, 1, 0, 1, 1, 0, 0, 0, 0, 1]"
11078,1,1,2,0.29502646328943916,"[1, 0, 0, 0, 0, 0, 0, 0, 0, 1]"
11079,1,1,2,0.7568683666728659,"[1, 1, 0, 0, 1, 1, 1, 0, 0, 1]"
11080,1,1,2,0.48201589171744275,"[0, 1, 0, 1, 0, 1, 0, 0, 1, 1]"
11081,1,1,2,0.10561969214493416,"[1, 0, 0, 0, 1, 1, 1, 1, 0, 0]"
11082,2,2,4,0.6604653823372911,"[0, 0, 0, 1, 0, 0, 1, 1, 0, 1]"
11083,1,1,2,0.6223207065741092,"[0, 0, 0, 0, 1, 1, 1, 1, 1, 0]"
11084,1,1,2,0.3423792812447737,"[1, 1, 0, 1, 0, 0, 0, 0, 1, 0]"
11085,2,2,4,0.5981973893827214,"[0, 0, 1, 0, 0, 0, 1, 1, 0, 1]"
11086,4,4,8,0.20875401650703496,"[1, 0, 1, 1, 1, 0, 0, 1, 1, 1]"
11087,2,2,4,0.010962117627317913,"[1, 0, 1, 1, 0, 1, 0, 0, 0, 0]"
11088,1,1,2,0.09625218613690134,"[1, 0, 0, 0, 1, 1, 1, 1, 1, 1]"
11089,1,1,2,0.23155263894592282,"[0, 0, 0, 0, 0, 1, 0, 1, 1, 1]"
11090,2,2,4,0.8623532041454468,"[1, 1, 0, 0, 1, 0, 0, 1, 0, 1]"
11091,1,1,2,0.531859744640139,"[0, 1, 1, 0, 0, 1, 0, 0, 1, 0]"
11092,1,1,2,0.36412819648595174,"[1, 0, 0, 1, 1, 0, 1, 0, 0, 1]"
11093,1,1,2,0.2983380082159044,"[1, 0, 0, 0, 1, 1, 1, 1, 1, 1]"
11094,1,1,2,0.7250434414666788,"[1, 0, 1, 1, 0, 1, 0, 0, 1, 1]"
11095,1,1,2,0.8926610780519667,"[1, 1, 0, 1, 1, 1, 0, 1, 1, 0]"
11096,1,1,2,0.8844507114769918,"[1, 0, 1, 0, 1, 0, 1, 0, 0, 0]"
11097,1,1,2,0.9152830822952658,"[1, 0, 0, 0, 0, 1, 0, 0, 0, 1]"
11098,1,1,2,0.9187477733964913,"[0, 0, 1, 0, 0, 1, 0, 1, 1, 0]"
11099,2,2,4,0.016759863367649785,"[0, 1, 1, 1, 1, 0, 0, 0, 1, 0]"
11100,4,4,8,0.2512461160459326,"[0, 1, 0, 0, 0, 1, 0, 0, 0, 0]"
11101,1,1,2,0.16646905306784598,"[0, 0, 0, 0, 0, 1, 0, 0, 1, 0]"
11102,1,1,2,0.22817256106332795,"[1, 0, 0, 1, 1, 1, 0, 1, 1, 0]"
11103,1,1,2,0.8726899598013569,"[0, 0, 1, 0, 0, 1, 1, 1, 0, 1]"
11104,1,1,2,0.47153433657496824,"[1, 0, 0, 0, 0, 1, 1, 0, 0, 0]"
11105,2,2,4,0.8053514899662005,"[1, 0, 1, 1, 1, 0, 0, 0, 0, 1]"
11106,1,1,2,0.8612908783471398,"[1, 0, 0, 1, 0, 0, 1, 1, 0, 0]"
11107,1,1,2,0.6477419789876777,"[0, 0, 0, 1, 0, 0, 1, 0, 0, 0]"
11108,2,2,4,0.24779378290145415,"[0, 1, 1, 0, 0, 1, 0, 0, 1, 0]"
11109,2,2,4,0.9279451966410923,"[1, 0, 1, 0, 0, 1, 1, 0, 1, 0]"
11110,1,1,2,0.22000834015589465,"[0, 0, 1, 1, 0, 1, 0, 1, 1, 0]"
11111,2,2,4,0.28528375669923,"[1, 0, 0, 1, 1, 0, 0, 1, 1, 1]"
11112,1,1,2,0.21136497334856374,"[1, 0, 1, 1, 1, 1, 0, 0, 1, 0]"
11113,1,1,2,0.11640367092222881,"[1, 1, 1, 1, 1, 1, 1, 0, 1, 1]"
11114,1,1,2,0.8635357314425298,"[1, 0, 0, 0, 0, 1, 1, 1, 1, 0]"
11115,2,2,4,0.37117066427555845,"[1, 1, 1, 0, 0, 1, 1, 1, 1, 1]"
11116,1,1,2,0.4062009451371783,"[1, 1, 1, 0, 1, 1, 0, 0, 1, 1]"
11117,1,1,2,0.4998606442385154,"[1, 1, 1, 0, 0, 1, 0, 1, 0, 1]"
11118,1,1,2,0.9906313355265698,"[1, 0, 1, 1, 1, 1, 1, 1, 0, 0]"
11119,1,1,2,0.48473971788352455,"[0, 0, 1, 0, 1, 0, 1, 1, 1, 0]"
11120,1,1,2,0.3104810510471836,"[1, 0, 1, 0, 1, 1, 1, 1, 0, 0]"
11121,1,1,2,0.04658505491491116,"[0, 0, 0, 0, 1, 0, 1, 1, 1, 0]"
11122,2,2,4,0.47246556513749216,"[1, 0, 0, 1, 1, 0, 0, 1, 0, 0]"
11123,1,1,2,0.9381767643064418,"[0, 1, 0, 0, 0, 1, 0, 1, 0, 1]"
11124,1,1,2,0.5337995764418575,"[0, 0, 1, 1, 1, 0, 0, 1, 0, 0]"
11125,1,1,2,0.08319924450965277,"[1, 0, 0, 0, 0, 0, 0, 1, 0, 1]"
11126,1,1,2,0.9898391793849864,"[1, 1, 0, 0, 0, 0, 0, 0, 1, 0]"
11127,3,3,6,0.7981627169159454,"[0, 0, 1, 1, 1, 1, 0, 1, 0, 1]"
11128,1,1,2,0.2945883517915694,"[0, 1, 0, 0, 0, 0, 0, 1, 1, 1]"
11129,1,1,2,0.1534634123154447,"[1, 1, 0, 0, 1, 1, 0, 0, 1, 0]"
11130,2,2,4,0.10488660365379132,"[1, 1, 0, 1, 0, 1, 0, 0, 1, 0]"
11131,1,1,2,0.330386190993155,"[0, 1, 1, 0, 1, 0, 1, 1, 1, 0]"
11132,1,1,2,0.9687959733399057,"[0, 0, 0, 1, 1, 1, 0, 0, 0, 0]"
11133,1,1,2,0.30082085173252304,"[0, 1, 0, 1, 0, 1, 0, 1, 1, 1]"
11134,1,1,2,0.7149866394730263,"[1, 1, 0, 1, 0, 1, 0, 0, 1, 1]"
11135,2,2,4,0.4564011111531735,"[1, 0, 0, 1, 1, 0, 1, 0, 0, 1]"
11136,1,1,2,0.9121161579644309,"[1, 1, 0, 1, 1, 0, 0, 1, 1, 0]"
11137,1,1,2,0.8602277590232139,"[1, 1, 0, 0, 0, 0, 0, 1, 0, 0]"
11138,1,1,2,0.8069439960637184,"[0, 0, 0, 0, 0, 0, 1, 1, 1, 1]"
11139,1,1,2,0.8771501050209428,"[0, 1, 0, 1, 1, 0, 1, 0, 0, 0]"
11140,3,3,6,0.8035216941417229,"[1, 1, 1, 1, 1, 0, 0, 1, 1, 0]"
11141,2,2,4,0.8615314243227375,"[0, 1, 0, 1, 0, 1, 1, 0, 1, 0]"
11142,1,1,2,0.1735020799546847,"[1, 1, 0, 0, 1, 1, 1, 0, 0, 1]"
11143,1,1,2,0.1509464228860149,"[0, 0, 0, 1, 0, 0, 1, 0, 0, 0]"
11144,1,1,2,0.38587224725029556,"[1, 0, 1, 0, 1, 0, 0, 0, 0, 0]"
11145,1,1,2,0.9960207144292048,"[0, 1, 0, 0, 0, 1, 1, 0, 1, 0]"
11146,3,3,6,0.2762438390198273,"[0, 1, 1, 0, 0, 0, 1, 1, 1, 1]"
11147,1,1,2,0.28540642031949703,"[0, 1, 0, 0, 0, 0, 0, 0, 1, 0]"
11148,1,1,2,0.20660816390614423,"[0, 0, 1, 1, 0, 1, 0, 0, 0, 1]"
11149,1,1,2,0.9954157410201709,"[0, 0, 0, 1, 1, 1, 1, 0, 0, 0]"
11150,1,1,2,0.22634883058386213,"[0, 0, 1, 0, 0, 1, 0, 0, 0, 0]"
11151,1,1,2,0.5475017184663472,"[1, 1, 1, 0, 1, 1, 1, 1, 0, 0]"
11152,1,1,2,0.12365222156314548,"[1, 0, 0, 1, 1, 0, 1, 1, 0, 0]"
11153,3,3,6,0.14102233848229906,"[1, 0, 0, 1, 1, 0, 0, 0, 0, 1]"
11154,1,1,2,0.1745045259579312,"[1, 1, 0, 1, 1, 0, 1, 0, 0, 0]"
11155,1,1,2,0.3026439784294651,"[1, 1, 1, 0, 1, 1, 1, 1, 1, 1]"
11156,2,2,4,0.6498492101800141,"[1, 0, 1, 1, 0, 0, 0, 0, 1, 1]"
11157,1,1,2,0.8320059740033202,"[1, 0, 1, 0, 0, 0, 1, 1, 0, 1]"
11158,1,1,2,0.6674357932564393,"[1, 0, 1, 0, 0, 0, 1, 0, 1, 1]"
11159,1,1,2,0.1535294602876376,"[1, 0, 0, 1, 1, 1, 1, 0, 0, 1]"
11160,1,1,2,0.5822140333840021,"[0, 1, 1, 0, 0, 0, 1, 0, 0, 0]"
11161,1,1,2,0.7816373175059982,"[1, 0, 1, 0, 1, 0, 1, 0, 1, 1]"
11162,1,1,2,0.4559854985787991,"[1, 0, 0, 0, 1, 0, 1, 1, 1, 0]"
11163,1,1,2,0.9159737799513968,"[1, 0, 0, 1, 1, 1, 0, 1, 1, 1]"
11164,1,1,2,0.4735976258120964,"[0, 0, 1, 1, 1, 0, 0, 1, 0, 1]"
11165,1,1,2,0.043459488489258624,"[1, 1, 0, 1, 1, 1, 0, 1, 1, 0]"
11166,1,1,2,0.6841930861057828,"[1, 1, 1, 0, 1, 1, 1, 1, 1, 0]"
11167,1,1,2,0.5011069813653738,"[1, 1, 0, 1, 0, 1, 0, 1, 1, 0]"
11168,1,1,2,0.6204130948779345,"[0, 0, 0, 1, 0, 0, 1, 0, 1, 1]"
11169,1,1,2,0.5309066805079379,"[0, 0, 1, 0, 1, 0, 0, 0, 0, 1]"
11170,1,1,2,0.9211890966488894,"[0, 1, 0, 0, 0, 0, 1, 1, 0, 0]"
11171,1,1,2,0.8798972424012359,"[0, 0, 0, 1, 1, 0, 0, 0, 0, 0]"
11172,3,3,6,0.13291517497254068,"[0, 1, 0, 0, 1, 0, 1, 0, 1, 1]"
11173,1,1,2,0.3067979921356171,"[1, 1, 1, 0, 1, 0, 0, 1, 1, 0]"
11174,1,1,2,0.5800857453652726,"[0, 0, 0, 1, 1, 1, 0, 0, 1, 1]"
11175,1,1,2,0.8352359294549389,"[0, 1, 0, 1, 0, 1, 0, 1, 1, 1]"
11176,1,1,2,0.30279506327767447,"[1, 1, 1, 0, 1, 0, 1, 0, 1, 0]"
11177,2,2,4,0.9832282526136512,"[0, 1, 1, 0, 1, 1, 1, 0, 0, 1]"
11178,1,1,2,0.10719714355543741,"[0, 0, 0, 0, 0, 0, 1, 0, 1, 1]"
11179,3,3,6,0.3903234273634807,"[1, 1, 1, 0, 0, 0, 1, 0, 1, 0]"
11180,2,2,4,0.2214140669662953,"[0, 0, 1, 0, 0, 0, 1, 1, 0, 0]"
11181,1,1,2,0.663693620596306,"[0, 0, 0, 0, 0, 0, 0, 0, 1, 0]"
11182,1,1,2,0.6458941916659878,"[1, 1, 1, 0, 0, 0, 1, 0, 1, 1]"
11183,1,1,2,0.13545989145725534,"[1, 1, 0, 0, 0, 1, 0, 0, 1, 0]"
11184,1,1,2,0.7801850443486233,"[0, 0, 1, 0, 1, 0, 1, 0, 1, 1]"
11185,1,1,2,0.822204397210845,"[0, 0, 1, 0, 0, 0, 1, 1, 0, 1]"
11186,1,1,2,0.10614540325924537,"[0, 0, 0, 0, 0, 0, 1, 1, 0, 0]"
11187,1,1,2,0.921978137083944,"[1, 1, 1, 0, 0, 0, 1, 0, 0, 0]"
11188,1,1,2,0.33034257119429644,"[0, 0, 0, 0, 0, 1, 1, 0, 1, 1]"
11189,1,1,2,0.7989302148464474,"[0, 0, 0, 1, 0, 1, 0, 0, 0, 1]"
11190,2,2,4,0.11139242674346916,"[1, 0, 1, 0, 0, 1, 0, 0, 0, 1]"
11191,1,1,2,0.7885343499656495,"[1, 1, 0, 1, 1, 1, 0, 1, 0, 1]"
11192,1,1,2,0.050263579060329855,"[0, 0, 0, 0, 0, 0, 0, 1, 1, 0]"
11193,1,1,2,0.9999436002708706,"[1, 1, 0, 1, 1, 0, 0, 0, 0, 1]"
11194,1,1,2,0.5437824459707047,"[1, 0, 1, 1, 1, 0, 1, 1, 1, 0]"
11195,2,2,4,0.34723725189118515,"[1, 1, 0, 1, 1, 0, 1, 0, 1, 1]"
11196,2,2,4,0.19872953302098462,"[1, 1, 0, 0, 1, 1, 1, 0, 0, 0]"
11197,1,1,2,0.008381326497831298,"[0, 0, 1, 1, 0, 0, 1, 0, 1, 1]"
11198,2,2,4,0.957388546668222,"[0, 1, 1, 1, 1, 1, 0, 1, 0, 0]"
11199,2,2,4,0.13266511735586162,"[1, 0, 1, 0, 1, 0, 0, 0, 0, 0]"
11200,1,1,2,0.648680381067315,"[1, 0, 0, 0, 0, 0, 0, 0, 0, 1]"
11201,1,1,2,0.6416575073721275,"[0, 1, 0, 0, 0, 0, 0, 1, 1, 1]"
11202,1,1,2,0.7666257293628915,"[0, 1, 1, 0, 0, 1, 0, 0, 1, 0]"
11203,1,1,2,0.025943833675287076,"[0, 0, 0, 0, 0, 0, 0, 1, 1, 1]"
11204,4,4,8,0.3421822946177526,"[1, 0, 1, 1, 0, 1, 0, 1, 0, 1]"
11205,2,2,4,0.6901317508975103,"[0, 1, 1, 1, 1, 1, 0, 1, 1, 0]"
11206,1,1,2,0.36253526348470244,"[0, 0, 0, 1, 0, 0, 1, 1, 0, 1]"
11207,1,1,2,0.9802705149572005,"[0, 1, 1, 1, 0, 1, 0, 0, 0, 0]"
11208,2,2,4,0.30587823934247704,"[0, 1, 0, 1, 1, 0, 1, 1, 1, 1]"
11209,3,3,6,0.05525074619886006,"[1, 0, 0, 1, 0, 0, 1, 0, 0, 1]"
11210,1,1,2,0.5276798797982547,"[0, 1, 1, 1, 0, 0, 0, 0, 1, 1]"
11211,1,1,2,0.447708346967704,"[1, 1, 0, 1, 1, 0, 0, 0, 0, 0]"
11212,1,1,2,0.29469072579247435,"[0, 1, 0, 0, 1, 1, 0, 0, 0, 1]"
11213,2,2,4,0.6015808837588702,"[1, 1, 1, 0, 1, 1, 1, 0, 1, 0]"
11214,1,1,2,0.21224598169990594,"[0, 1, 0, 1, 0, 0, 0, 1, 1, 0]"
11215,1,1,2,0.7926632086924175,"[1, 1, 0, 1, 1, 0, 0, 1, 1, 1]"
11216,1,1,2,0.6273246531950387,"[1, 0, 1, 1, 0, 0, 0, 1, 1, 0]"
11217,1,1,2,0.9738437898552663,"[1, 1, 0, 0, 0, 1, 0, 1, 1, 0]"
11218,2,2,4,0.19730851368589775,"[1, 0, 0, 1, 0, 0, 1, 1, 1, 1]"
11219,2,2,4,0.9462478322092256,"[1, 0, 0, 0, 0, 0, 1, 1, 1, 0]"
11220,1,1,2,0.45931069574174943,"[1, 1, 0, 0, 0, 1, 1, 0, 0, 1]"
11221,1,1,2,0.5619361688458214,"[1, 0, 1, 0, 1, 1, 1, 0, 1, 0]"
11222,1,1,2,0.5887258523227324,"[0, 0, 1, 0, 0, 0, 1, 0, 0, 1]"
11223,1,1,2,0.181429221361869,"[0, 1, 0, 1, 1, 1, 0, 1, 1, 1]"
11224,1,1,2,0.28059663203689933,"[0, 1, 1, 1, 0, 0, 1, 0, 0, 1]"
11225,1,1,2,0.45854088465599274,"[0, 0, 1, 0, 0, 0, 1, 1, 1, 1]"
11226,1,1,2,0.7012071189249454,"[0, 0, 0, 1, 1, 0, 0, 0, 1, 1]"
11227,1,1,2,0.7941914815670862,"[1, 1, 1, 1, 0, 0, 1, 1, 1, 0]"
11228,1,1,2,0.3885661994399775,"[0, 1, 1, 0, 1, 0, 1, 0, 0, 0]"
11229,2,2,4,0.3319834991195725,"[1, 1, 1, 0, 0, 0, 0, 0, 0, 1]"
11230,1,1,2,0.12716729381993808,"[1, 0, 0, 0, 0, 0, 1, 0, 1, 1]"
11231,1,1,2,0.29904822833468225,"[0, 1, 0, 1, 1, 1, 0, 1, 0, 1]"
11232,1,1,2,0.338835382296546,"[0, 0, 1, 0, 0, 0, 0, 1, 0, 0]"
11233,1,1,2,0.45325220797898225,"[0, 1, 0, 1, 0, 1, 0, 1, 0, 1]"
11234,1,1,2,0.1441720978184713,"[1, 0, 0, 1, 0, 0, 0, 0, 0, 1]"
11235,1,1,2,0.2713545764617883,"[1, 1, 1, 1, 1, 0, 0, 1, 1, 1]"
11236,1,1,2,0.24371766501451264,"[0, 0, 1, 0, 0, 0, 1, 0, 1, 1]"
11237,1,1,2,0.028133235980781657,"[1, 1, 0, 1, 1, 0, 0, 1, 1, 0]"
11238,1,1,2,0.06677522555040638,"[1, 0, 1, 1, 0, 1, 0, 1, 1, 1]"
11239,2,2,4,0.6176111298686355,"[1, 1, 0, 1, 1, 1, 0, 1, 0, 1]"
11240,1,1,2,0.38984024326168565,"[1, 0, 0, 1, 1, 0, 1, 0, 1, 0]"
11241,1,1,2,0.10829059697747179,"[0, 0, 1, 1, 1, 1, 1, 1, 0, 0]"
11242,1,1,2,0.5515456523695542,"[1, 0, 0, 0, 0, 1, 0, 0, 0, 0]"
11243,1,1,2,0.6484726506168419,"[0, 1, 1, 1, 1, 0, 1, 1, 1, 0]"
11244,1,1,2,0.3801118838076838,"[0, 0, 1, 0, 0, 1, 0, 1, 0, 1]"
11245,1,1,2,0.459635208472021,"[1, 1, 0, 0, 1, 0, 1, 0, 1, 1]"
11246,1,1,2,0.5389384365998103,"[0, 1, 1, 1, 1, 0, 1, 0, 1, 1]"
11247,1,1,2,0.05434962108692143,"[0, 1, 0, 1, 0, 1, 1, 1, 1, 1]"
11248,1,1,2,0.6954559313674848,"[0, 0, 1, 1, 1, 1, 0, 1, 0, 1]"
11249,1,1,2,0.3025992152926873,"[1, 0, 0, 0, 1, 0, 1, 0, 0, 0]"
11250,2,2,4,0.28373176692611435,"[1, 0, 1, 0, 0, 1, 1, 0, 0, 1]"
11251,1,1,2,0.5452822142547327,"[0, 1, 1, 1, 1, 0, 1, 1, 1, 0]"
11252,1,1,2,0.24959251815126882,"[1, 0, 0, 0, 1, 0, 0, 1, 1, 0]"
11253,1,1,2,0.32801156666347187,"[1, 0, 1, 1, 1, 0, 1, 0, 0, 0]"
11254,1,1,2,0.30947353943569755,"[1, 0, 0, 0, 1, 0, 0, 0, 0, 1]"
11255,1,1,2,0.7908706320841226,"[1, 0, 1, 0, 1, 0, 1, 1, 1, 0]"
11256,1,1,2,0.24143225177501382,"[1, 1, 1, 0, 1, 0, 0, 1, 1, 1]"
11257,2,2,4,0.3313947884627154,"[1, 1, 0, 0, 1, 0, 0, 0, 1, 0]"
11258,1,1,2,0.9464867886264153,"[1, 1, 0, 1, 1, 1, 1, 0, 0, 0]"
11259,1,1,2,0.7555762645988126,"[1, 1, 1, 0, 1, 1, 0, 1, 1, 0]"
11260,1,1,2,0.9350928847566731,"[0, 0, 1, 0, 1, 1, 1, 0, 1, 0]"
11261,3,3,6,0.41257923397196306,"[0, 0, 1, 0, 1, 0, 1, 1, 1, 0]"
11262,1,1,2,0.8535353654739846,"[0, 0, 0, 0, 0, 1, 1, 1, 0, 1]"
11263,1,1,2,0.8036796260494976,"[0, 0, 0, 1, 1, 1, 1, 1, 0, 1]"
11264,3,3,6,0.07112059410494953,"[0, 0, 0, 0, 0, 0, 0, 1, 1, 0]"
11265,1,1,2,0.7437588027204867,"[1, 1, 1, 1, 1, 0, 0, 1, 0, 0]"
11266,1,1,2,0.47212911197854845,"[1, 1, 0, 1, 1, 0, 1, 1, 1, 1]"
11267,1,1,2,0.786492245251239,"[1, 0, 0, 1, 0, 0, 0, 1, 1, 1]"
11268,1,1,2,0.36772561573610163,"[0, 0, 1, 0, 0, 1, 0, 1, 1, 0]"
11269,2,2,4,0.9799516532483423,"[0, 1, 1, 1, 0, 0, 1, 1, 1, 0]"
11270,2,2,4,0.13488723046827789,"[1, 0, 1, 0, 1, 1, 0, 1, 0, 0]"
11271,1,1,2,0.13441829070091071,"[0, 0, 1, 0, 1, 1, 1, 0, 1, 1]"
11272,1,1,2,0.5634635134572392,"[0, 0, 1, 1, 0, 1, 0, 0, 0, 0]"
11273,1,1,2,0.2469531299070974,"[1, 1, 1, 0, 0, 1, 1, 0, 1, 1]"
11274,1,1,2,0.673308985805432,"[0, 1, 1, 0, 1, 0, 0, 0, 0, 1]"
11275,1,1,2,0.3565337647217084,"[0, 1, 0, 1, 0, 1, 1, 1, 1, 0]"
11276,1,1,2,0.18270362147560315,"[0, 0, 0, 0, 0, 0, 1, 1, 1, 0]"
11277,1,1,2,0.6566595566557445,"[1, 0, 1, 1, 0, 0, 0, 1, 0, 0]"
11278,1,1,2,0.4217138790470265,"[1, 1, 1, 0, 1, 1, 0, 0, 1, 0]"
11279,1,1,2,0.7364546103080256,"[0, 1, 0, 0, 1, 0, 0, 1, 0, 0]"
11280,1,1,2,0.909446567083124,"[1, 0, 0, 0, 0, 0, 0, 0, 0, 0]"
11281,1,1,2,0.8044451535078879,"[0, 1, 1, 1, 0, 1, 0, 1, 1, 1]"
11282,2,2,4,0.10017136567211005,"[0, 0, 0, 1, 1, 1, 1, 1, 0, 0]"
11283,1,1,2,0.6202803595831253,"[1, 0, 0, 1, 1, 1, 1, 0, 0, 0]"
11284,3,3,6,0.5606974855768824,"[1, 1, 1, 1, 0, 1, 1, 1, 0, 1]"
11285,1,1,2,0.7508574771146161,"[0, 0, 0, 1, 0, 0, 0, 0, 0, 0]"
11286,1,1,2,0.9773284823544519,"[1, 1, 1, 1, 1, 1, 1, 1, 1, 0]"
11287,2,2,4,0.8547159287169805,"[1, 0, 0, 1, 0, 1, 1, 1, 1, 0]"
11288,1,1,2,0.0173548450473624,"[0, 0, 0, 1, 1, 0, 0, 1, 0, 1]"
11289,2,2,4,0.4833971622230633,"[1, 1, 0, 0, 1, 0, 0, 0, 1, 1]"
11290,1,1,2,0.821120189903676,"[1, 0, 0, 0, 1, 1, 1, 1, 1, 0]"
11291,1,1,2,0.7187996381837559,"[1, 0, 0, 0, 0, 0, 0, 1, 1, 0]"
11292,1,1,2,0.30161177492869795,"[0, 0, 0, 1, 0, 0, 1, 1, 0, 0]"
11293,1,1,2,0.5476933351607549,"[0, 0, 0, 1, 0, 0, 0, 0, 0, 1]"
11294,1,1,2,0.5427373415588366,"[1, 0, 0, 0, 1, 0, 0, 0, 0, 0]"
11295,1,1,2,0.060919072183095,"[1, 1, 0, 1, 0, 1, 1, 1, 0, 0]"
11296,2,2,4,0.7616969349894329,"[0, 0, 0, 1, 0, 1, 0, 1, 1, 0]"
11297,1,1,2,0.16743058622977547,"[0, 1, 0, 0, 1, 1, 0, 1, 0, 1]"
11298,1,1,2,0.1581752842580012,"[1, 0, 1, 1, 1, 1, 0, 0, 1, 0]"
11299,1,1,2,0.8187053373529857,"[0, 0, 1, 0, 0, 1, 1, 1, 1, 0]"
11300,1,1,2,0.9025677204107246,"[0, 0, 1, 0, 1, 1, 1, 0, 0, 1]"
11301,1,1,2,0.06943130807836007,"[0, 1, 1, 1, 0, 0, 1, 0, 0, 1]"
11302,1,1,2,0.4265120328945802,"[1, 1, 0, 1, 1, 1, 0, 1, 0, 0]"
11303,1,1,2,0.8604444038011123,"[0, 0, 1, 1, 0, 1, 1, 1, 0, 0]"
11304,1,1,2,0.9460006128790833,"[1, 1, 1, 1, 1, 1, 0, 0, 0, 1]"
11305,1,1,2,0.263924322828746,"[1, 0, 1, 1, 0, 1, 0, 1, 0, 0]"
11306,2,2,4,0.899348422996102,"[1, 1, 0, 0, 1, 1, 1, 1, 1, 1]"
11307,1,1,2,0.06308974011535806,"[0, 1, 0, 1, 1, 1, 1, 0, 1, 0]"
11308,2,2,4,0.47927548748725435,"[1, 1, 0, 1, 0, 1, 0, 0, 0, 0]"
11309,2,2,4,0.7706884358097343,"[1, 1, 1, 0, 0, 0, 0, 1, 0, 1]"
11310,2,2,4,0.1712145312151384,"[0, 0, 0, 1, 1, 0, 1, 1, 1, 0]"
11311,2,2,4,0.044353414492247056,"[1, 1, 0, 1, 1, 0, 1, 0, 0, 0]"
11312,2,2,4,0.7403740542079905,"[0, 1, 1, 1, 1, 0, 1, 0, 1, 1]"
11313,1,1,2,0.28070493650168626,"[0, 1, 1, 1, 0, 0, 1, 0, 1, 0]"
11314,1,1,2,0.7103351506799739,"[0, 0, 0, 1, 1, 0, 1, 0, 0, 1]"
11315,1,1,2,0.17961666597503012,"[0, 1, 0, 0, 1, 0, 0, 1, 0, 1]"
11316,1,1,2,0.98117439856404,"[1, 1, 0, 0, 1, 1, 1, 1, 0, 1]"
11317,1,1,2,0.5782032919577411,"[0, 0, 1, 0, 1, 1, 1, 0, 0, 1]"
11318,2,2,4,0.3324678067563859,"[0, 1, 0, 0, 1, 0, 0, 0, 1, 0]"
11319,1,1,2,0.5988650045382865,"[1, 1, 1, 0, 0, 0, 1, 1, 1, 1]"
11320,1,1,2,0.05040282653648809,"[0, 1, 0, 0, 1, 1, 1, 1, 0, 0]"
11321,1,1,2,0.6271474306344421,"[0, 0, 1, 0, 1, 1, 0, 1, 1, 0]"
11322,1,1,2,0.7364940341040614,"[0, 1, 1, 1, 0, 1, 0, 1, 0, 0]"
11323,1,1,2,0.3720295224008343,"[1, 0, 1, 0, 0, 1, 1, 1, 0, 0]"
11324,1,1,2,0.4753667865620087,"[0, 1, 1, 0, 0, 1, 1, 0, 1, 1]"
11325,1,1,2,0.9140639099946138,"[1, 1, 0, 1, 1, 0, 0, 1, 0, 0]"
11326,1,1,2,0.6573372023716249,"[1, 1, 0, 1, 0, 0, 1, 1, 0, 1]"
11327,2,2,4,0.012857979723731705,"[0, 1, 1, 0, 0, 1, 0, 1, 0, 0]"
11328,2,2,4,0.014602411571936424,"[0, 0, 0, 0, 0, 1, 1, 0, 1, 1]"
11329,1,1,2,0.8458306931666247,"[0, 1, 1, 1, 0, 1, 1, 1, 1, 0]"
11330,1,1,2,0.6869805068356857,"[0, 1, 0, 0, 1, 1, 1, 1, 0, 0]"
11331,1,1,2,0.5594535026076785,"[0, 0, 1, 0, 1, 0, 0, 1, 1, 1]"
11332,1,1,2,0.8132858543925586,"[0, 0, 1, 0, 1, 1, 1, 1, 0, 1]"
11333,1,1,2,0.2947949863478867,"[1, 1, 1, 0, 0, 1, 0, 1, 0, 0]"
11334,1,1,2,0.8952844713341118,"[0, 0, 1, 0, 1, 1, 1, 0, 1, 1]"
11335,1,1,2,0.2491447235285077,"[1, 0, 1, 0, 1, 0, 1, 1, 0, 0]"
11336,1,1,2,0.44226493716019677,"[1, 0, 0, 0, 0, 0, 1, 1, 1, 1]"
11337,1,1,2,0.8853430509313185,"[1, 1, 1, 1, 0, 0, 0, 0, 1, 1]"
11338,1,1,2,0.5512660296513664,"[0, 0, 1, 0, 1, 1, 1, 1, 1, 0]"
11339,1,1,2,0.38786542924398526,"[1, 0, 0, 1, 1, 0, 0, 0, 0, 0]"
11340,1,1,2,0.6502436531938584,"[0, 0, 1, 0, 1, 0, 1, 0, 0, 0]"
11341,1,1,2,0.6925457993550637,"[0, 0, 1, 0, 0, 0, 0, 1, 0, 1]"
11342,1,1,2,0.4261718497747279,"[0, 0, 1, 1, 1, 0, 1, 1, 0, 1]"
11343,2,2,4,0.23211567040616732,"[0, 0, 1, 0, 0, 1, 1, 1, 0, 1]"
11344,1,1,2,0.11741020600188656,"[1, 0, 0, 0, 0, 0, 0, 0, 1, 0]"
11345,2,2,4,0.48797134422340893,"[0, 0, 1, 1, 1, 0, 0, 0, 0, 1]"
11346,1,1,2,0.4758267977925409,"[1, 1, 0, 1, 1, 1, 0, 0, 1, 1]"
11347,1,1,2,0.09716710129608874,"[1, 1, 1, 0, 1, 0, 1, 1, 1, 0]"
11348,1,1,2,0.7171233306432551,"[1, 0, 0, 0, 1, 0, 1, 0, 0, 0]"
11349,1,1,2,0.3596088337312445,"[0, 1, 0, 1, 0, 1, 1, 0, 1, 1]"
11350,2,2,4,0.1038122119314212,"[1, 1, 1, 1, 1, 1, 0, 0, 1, 0]"
11351,1,1,2,0.1646131149240776,"[1, 1, 1, 0, 1, 1, 1, 0, 0, 0]"
11352,2,2,4,0.6084949825045399,"[1, 0, 1, 1, 1, 0, 1, 1, 1, 0]"
11353,1,1,2,0.9207246750926387,"[0, 0, 1, 0, 1, 0, 0, 1, 0, 0]"
11354,1,1,2,0.17962961863210958,"[0, 1, 0, 0, 0, 1, 1, 0, 0, 0]"
11355,1,1,2,0.8610394526799089,"[0, 1, 1, 0, 0, 0, 0, 0, 1, 0]"
11356,2,2,4,0.6218223095830063,"[0, 1, 1, 1, 0, 1, 0, 0, 0, 1]"
11357,1,1,2,0.4672390402132863,"[1, 1, 1, 0, 1, 1, 0, 1, 0, 0]"
11358,1,1,2,0.10215584254365673,"[0, 0, 1, 0, 0, 0, 0, 1, 1, 1]"
11359,1,1,2,0.8468370737347162,"[0, 1, 1, 1, 1, 1, 0, 1, 0, 1]"
11360,2,2,4,0.562442064203908,"[1, 0, 1, 1, 0, 0, 1, 0, 0, 1]"
11361,1,1,2,0.1661807933531062,"[0, 0, 1, 1, 1, 0, 0, 0, 0, 0]"
11362,1,1,2,0.2832967355531919,"[0, 0, 0, 1, 1, 1, 0, 1, 0, 0]"
11363,1,1,2,0.586973837866339,"[1, 0, 1, 1, 0, 0, 0, 0, 1, 1]"
11364,1,1,2,0.06058692307307201,"[0, 1, 0, 1, 1, 0, 1, 1, 0, 0]"
11365,1,1,2,0.562529092588974,"[1, 1, 0, 1, 1, 0, 1, 0, 0, 0]"
11366,1,1,2,0.8026863471553378,"[1, 0, 1, 0, 0, 0, 1, 0, 1, 1]"
11367,1,1,2,0.7729327556459044,"[0, 1, 0, 0, 0, 0, 0, 1, 1, 0]"
11368,1,1,2,0.23020447604480554,"[0, 1, 1, 0, 0, 0, 0, 0, 0, 1]"
11369,2,2,4,0.056559891452242606,"[1, 0, 1, 0, 0, 0, 0, 0, 0, 0]"
11370,1,1,2,0.39779595389488287,"[1, 1, 0, 0, 1, 0, 1, 0, 0, 0]"
11371,2,2,4,0.35783533620964636,"[1, 1, 0, 0, 0, 0, 0, 0, 1, 1]"
11372,1,1,2,0.560927362963545,"[1, 0, 0, 1, 0, 0, 0, 1, 1, 1]"
11373,1,1,2,0.3776680144259109,"[0, 1, 1, 1, 0, 1, 0, 0, 1, 0]"
11374,1,1,2,0.5587802683631984,"[1, 0, 0, 1, 0, 1, 1, 0, 0, 1]"
11375,1,1,2,0.7764008412076987,"[0, 0, 0, 1, 0, 0, 0, 0, 1, 1]"
11376,1,1,2,0.6716885373960187,"[0, 0, 0, 1, 1, 0, 0, 0, 0, 0]"
11377,1,1,2,0.3515674764220318,"[1, 1, 0, 1, 1, 1, 1, 1, 1, 1]"
11378,1,1,2,0.294714653541978,"[0, 0, 1, 0, 1, 1, 1, 1, 1, 0]"
11379,1,1,2,0.5124499209886226,"[1, 1, 0, 1, 1, 1, 1, 0, 1, 1]"
11380,1,1,2,0.43510978887327734,"[0, 0, 1, 1, 0, 0, 1, 0, 1, 0]"
11381,1,1,2,0.4003204809526647,"[1, 0, 0, 1, 0, 1, 0, 1, 0, 0]"
11382,2,2,4,0.11798827484328323,"[0, 1, 1, 1, 1, 0, 1, 0, 1, 0]"
11383,1,1,2,0.5539168675810289,"[1, 0, 0, 1, 1, 1, 0, 1, 1, 0]"
11384,1,1,2,0.009183294970569245,"[0, 0, 1, 1, 1, 1, 1, 0, 0, 0]"
11385,1,1,2,0.8640051072632724,"[1, 0, 0, 0, 0, 0, 0, 0, 1, 1]"
11386,1,1,2,0.9700077807377423,"[1, 0, 0, 0, 0, 1, 0, 0, 0, 0]"
11387,2,2,4,0.797956501303829,"[0, 1, 0, 0, 0, 0, 1, 1, 1, 1]"
11388,1,1,2,0.36182672542703553,"[1, 1, 1, 1, 0, 1, 0, 1, 1, 1]"
11389,4,4,8,0.08899564183644537,"[1, 1, 0, 1, 1, 0, 1, 1, 1, 1]"
11390,5,5,10,0.4105614031682151,"[1, 0, 0, 0, 0, 1, 1, 1, 0, 0]"
11391,1,1,2,0.17803085989641787,"[0, 0, 1, 0, 0, 1, 1, 0, 0, 1]"
11392,1,1,2,0.45623034318781,"[1, 0, 0, 0, 1, 1, 0, 1, 0, 1]"
11393,1,1,2,0.07807503066835675,"[1, 1, 1, 0, 0, 1, 1, 0, 0, 1]"
11394,1,1,2,0.5682330493584125,"[1, 0, 0, 1, 0, 0, 1, 0, 1, 0]"
11395,1,1,2,0.5204278726278417,"[0, 0, 1, 1, 1, 1, 0, 1, 0, 1]"
11396,1,1,2,0.3184295501525325,"[1, 0, 0, 0, 0, 0, 0, 1, 1, 0]"
11397,1,1,2,0.721414143687241,"[0, 0, 0, 0, 0, 1, 0, 0, 1, 0]"
11398,3,3,6,0.4625674416314447,"[1, 0, 1, 0, 0, 1, 1, 1, 1, 0]"
11399,2,2,4,0.13034680432331458,"[1, 0, 0, 1, 0, 0, 1, 0, 1, 0]"
11400,2,2,4,0.41933041042108643,"[0, 0, 1, 1, 0, 0, 1, 1, 1, 1]"
11401,1,1,2,0.05135332829369477,"[0, 1, 1, 1, 1, 0, 1, 1, 0, 1]"
11402,1,1,2,0.3305618999138178,"[1, 0, 0, 1, 1, 1, 1, 1, 0, 0]"
11403,1,1,2,0.6668172580666677,"[1, 1, 1, 0, 1, 1, 0, 1, 0, 1]"
11404,2,2,4,0.9325085039219337,"[0, 1, 0, 0, 0, 0, 0, 1, 1, 1]"
11405,2,2,4,0.7159647761914534,"[1, 1, 1, 0, 1, 1, 1, 1, 0, 1]"
11406,2,2,4,0.1972191601818032,"[1, 1, 0, 0, 1, 0, 1, 1, 1, 1]"
11407,1,1,2,0.8874874587187093,"[1, 0, 0, 1, 1, 1, 0, 1, 0, 0]"
11408,2,2,4,0.5719342714322799,"[1, 1, 0, 0, 1, 1, 1, 1, 1, 1]"
11409,1,1,2,0.6102227093489127,"[1, 0, 0, 1, 1, 0, 0, 1, 1, 0]"
11410,1,1,2,0.623105877414339,"[0, 0, 1, 0, 0, 1, 1, 0, 1, 1]"
11411,1,1,2,0.17169457590984616,"[0, 0, 0, 0, 0, 1, 0, 1, 0, 0]"
11412,1,1,2,0.00873307800274059,"[1, 0, 1, 0, 0, 0, 1, 0, 0, 0]"
11413,1,1,2,0.26227546725570194,"[0, 0, 0, 0, 1, 1, 1, 0, 0, 1]"
11414,1,1,2,0.6146057908512383,"[0, 0, 1, 0, 1, 1, 1, 0, 1, 1]"
11415,1,1,2,0.4504494081862007,"[0, 0, 1, 1, 1, 0, 1, 1, 0, 1]"
11416,1,1,2,0.23892893619908917,"[0, 0, 0, 1, 1, 1, 1, 0, 0, 1]"
11417,2,2,4,0.863667139260785,"[0, 0, 0, 0, 1, 1, 0, 0, 1, 1]"
11418,1,1,2,0.5183627559701303,"[0, 0, 0, 0, 1, 1, 0, 0, 0, 0]"
11419,1,1,2,0.08364664694854917,"[0, 1, 1, 1, 0, 0, 1, 1, 1, 1]"
11420,2,2,4,0.29939043102110174,"[1, 1, 0, 1, 0, 0, 1, 1, 0, 0]"
11421,1,1,2,0.13115823672021276,"[0, 0, 0, 0, 0, 1, 0, 1, 1, 0]"
11422,1,1,2,0.6963455777341463,"[0, 1, 1, 0, 1, 1, 0, 0, 0, 1]"
11423,1,1,2,0.5477849016763349,"[0, 1, 0, 0, 0, 0, 1, 0, 0, 0]"
11424,1,1,2,0.6322085369955522,"[0, 1, 1, 1, 1, 1, 0, 1, 0, 1]"
11425,1,1,2,0.394330335093957,"[1, 0, 1, 1, 0, 1, 1, 0, 1, 0]"
11426,1,1,2,0.7430931367672147,"[0, 1, 0, 0, 0, 0, 0, 0, 1, 0]"
11427,1,1,2,0.2490923236067536,"[1, 0, 1, 0, 0, 0, 0, 1, 1, 1]"
11428,1,1,2,0.6483083736187304,"[0, 1, 0, 1, 1, 0, 1, 1, 1, 0]"
11429,1,1,2,0.5468644889717885,"[0, 0, 1, 0, 1, 1, 1, 0, 1, 0]"
11430,1,1,2,0.06750043133884731,"[1, 0, 0, 0, 0, 0, 1, 0, 1, 1]"
11431,1,1,2,0.4471536547518785,"[1, 1, 1, 0, 1, 1, 1, 0, 1, 0]"
11432,1,1,2,0.9927093635345694,"[1, 1, 0, 0, 0, 1, 1, 1, 0, 1]"
11433,2,2,4,0.858731844575254,"[0, 1, 0, 1, 1, 1, 0, 1, 1, 0]"
11434,2,2,4,0.6662453717409655,"[1, 0, 1, 1, 1, 1, 0, 0, 0, 1]"
11435,1,1,2,0.9785051986133954,"[0, 1, 1, 1, 0, 1, 0, 0, 0, 0]"
11436,2,2,4,0.22359436872537186,"[0, 1, 0, 0, 1, 1, 0, 0, 0, 1]"
11437,1,1,2,0.18629486162232278,"[0, 0, 1, 1, 0, 0, 0, 0, 1, 0]"
11438,1,1,2,0.6812048260594954,"[1, 1, 1, 0, 1, 0, 1, 0, 1, 1]"
11439,1,1,2,0.38955629067567754,"[1, 0, 0, 0, 1, 0, 1, 0, 1, 0]"
11440,2,2,4,0.150833018719029,"[0, 1, 0, 1, 0, 1, 0, 1, 1, 1]"
11441,1,1,2,0.8410050250042207,"[0, 1, 1, 0, 1, 1, 0, 1, 0, 1]"
11442,1,1,2,0.24497484900310007,"[0, 0, 0, 0, 0, 0, 0, 0, 0, 0]"
11443,1,1,2,0.7085767989862367,"[1, 1, 1, 0, 0, 0, 1, 1, 1, 1]"
11444,1,1,2,0.34673081346596246,"[0, 1, 1, 0, 0, 0, 0, 1, 0, 0]"
11445,1,1,2,0.19688925709944782,"[0, 1, 1, 0, 0, 1, 0, 0, 0, 1]"
11446,1,1,2,0.9285119218298169,"[0, 0, 1, 0, 1, 0, 1, 0, 0, 0]"
11447,1,1,2,0.2486268101215836,"[1, 0, 0, 1, 0, 0, 1, 0, 0, 1]"
11448,1,1,2,0.669926632555033,"[0, 0, 0, 0, 0, 0, 0, 0, 1, 0]"
11449,1,1,2,0.11332360137613018,"[1, 1, 1, 0, 1, 0, 1, 0, 0, 0]"
11450,3,3,6,0.004481228596738829,"[1, 0, 1, 0, 1, 1, 1, 1, 0, 1]"
11451,1,1,2,0.6613919991356694,"[1, 1, 1, 1, 0, 0, 1, 1, 0, 0]"
11452,1,1,2,0.5701643540285294,"[0, 1, 1, 1, 1, 0, 0, 1, 0, 1]"
11453,1,1,2,0.07384242658734741,"[1, 0, 0, 0, 1, 1, 1, 0, 0, 0]"
11454,1,1,2,0.05496734762790556,"[0, 0, 0, 0, 0, 0, 1, 0, 1, 1]"
11455,1,1,2,0.4523009730087676,"[0, 0, 0, 1, 0, 0, 1, 0, 1, 1]"
11456,1,1,2,0.7167120994101096,"[0, 0, 0, 0, 0, 0, 1, 0, 0, 1]"
11457,1,1,2,0.6960602007680073,"[1, 1, 0, 1, 1, 0, 0, 0, 1, 0]"
11458,1,1,2,0.9642261187049974,"[0, 0, 1, 0, 1, 1, 0, 1, 0, 0]"
11459,1,1,2,0.5980695763210411,"[0, 1, 0, 1, 0, 0, 0, 0, 0, 1]"
11460,1,1,2,0.7507416103897896,"[0, 1, 0, 1, 1, 0, 0, 0, 1, 0]"
11461,3,3,6,0.874356724157145,"[1, 1, 0, 1, 1, 1, 0, 0, 0, 0]"
11462,2,2,4,0.4506148612844949,"[1, 1, 0, 1, 0, 0, 0, 0, 0, 1]"
11463,1,1,2,0.3811244921299498,"[1, 0, 0, 0, 1, 0, 1, 1, 0, 0]"
11464,1,1,2,0.07994819155351363,"[1, 1, 1, 0, 0, 0, 1, 0, 1, 0]"
11465,1,1,2,0.14911233176073913,"[1, 1, 0, 1, 1, 0, 1, 0, 1, 0]"
11466,1,1,2,0.5400682059414403,"[0, 0, 1, 1, 0, 1, 0, 1, 1, 0]"
11467,1,1,2,0.5346087571707605,"[1, 1, 0, 1, 0, 0, 0, 1, 0, 1]"
11468,1,1,2,0.0035075210624326836,"[0, 1, 1, 0, 0, 1, 1, 0, 0, 0]"
11469,1,1,2,0.9490702742210141,"[0, 1, 1, 0, 0, 1, 1, 0, 0, 1]"
11470,1,1,2,0.8326522260074702,"[1, 0, 0, 1, 1, 1, 0, 0, 1, 1]"
11471,2,2,4,0.42140114601926704,"[1, 1, 1, 1, 0, 1, 0, 1, 0, 1]"
11472,2,2,4,0.15907372086780336,"[0, 1, 0, 1, 0, 1, 1, 0, 0, 0]"
11473,2,2,4,0.5580978180231588,"[1, 0, 0, 1, 1, 0, 1, 0, 1, 1]"
11474,2,2,4,0.20084996892420903,"[1, 0, 1, 0, 1, 1, 1, 1, 1, 1]"
11475,1,1,2,0.866392247084995,"[0, 1, 1, 0, 0, 1, 1, 1, 0, 0]"
11476,2,2,4,0.16519091060364655,"[1, 1, 0, 0, 1, 0, 0, 1, 0, 0]"
11477,1,1,2,0.1605110520535904,"[0, 1, 0, 0, 1, 1, 1, 1, 0, 0]"
11478,1,1,2,0.14413031079740168,"[0, 1, 1, 1, 0, 1, 0, 0, 0, 0]"
11479,1,1,2,0.8622437737192589,"[0, 1, 0, 1, 1, 1, 1, 0, 1, 1]"
11480,1,1,2,0.6659786500793698,"[0, 1, 1, 1, 1, 1, 0, 1, 1, 1]"
11481,1,1,2,0.5271968755824246,"[1, 0, 0, 1, 0, 1, 0, 1, 0, 1]"
11482,1,1,2,0.4758439372753992,"[0, 1, 0, 1, 0, 0, 0, 1, 0, 1]"
11483,1,1,2,0.23762310048794644,"[1, 0, 0, 1, 0, 0, 0, 1, 0, 0]"
11484,1,1,2,0.5967519664284179,"[0, 0, 1, 1, 1, 0, 0, 1, 0, 0]"
11485,1,1,2,0.44532531396012176,"[0, 1, 0, 1, 0, 0, 0, 1, 0, 1]"
11486,2,2,4,0.928746228970973,"[1, 0, 0, 1, 1, 1, 1, 0, 1, 1]"
11487,1,1,2,0.09920320058520271,"[0, 0, 0, 0, 1, 1, 1, 0, 0, 1]"
11488,1,1,2,0.8410108179889536,"[1, 0, 0, 1, 1, 0, 1, 1, 0, 1]"
11489,1,1,2,0.7020364167271923,"[0, 0, 0, 1, 0, 1, 0, 0, 0, 1]"
11490,1,1,2,0.807079328689987,"[0, 1, 0, 1, 1, 1, 0, 1, 0, 0]"
11491,1,1,2,0.45449613778953246,"[1, 0, 1, 1, 1, 0, 1, 1, 0, 1]"
11492,1,1,2,0.07245667886056117,"[0, 1, 0, 1, 0, 0, 0, 0, 1, 1]"
11493,1,1,2,0.5827194055923938,"[0, 1, 0, 1, 0, 0, 0, 0, 1, 0]"
11494,1,1,2,0.8903033881449031,"[0, 0, 1, 1, 0, 1, 1, 1, 0, 1]"
11495,1,1,2,0.4134973176730137,"[0, 1, 1, 0, 1, 1, 1, 1, 1, 0]"
11496,1,1,2,0.2862749091998734,"[0, 1, 1, 1, 0, 0, 0, 0, 1, 0]"
11497,1,1,2,0.21713618686418656,"[0, 0, 1, 1, 1, 1, 0, 1, 0, 1]"
11498,1,1,2,0.4725768584473943,"[1, 0, 1, 1, 1, 0, 0, 0, 0, 1]"
11499,2,2,4,0.44462144507805645,"[1, 1, 1, 1, 0, 1, 0, 0, 0, 0]"
11500,2,2,4,0.004862088867562897,"[1, 1, 1, 1, 1, 1, 1, 0, 0, 0]"
11501,2,2,4,0.24504793870852049,"[0, 1, 1, 1, 0, 0, 0, 0, 1, 1]"
11502,1,1,2,0.42228502807935075,"[0, 0, 0, 0, 0, 0, 1, 0, 1, 0]"
11503,1,1,2,0.13827704831652454,"[1, 0, 0, 1, 1, 1, 0, 1, 1, 1]"
11504,1,1,2,0.1621363134481798,"[0, 1, 1, 1, 1, 1, 0, 1, 0, 0]"
11505,1,1,2,0.8138768224392104,"[0, 1, 0, 1, 0, 0, 0, 1, 0, 0]"
11506,2,2,4,0.6255050322642428,"[1, 1, 0, 1, 1, 1, 0, 0, 0, 0]"
11507,1,1,2,0.08607118300311245,"[0, 1, 0, 1, 1, 1, 0, 1, 1, 1]"
11508,1,1,2,0.8900324680175224,"[0, 0, 0, 0, 1, 1, 1, 0, 0, 0]"
11509,1,1,2,0.8889491231986145,"[0, 1, 1, 1, 0, 0, 1, 0, 1, 1]"
11510,1,1,2,0.9560097766034114,"[0, 0, 0, 0, 1, 0, 1, 0, 1, 0]"
11511,3,3,6,0.22827250593548143,"[1, 0, 1, 1, 0, 1, 0, 1, 1, 1]"
11512,2,2,4,0.3856179407602325,"[1, 1, 0, 0, 1, 1, 0, 0, 0, 0]"
11513,2,2,4,0.760432326680834,"[1, 0, 1, 1, 1, 0, 1, 0, 0, 1]"
11514,1,1,2,0.5307297673141212,"[0, 0, 0, 0, 1, 1, 1, 1, 0, 0]"
11515,1,1,2,0.7658781083951832,"[1, 0, 0, 0, 0, 0, 1, 1, 0, 0]"
11516,1,1,2,0.5263806398974193,"[1, 0, 0, 0, 1, 0, 0, 0, 1, 1]"
11517,1,1,2,0.6335363581087557,"[1, 1, 1, 1, 0, 1, 0, 1, 1, 1]"
11518,1,1,2,0.9339213333122505,"[0, 1, 1, 0, 1, 0, 0, 1, 1, 0]"
11519,1,1,2,0.9152805156665212,"[1, 0, 0, 1, 1, 1, 1, 0, 0, 0]"
11520,2,2,4,0.4787941578821553,"[1, 0, 1, 0, 0, 0, 0, 1, 1, 0]"
11521,1,1,2,0.7122745547422553,"[0, 1, 1, 1, 0, 1, 1, 1, 0, 1]"
11522,1,1,2,0.5188345082315904,"[1, 1, 0, 1, 0, 0, 0, 1, 0, 1]"
11523,1,1,2,0.3850688712047061,"[0, 1, 1, 1, 0, 0, 0, 1, 1, 1]"
11524,1,1,2,0.8325518185791896,"[1, 1, 1, 1, 0, 0, 1, 0, 0, 0]"
11525,1,1,2,0.749479545446359,"[0, 0, 1, 0, 1, 0, 0, 0, 0, 1]"
11526,1,1,2,0.249543770002444,"[1, 1, 1, 0, 1, 1, 1, 0, 0, 0]"
11527,2,2,4,0.584221465002311,"[1, 0, 1, 1, 0, 0, 0, 1, 1, 1]"
11528,1,1,2,0.8888677333635882,"[1, 1, 1, 0, 0, 1, 0, 1, 0, 1]"
11529,1,1,2,0.6881684098804683,"[1, 1, 1, 0, 1, 0, 1, 0, 0, 0]"
11530,1,1,2,0.042119787383560925,"[0, 0, 1, 1, 1, 1, 0, 0, 0, 1]"
11531,1,1,2,0.008285113712000802,"[1, 0, 0, 1, 0, 1, 0, 0, 0, 0]"
11532,1,1,2,0.8798142623697257,"[0, 1, 1, 1, 0, 0, 0, 0, 1, 0]"
11533,1,1,2,0.8714501491603841,"[1, 1, 1, 0, 1, 1, 0, 1, 0, 1]"
11534,1,1,2,0.6293677081476723,"[0, 0, 0, 0, 0, 1, 0, 0, 1, 0]"
11535,1,1,2,0.6942371736743038,"[1, 1, 0, 0, 1, 1, 0, 0, 0, 0]"
11536,2,2,4,0.6276326375730324,"[0, 1, 0, 1, 1, 0, 1, 1, 1, 1]"
11537,2,2,4,0.9171160188278771,"[0, 0, 0, 1, 0, 1, 0, 1, 0, 1]"
11538,1,1,2,0.6890449020704469,"[0, 0, 1, 1, 0, 0, 0, 0, 1, 0]"
11539,1,1,2,0.5733541756665844,"[0, 1, 1, 1, 0, 1, 0, 0, 0, 0]"
11540,1,1,2,0.3380549728268668,"[1, 0, 0, 0, 0, 0, 0, 1, 1, 1]"
11541,1,1,2,0.1307060668522988,"[0, 1, 0, 0, 1, 1, 0, 0, 0, 0]"
11542,1,1,2,0.5151214731583538,"[0, 1, 0, 1, 0, 0, 0, 0, 1, 1]"
11543,1,1,2,0.606267554812606,"[0, 1, 1, 1, 0, 1, 1, 0, 1, 0]"
11544,1,1,2,0.09961595776394905,"[0, 1, 1, 1, 0, 0, 0, 0, 1, 0]"
11545,1,1,2,0.8485140875274797,"[1, 0, 0, 1, 0, 1, 1, 0, 1, 1]"
11546,1,1,2,0.45673816159605163,"[0, 0, 1, 0, 1, 0, 0, 1, 0, 1]"
11547,1,1,2,0.0787159629205667,"[1, 0, 1, 1, 1, 1, 1, 1, 0, 1]"
11548,1,1,2,0.8256845325864963,"[1, 0, 0, 0, 1, 1, 1, 1, 0, 1]"
11549,1,1,2,0.1539359119540914,"[1, 1, 1, 0, 1, 1, 1, 0, 1, 0]"
11550,3,3,6,0.7562501676745768,"[1, 1, 1, 0, 1, 0, 0, 1, 1, 1]"
11551,4,4,8,0.6959361219937313,"[1, 1, 0, 1, 0, 1, 0, 1, 1, 1]"
11552,2,2,4,0.5691375427324504,"[0, 0, 1, 0, 1, 1, 1, 0, 1, 0]"
11553,1,1,2,0.6520813578940998,"[0, 0, 1, 1, 0, 1, 1, 1, 1, 0]"
11554,1,1,2,0.6850684253648444,"[1, 1, 1, 1, 1, 0, 0, 0, 1, 0]"
11555,1,1,2,0.12778007773397293,"[1, 1, 0, 0, 1, 0, 1, 0, 0, 1]"
11556,1,1,2,0.3757842585320912,"[1, 1, 0, 0, 0, 1, 0, 1, 0, 1]"
11557,1,1,2,0.8730233647812291,"[1, 1, 0, 1, 1, 1, 1, 0, 0, 0]"
11558,1,1,2,0.972157170652701,"[0, 0, 0, 1, 1, 0, 0, 1, 0, 0]"
11559,3,3,6,0.7442509217097975,"[0, 1, 1, 0, 0, 0, 1, 1, 1, 1]"
11560,1,1,2,0.6490865229434216,"[0, 0, 0, 0, 0, 1, 1, 0, 0, 0]"
11561,1,1,2,0.9340549023297459,"[1, 1, 0, 1, 0, 1, 0, 0, 1, 1]"
11562,1,1,2,0.7442751708794041,"[1, 0, 1, 0, 0, 0, 0, 0, 1, 1]"
11563,1,1,2,0.6820889168251976,"[1, 1, 1, 0, 1, 0, 0, 1, 1, 0]"
11564,1,1,2,0.857681905049431,"[1, 0, 0, 1, 1, 1, 0, 0, 0, 1]"
11565,3,3,6,0.5758249203926771,"[0, 0, 0, 1, 1, 1, 1, 0, 0, 1]"
11566,1,1,2,0.289486159541397,"[1, 0, 1, 1, 1, 1, 0, 0, 0, 0]"
11567,1,1,2,0.28455335524295367,"[1, 1, 0, 1, 0, 1, 0, 1, 1, 1]"
11568,1,1,2,0.9966793012642817,"[1, 1, 0, 0, 0, 0, 1, 0, 0, 1]"
11569,1,1,2,0.17153277014473955,"[1, 1, 1, 1, 0, 0, 0, 1, 1, 1]"
11570,1,1,2,0.8664255555727791,"[0, 0, 1, 1, 0, 0, 1, 0, 1, 1]"
11571,2,2,4,0.3883019428199046,"[1, 0, 0, 0, 0, 0, 1, 0, 0, 0]"
11572,1,1,2,0.0826779326884427,"[0, 0, 0, 1, 0, 0, 1, 0, 1, 0]"
11573,1,1,2,0.7274540907036396,"[1, 1, 1, 0, 0, 0, 1, 0, 1, 0]"
11574,2,2,4,0.4441723900606812,"[1, 1, 0, 1, 0, 1, 1, 1, 0, 0]"
11575,1,1,2,0.2614313637089306,"[0, 0, 1, 1, 0, 1, 1, 0, 0, 0]"
11576,1,1,2,0.26461995450703313,"[0, 0, 1, 1, 0, 0, 1, 0, 0, 1]"
11577,1,1,2,0.3216533620774503,"[0, 0, 1, 0, 0, 1, 0, 0, 1, 0]"
11578,1,1,2,0.9763139796178996,"[1, 1, 1, 0, 0, 0, 0, 0, 0, 0]"
11579,2,2,4,0.5953882760832083,"[0, 0, 0, 0, 0, 1, 0, 0, 1, 1]"
11580,1,1,2,0.9699307189206126,"[1, 0, 0, 0, 1, 1, 1, 0, 1, 1]"
11581,2,2,4,0.031853200033449824,"[1, 0, 1, 0, 0, 0, 1, 1, 1, 0]"
11582,1,1,2,0.4172210639110804,"[0, 1, 1, 1, 1, 0, 0, 0, 1, 1]"
11583,2,2,4,0.47425686563101366,"[1, 0, 0, 0, 0, 1, 0, 1, 0, 1]"
11584,1,1,2,0.6557338098074218,"[0, 1, 0, 0, 1, 0, 0, 0, 0, 0]"
11585,4,4,8,0.6503429873588914,"[0, 1, 1, 0, 1, 0, 1, 0, 1, 0]"
11586,1,1,2,0.8588862053624153,"[0, 0, 1, 1, 1, 1, 0, 1, 0, 0]"
11587,1,1,2,0.0937007317984262,"[1, 0, 1, 0, 0, 0, 0, 0, 0, 0]"
11588,1,1,2,0.8734958109643723,"[0, 1, 0, 0, 0, 1, 0, 0, 1, 1]"
11589,1,1,2,0.5964327362417733,"[0, 1, 1, 0, 1, 1, 1, 1, 1, 1]"
11590,1,1,2,0.8942138400067847,"[1, 0, 1, 1, 0, 1, 1, 0, 1, 0]"
11591,1,1,2,0.9164980560702041,"[1, 1, 0, 0, 1, 0, 1, 1, 0, 0]"
11592,1,1,2,0.2826351313128387,"[1, 1, 1, 0, 1, 1, 1, 0, 0, 0]"
11593,3,3,6,0.9104051742094101,"[0, 0, 0, 1, 0, 1, 1, 0, 0, 1]"
11594,1,1,2,0.8994961560025081,"[1, 1, 0, 1, 1, 0, 1, 1, 1, 1]"
11595,1,1,2,0.20455552663500665,"[0, 1, 1, 1, 0, 1, 1, 1, 0, 0]"
11596,1,1,2,0.5742012526239542,"[1, 0, 1, 1, 1, 1, 0, 1, 0, 1]"
11597,1,1,2,0.9202706123516091,"[1, 0, 1, 0, 0, 1, 0, 0, 0, 1]"
11598,1,1,2,0.08946589416541884,"[1, 0, 1, 1, 1, 0, 1, 1, 0, 1]"
11599,1,1,2,0.5832585942063278,"[1, 0, 0, 1, 0, 1, 0, 1, 1, 0]"
11600,1,1,2,0.30748826782554517,"[0, 1, 1, 1, 0, 1, 1, 1, 0, 0]"
11601,2,2,4,0.7214954828476816,"[1, 1, 0, 1, 1, 0, 0, 0, 1, 0]"
11602,1,1,2,0.3795945148098644,"[1, 1, 0, 0, 0, 0, 0, 0, 1, 0]"
11603,1,1,2,0.5167420630776448,"[0, 0, 1, 0, 0, 0, 0, 0, 0, 0]"
11604,1,1,2,0.3762807338978791,"[1, 0, 1, 1, 1, 1, 1, 0, 0, 0]"
11605,1,1,2,0.42814832919683643,"[1, 0, 0, 1, 1, 0, 0, 0, 1, 0]"
11606,1,1,2,0.30817052405275636,"[1, 0, 0, 1, 1, 1, 0, 1, 0, 1]"
11607,3,3,6,0.1561018845381712,"[1, 0, 0, 1, 1, 1, 1, 0, 1, 1]"
11608,2,2,4,0.39859404216457706,"[0, 1, 0, 0, 1, 0, 0, 1, 0, 1]"
11609,1,1,2,0.5378868301106494,"[0, 1, 1, 1, 1, 0, 0, 0, 0, 1]"
11610,1,1,2,0.04369721698746876,"[1, 1, 1, 0, 1, 0, 0, 0, 1, 0]"
11611,2,2,4,0.6661264573294426,"[0, 1, 0, 1, 0, 1, 0, 0, 1, 0]"
11612,1,1,2,0.5848621722726518,"[1, 1, 0, 1, 0, 1, 0, 1, 0, 0]"
11613,1,1,2,0.5040582765910566,"[0, 0, 1, 0, 0, 0, 1, 0, 1, 1]"
11614,1,1,2,0.9764649379775505,"[0, 0, 1, 0, 0, 0, 1, 0, 0, 0]"
11615,2,2,4,0.8802585908034212,"[1, 1, 1, 0, 0, 1, 0, 1, 1, 0]"
11616,1,1,2,0.04412198171913828,"[0, 0, 0, 0, 1, 0, 1, 1, 1, 0]"
11617,1,1,2,0.009590405901896415,"[1, 1, 0, 1, 1, 0, 1, 1, 0, 0]"
11618,3,3,6,0.16169164909073785,"[0, 0, 1, 1, 0, 1, 0, 1, 0, 1]"
11619,1,1,2,0.20240257634971492,"[1, 1, 0, 0, 1, 0, 0, 1, 0, 0]"
11620,1,1,2,0.7768299088669657,"[1, 1, 1, 0, 0, 1, 1, 1, 0, 0]"
11621,3,3,6,0.8817320543301704,"[0, 0, 1, 0, 0, 1, 0, 1, 1, 0]"
11622,2,2,4,0.8884200638540672,"[1, 0, 1, 0, 0, 0, 0, 1, 0, 1]"
11623,1,1,2,0.6225293703421285,"[0, 1, 0, 0, 0, 0, 0, 1, 0, 1]"
11624,1,1,2,0.14275042800335536,"[0, 1, 1, 1, 1, 0, 0, 0, 0, 1]"
11625,1,1,2,0.1332577425474537,"[0, 1, 0, 1, 1, 0, 1, 0, 1, 1]"
11626,1,1,2,0.5567172088329282,"[1, 1, 1, 1, 1, 1, 1, 1, 1, 1]"
11627,1,1,2,0.3716109673708622,"[0, 0, 1, 0, 0, 0, 0, 1, 0, 1]"
11628,1,1,2,0.5743596193937421,"[0, 1, 0, 0, 0, 0, 1, 0, 1, 1]"
11629,1,1,2,0.4550124406263807,"[1, 0, 0, 0, 1, 1, 0, 1, 1, 0]"
11630,2,2,4,0.9657514068923602,"[0, 0, 1, 0, 1, 1, 0, 1, 0, 0]"
11631,1,1,2,0.8609977619772461,"[1, 0, 0, 1, 0, 0, 0, 0, 1, 1]"
11632,1,1,2,0.8869117349242331,"[1, 0, 0, 1, 0, 0, 1, 0, 1, 1]"
11633,1,1,2,0.5192821682098845,"[1, 0, 0, 1, 1, 1, 0, 1, 1, 1]"
11634,1,1,2,0.22151731300595479,"[1, 1, 0, 1, 1, 0, 1, 1, 0, 0]"
11635,1,1,2,0.18020131140940854,"[1, 1, 0, 1, 1, 0, 1, 1, 1, 0]"
11636,3,3,6,0.27321503131565616,"[0, 0, 0, 1, 1, 0, 0, 1, 0, 1]"
11637,1,1,2,0.3818297416047688,"[0, 1, 0, 1, 1, 1, 1, 0, 1, 0]"
11638,1,1,2,0.8036619555497698,"[1, 0, 1, 1, 0, 0, 0, 0, 0, 0]"
11639,1,1,2,0.24525116127777014,"[1, 0, 1, 0, 1, 0, 1, 1, 1, 0]"
11640,1,1,2,0.2684816961443286,"[0, 1, 1, 0, 0, 0, 1, 0, 0, 1]"
11641,2,2,4,0.37300913026845595,"[0, 1, 1, 1, 0, 0, 1, 0, 1, 0]"
11642,3,3,6,0.09234248694875624,"[1, 1, 0, 1, 1, 0, 1, 0, 0, 1]"
11643,1,1,2,0.14865414256186926,"[1, 1, 0, 0, 1, 0, 1, 1, 1, 1]"
11644,1,1,2,0.6325819810832617,"[1, 0, 0, 1, 1, 0, 1, 1, 0, 1]"
11645,1,1,2,0.7551892465459763,"[0, 0, 0, 1, 0, 1, 1, 0, 0, 0]"
11646,1,1,2,0.32707161529029805,"[0, 0, 0, 1, 0, 0, 1, 1, 0, 1]"
11647,1,1,2,0.8120626600103538,"[1, 0, 1, 0, 0, 1, 1, 0, 0, 0]"
11648,1,1,2,0.21052907526441578,"[0, 1, 0, 0, 0, 0, 0, 1, 1, 0]"
11649,1,1,2,0.4128832934401194,"[1, 0, 1, 1, 0, 0, 1, 1, 1, 0]"
11650,1,1,2,0.5029277958484653,"[1, 1, 1, 0, 0, 0, 1, 1, 0, 0]"
11651,1,1,2,0.9918750280792936,"[1, 0, 1, 1, 1, 1, 1, 0, 1, 0]"
11652,1,1,2,0.44267133046482177,"[0, 0, 0, 1, 1, 0, 0, 1, 0, 1]"
11653,2,2,4,0.8058590080494671,"[1, 1, 0, 0, 0, 0, 0, 0, 1, 0]"
11654,1,1,2,0.3440469829233297,"[1, 0, 0, 1, 0, 1, 1, 1, 1, 1]"
11655,2,2,4,0.03251228462236677,"[0, 1, 0, 1, 1, 0, 0, 1, 1, 1]"
11656,3,3,6,0.15900161287398074,"[1, 1, 1, 1, 1, 1, 0, 1, 0, 0]"
11657,1,1,2,0.13546589282296884,"[0, 0, 1, 1, 0, 1, 1, 0, 1, 0]"
11658,2,2,4,0.06808395155025859,"[0, 1, 0, 0, 1, 1, 0, 1, 1, 0]"
11659,2,2,4,0.6850347342144818,"[1, 1, 0, 0, 1, 1, 0, 0, 0, 1]"
11660,2,2,4,0.5459804128424984,"[0, 1, 1, 1, 1, 1, 0, 1, 0, 1]"
11661,1,1,2,0.2562418772911691,"[1, 1, 1, 1, 0, 1, 1, 1, 0, 1]"
11662,1,1,2,0.8420585976067674,"[1, 0, 1, 0, 1, 0, 0, 0, 1, 1]"
11663,1,1,2,0.8674969146943604,"[0, 1, 0, 1, 1, 0, 0, 0, 1, 1]"
11664,1,1,2,0.30399877135454345,"[0, 0, 1, 0, 1, 1, 1, 1, 0, 0]"
11665,1,1,2,0.17330604186855425,"[1, 1, 1, 0, 0, 0, 1, 0, 1, 0]"
11666,1,1,2,0.3678065420484835,"[0, 1, 0, 0, 1, 1, 0, 0, 1, 0]"
11667,2,2,4,0.20385129136160096,"[0, 0, 0, 1, 1, 0, 1, 0, 1, 1]"
11668,1,1,2,0.45024054661929325,"[0, 1, 1, 0, 1, 1, 0, 1, 1, 0]"
11669,1,1,2,0.06487149519300861,"[0, 1, 0, 1, 0, 1, 1, 0, 1, 0]"
11670,1,1,2,0.07101833109494127,"[0, 1, 1, 1, 1, 1, 1, 0, 1, 0]"
11671,1,1,2,0.486718342367104,"[0, 0, 0, 1, 0, 0, 1, 0, 1, 0]"
11672,2,2,4,0.8825520816131109,"[0, 0, 1, 1, 0, 1, 0, 0, 0, 1]"
11673,1,1,2,0.23374629986800433,"[1, 0, 1, 1, 1, 1, 1, 1, 1, 0]"
11674,1,1,2,0.24845864837773002,"[1, 0, 1, 1, 1, 1, 0, 1, 0, 1]"
11675,2,2,4,0.6220833612777202,"[0, 0, 0, 1, 0, 1, 0, 1, 1, 1]"
11676,1,1,2,0.9383917774576297,"[0, 0, 0, 0, 1, 1, 0, 1, 0, 0]"
11677,1,1,2,0.49262818123165597,"[0, 1, 0, 0, 0, 1, 0, 0, 0, 1]"
11678,1,1,2,0.916600154178465,"[0, 1, 1, 1, 1, 1, 1, 1, 0, 1]"
11679,1,1,2,0.3931367773449367,"[0, 0, 1, 0, 0, 1, 0, 0, 1, 0]"
11680,1,1,2,0.36743829581431675,"[0, 1, 1, 1, 1, 1, 0, 0, 0, 1]"
11681,1,1,2,0.6700667235142289,"[1, 0, 1, 0, 0, 0, 1, 1, 0, 0]"
11682,3,3,6,0.967667735544976,"[1, 1, 0, 1, 1, 0, 1, 0, 1, 0]"
11683,1,1,2,0.6333046757302038,"[1, 1, 1, 1, 1, 0, 0, 0, 1, 0]"
11684,2,2,4,0.5629062678576409,"[1, 1, 0, 0, 1, 0, 0, 1, 1, 1]"
11685,1,1,2,0.5425063830459558,"[0, 1, 0, 0, 1, 0, 1, 1, 1, 0]"
11686,2,2,4,0.2791720750321851,"[1, 1, 0, 0, 1, 0, 1, 1, 0, 0]"
11687,1,1,2,0.819781481893207,"[0, 1, 0, 1, 1, 1, 1, 0, 0, 1]"
11688,1,1,2,0.5878094029260506,"[0, 0, 1, 0, 0, 0, 0, 0, 0, 1]"
11689,1,1,2,0.6126665546492791,"[1, 0, 0, 0, 1, 0, 0, 0, 0, 1]"
11690,1,1,2,0.11111111511752014,"[1, 1, 1, 0, 0, 0, 1, 1, 1, 0]"
11691,1,1,2,0.7280508270555662,"[0, 0, 0, 1, 1, 1, 1, 1, 1, 0]"
11692,1,1,2,0.31624619992985814,"[0, 1, 1, 0, 0, 0, 0, 1, 0, 1]"
11693,1,1,2,0.800148411905593,"[0, 1, 0, 1, 1, 0, 0, 0, 0, 0]"
11694,2,2,4,0.48580109971552143,"[1, 0, 0, 1, 0, 0, 1, 1, 0, 0]"
11695,1,1,2,0.011358060893292055,"[0, 1, 0, 1, 1, 1, 0, 1, 1, 0]"
11696,2,2,4,0.7078393258767912,"[1, 1, 0, 1, 0, 0, 1, 0, 0, 0]"
11697,1,1,2,0.7057439044520695,"[1, 1, 1, 0, 0, 0, 1, 1, 0, 1]"
11698,1,1,2,0.6272490992939362,"[0, 0, 1, 0, 1, 1, 1, 1, 0, 0]"
11699,1,1,2,0.09080181257319442,"[1, 0, 1, 1, 1, 0, 1, 0, 0, 0]"
11700,2,2,4,0.10111871963115393,"[1, 0, 1, 0, 0, 1, 0, 1, 1, 0]"
11701,1,1,2,0.10872404145994063,"[1, 0, 0, 0, 1, 0, 1, 0, 0, 1]"
11702,1,1,2,0.2503216221084881,"[0, 0, 0, 0, 1, 0, 0, 1, 0, 1]"
11703,1,1,2,0.10814043965094944,"[0, 0, 0, 1, 0, 0, 1, 0, 0, 0]"
11704,2,2,4,0.22765885051566603,"[1, 1, 0, 0, 0, 0, 1, 1, 0, 1]"
11705,1,1,2,0.23231740416834223,"[0, 1, 1, 1, 1, 0, 1, 1, 0, 0]"
11706,1,1,2,0.10102617557551086,"[1, 1, 1, 0, 1, 1, 0, 1, 1, 0]"
11707,1,1,2,0.797333504459025,"[0, 0, 0, 0, 0, 1, 0, 1, 1, 1]"
11708,1,1,2,0.005732591338206805,"[1, 1, 1, 1, 0, 0, 1, 1, 1, 1]"
11709,1,1,2,0.7132426504694536,"[0, 1, 0, 1, 1, 0, 1, 0, 0, 0]"
11710,1,1,2,0.4229137960646281,"[1, 0, 1, 1, 0, 0, 0, 0, 1, 1]"
11711,1,1,2,0.841800284643759,"[0, 1, 0, 1, 0, 0, 0, 0, 1, 0]"
11712,1,1,2,0.22282944896451884,"[0, 0, 0, 0, 1, 0, 1, 0, 0, 0]"
11713,1,1,2,0.8071917244344161,"[1, 1, 1, 1, 0, 0, 0, 0, 0, 1]"
11714,1,1,2,0.3633420319200309,"[1, 1, 1, 0, 0, 1, 0, 1, 0, 1]"
11715,1,1,2,0.4095000387296496,"[0, 0, 1, 0, 1, 1, 1, 0, 0, 1]"
11716,2,2,4,0.16916833979209278,"[1, 0, 0, 0, 0, 1, 1, 1, 0, 0]"
11717,1,1,2,0.9544103727410972,"[0, 1, 0, 1, 0, 0, 1, 0, 0, 0]"
11718,1,1,2,0.4315242179139619,"[0, 0, 0, 0, 1, 0, 0, 0, 0, 1]"
11719,1,1,2,0.5590635694219457,"[0, 1, 0, 0, 0, 1, 0, 0, 0, 1]"
11720,2,2,4,0.3415479206746068,"[0, 0, 0, 0, 0, 1, 1, 0, 1, 1]"
11721,2,2,4,0.6666852776537109,"[1, 1, 0, 0, 0, 0, 1, 0, 1, 1]"
11722,1,1,2,0.4378873010521982,"[1, 1, 1, 1, 1, 1, 0, 1, 1, 1]"
11723,1,1,2,0.530616556628192,"[0, 1, 1, 0, 1, 1, 0, 0, 0, 0]"
11724,1,1,2,0.03098477369366537,"[0, 0, 1, 0, 1, 0, 0, 0, 0, 0]"
11725,1,1,2,0.9050457652878263,"[1, 1, 0, 0, 1, 1, 1, 0, 0, 1]"
11726,1,1,2,0.3227839236469259,"[1, 0, 1, 0, 1, 0, 0, 0, 0, 1]"
11727,2,2,4,0.474062482437866,"[0, 1, 0, 0, 1, 0, 1, 0, 1, 0]"
11728,1,1,2,0.16530610842599247,"[0, 0, 1, 0, 1, 0, 1, 0, 1, 0]"
11729,1,1,2,0.02503129736253884,"[0, 0, 1, 0, 0, 1, 1, 0, 1, 0]"
11730,1,1,2,0.6527493213726664,"[1, 0, 0, 1, 0, 1, 1, 1, 1, 1]"
11731,1,1,2,0.1617016323973408,"[1, 1, 1, 1, 0, 0, 1, 1, 0, 1]"
11732,5,5,10,0.5680790963014442,"[1, 1, 1, 1, 1, 1, 1, 1, 0, 1]"
11733,1,1,2,0.4113647834343215,"[0, 1, 0, 1, 0, 0, 0, 1, 1, 0]"
11734,2,2,4,0.595802718289668,"[0, 0, 1, 1, 0, 0, 0, 0, 1, 0]"
11735,1,1,2,0.4505575650515383,"[0, 0, 1, 0, 0, 1, 1, 0, 1, 1]"
11736,1,1,2,0.07228230917273071,"[1, 1, 1, 0, 0, 1, 0, 0, 0, 1]"
11737,1,1,2,0.055696553821269035,"[1, 1, 0, 1, 1, 1, 1, 1, 0, 1]"
11738,2,2,4,0.3636598364707425,"[1, 1, 1, 1, 1, 1, 1, 1, 1, 1]"
11739,2,2,4,0.4239966188528953,"[1, 0, 0, 0, 1, 1, 0, 1, 1, 0]"
11740,1,1,2,0.4716239634160164,"[1, 1, 0, 0, 0, 0, 1, 1, 1, 1]"
11741,1,1,2,0.9466445626860922,"[0, 0, 1, 0, 0, 1, 0, 1, 1, 1]"
11742,1,1,2,0.7663910345410556,"[0, 1, 1, 1, 0, 0, 0, 0, 0, 0]"
11743,1,1,2,0.4573745100227724,"[0, 0, 1, 1, 0, 1, 1, 0, 0, 0]"
11744,1,1,2,0.9586898210048658,"[1, 1, 1, 0, 0, 0, 0, 0, 1, 1]"
11745,1,1,2,0.9396108174629767,"[1, 1, 1, 0, 1, 1, 1, 0, 1, 1]"
11746,1,1,2,0.8102120910225248,"[1, 1, 1, 0, 0, 1, 1, 0, 1, 0]"
11747,1,1,2,0.9730972351589731,"[1, 1, 0, 0, 0, 1, 1, 0, 0, 0]"
11748,1,1,2,0.9969072909158463,"[0, 0, 0, 0, 0, 0, 0, 1, 1, 1]"
11749,1,1,2,0.6412214633918024,"[0, 1, 0, 1, 1, 1, 1, 1, 0, 0]"
11750,1,1,2,0.4869071771360378,"[1, 1, 0, 1, 1, 0, 0, 0, 1, 1]"
11751,1,1,2,0.7046494335191755,"[0, 0, 1, 1, 0, 0, 1, 0, 1, 0]"
11752,1,1,2,0.8926618547497275,"[0, 0, 0, 0, 0, 0, 1, 1, 0, 0]"
11753,2,2,4,0.33219933782315025,"[1, 1, 0, 1, 1, 0, 1, 1, 1, 0]"
11754,1,1,2,0.7563716563642013,"[0, 1, 0, 0, 1, 0, 1, 0, 0, 0]"
11755,1,1,2,0.8289348039316765,"[1, 0, 1, 1, 1, 1, 1, 0, 1, 1]"
11756,1,1,2,0.2962665909531559,"[1, 0, 0, 1, 0, 1, 0, 0, 1, 0]"
11757,2,2,4,0.2921670923193681,"[0, 0, 1, 1, 1, 0, 1, 0, 0, 0]"
11758,1,1,2,0.5714347071609273,"[1, 1, 1, 0, 1, 0, 0, 1, 1, 0]"
11759,2,2,4,0.5941061198840867,"[1, 1, 1, 1, 1, 1, 1, 1, 0, 1]"
11760,2,2,4,0.6602999898269062,"[0, 0, 1, 0, 0, 0, 0, 1, 0, 1]"
11761,1,1,2,0.12420166083180306,"[1, 1, 1, 1, 0, 1, 0, 1, 0, 1]"
11762,2,2,4,0.129814248508079,"[0, 0, 1, 0, 1, 1, 1, 1, 0, 1]"
11763,1,1,2,0.3321237950282582,"[0, 1, 1, 1, 1, 0, 0, 1, 1, 1]"
11764,2,2,4,0.15582949541828106,"[0, 0, 1, 1, 1, 1, 1, 0, 0, 0]"
11765,3,3,6,0.9960009943778496,"[1, 0, 1, 0, 0, 0, 0, 0, 0, 1]"
11766,1,1,2,0.8797931427606578,"[1, 0, 0, 1, 1, 1, 0, 0, 1, 0]"
11767,2,2,4,0.44080417228967217,"[1, 0, 1, 0, 0, 1, 1, 1, 0, 1]"
11768,1,1,2,0.7373882074340339,"[1, 0, 1, 0, 1, 0, 0, 0, 0, 0]"
11769,1,1,2,0.5483915579506053,"[1, 1, 0, 0, 1, 0, 1, 1, 0, 0]"
11770,1,1,2,0.62641335792853,"[1, 1, 1, 1, 1, 0, 1, 1, 0, 1]"
11771,1,1,2,0.12278864514331833,"[1, 0, 0, 0, 0, 0, 0, 0, 0, 0]"
11772,1,1,2,0.5828643677324012,"[0, 0, 0, 1, 1, 1, 1, 1, 0, 0]"
11773,2,2,4,0.6504808440142393,"[1, 1, 0, 0, 1, 1, 1, 1, 1, 0]"
11774,1,1,2,0.7729662424664261,"[1, 1, 1, 1, 1, 0, 0, 1, 1, 1]"
11775,1,1,2,0.8504019095377364,"[1, 0, 1, 0, 0, 0, 1, 1, 0, 1]"
11776,1,1,2,0.13961827821957784,"[0, 0, 1, 0, 0, 1, 0, 0, 1, 1]"
11777,1,1,2,0.2965627190168658,"[1, 0, 1, 0, 1, 1, 1, 0, 0, 1]"
11778,2,2,4,0.0052801075074782045,"[1, 1, 0, 0, 1, 1, 0, 1, 1, 1]"
11779,2,2,4,0.9321374867253376,"[1, 0, 1, 0, 1, 1, 0, 0, 0, 1]"
11780,2,2,4,0.5620252854357127,"[1, 0, 0, 1, 0, 1, 0, 0, 0, 1]"
11781,1,1,2,0.847515885169203,"[0, 1, 0, 0, 0, 1, 0, 0, 1, 0]"
11782,1,1,2,0.6237102541087954,"[0, 1, 1, 1, 1, 0, 0, 0, 0, 1]"
11783,1,1,2,0.880502612388225,"[0, 1, 1, 1, 1, 0, 1, 0, 1, 1]"
11784,1,1,2,0.4286943278031746,"[1, 0, 0, 1, 0, 1, 1, 0, 1, 1]"
11785,1,1,2,0.2060377537508955,"[1, 0, 0, 1, 1, 1, 0, 0, 0, 1]"
11786,1,1,2,0.22030031205043643,"[0, 1, 0, 0, 1, 1, 0, 1, 1, 0]"
11787,1,1,2,0.24342367775137597,"[1, 1, 0, 1, 1, 0, 0, 1, 0, 1]"
11788,1,1,2,0.544164328195046,"[1, 0, 0, 1, 1, 1, 1, 0, 1, 0]"
11789,1,1,2,0.36959105118553515,"[0, 1, 0, 1, 1, 1, 1, 1, 1, 0]"
11790,1,1,2,0.22311264281942877,"[0, 1, 0, 0, 1, 1, 1, 1, 0, 1]"
11791,1,1,2,0.19543981176282776,"[1, 1, 0, 0, 1, 0, 1, 1, 0, 0]"
11792,1,1,2,0.7763292410289317,"[0, 1, 0, 1, 0, 0, 0, 0, 1, 1]"
11793,1,1,2,0.5185095492951856,"[1, 0, 0, 0, 0, 1, 0, 0, 0, 0]"
11794,1,1,2,0.5815043030147651,"[1, 0, 0, 1, 1, 1, 0, 1, 0, 1]"
11795,1,1,2,0.852542293301162,"[0, 1, 1, 1, 1, 0, 1, 0, 0, 1]"
11796,2,2,4,0.9955538010941947,"[0, 1, 0, 1, 1, 1, 1, 0, 0, 1]"
11797,2,2,4,0.44144899618203826,"[0, 1, 0, 0, 0, 0, 0, 1, 1, 0]"
11798,1,1,2,0.5407421756745906,"[0, 1, 1, 1, 1, 1, 1, 0, 1, 0]"
11799,1,1,2,0.35010013372345516,"[1, 1, 1, 1, 0, 0, 0, 0, 0, 1]"
11800,2,2,4,0.7119385896126742,"[1, 0, 0, 0, 1, 1, 1, 1, 1, 1]"
11801,1,1,2,0.8625848910114602,"[1, 0, 0, 0, 0, 1, 1, 0, 1, 1]"
11802,1,1,2,0.3197669369500973,"[0, 0, 1, 1, 0, 0, 1, 0, 1, 1]"
11803,1,1,2,0.2984350124796117,"[0, 1, 1, 0, 0, 0, 0, 1, 1, 0]"
11804,2,2,4,0.1091669002939234,"[1, 1, 1, 1, 0, 1, 1, 1, 1, 1]"
11805,1,1,2,0.31074374745579025,"[0, 1, 1, 1, 0, 1, 1, 1, 1, 1]"
11806,1,1,2,0.6050712488991196,"[1, 1, 1, 1, 0, 1, 1, 1, 1, 1]"
11807,1,1,2,0.5107974188894191,"[1, 1, 0, 0, 1, 0, 1, 1, 0, 0]"
11808,3,3,6,0.14324423430700317,"[1, 1, 0, 1, 1, 0, 1, 1, 0, 1]"
11809,1,1,2,0.9508803310453796,"[0, 0, 0, 0, 0, 1, 1, 1, 0, 0]"
11810,1,1,2,0.6223008464337256,"[1, 0, 1, 0, 1, 1, 1, 0, 1, 1]"
11811,1,1,2,0.17028010805176674,"[0, 0, 0, 0, 0, 1, 1, 1, 0, 1]"
11812,1,1,2,0.27975034132980237,"[0, 0, 0, 0, 1, 1, 1, 0, 0, 1]"
11813,1,1,2,0.4437369903590508,"[1, 1, 0, 0, 1, 1, 0, 0, 0, 1]"
11814,1,1,2,0.16111323701318248,"[1, 1, 0, 1, 1, 0, 1, 1, 1, 1]"
11815,1,1,2,0.29387904820076105,"[0, 0, 1, 1, 0, 1, 1, 1, 1, 0]"
11816,1,1,2,0.26714123751578667,"[0, 1, 1, 1, 1, 1, 0, 0, 1, 1]"
11817,1,1,2,0.4186574589709532,"[1, 1, 1, 1, 1, 1, 0, 0, 0, 0]"
11818,1,1,2,0.518707916617057,"[1, 0, 1, 0, 1, 0, 1, 1, 1, 0]"
11819,1,1,2,0.47801740118274316,"[1, 1, 0, 0, 1, 1, 0, 0, 1, 1]"
11820,1,1,2,0.4914593218379918,"[1, 0, 0, 1, 1, 0, 1, 1, 0, 1]"
11821,1,1,2,0.2658990656888941,"[1, 0, 0, 1, 0, 0, 0, 1, 1, 1]"
11822,1,1,2,0.01923006972423358,"[1, 0, 1, 0, 0, 0, 0, 1, 1, 1]"
11823,1,1,2,0.6800032601891338,"[1, 0, 0, 1, 0, 1, 0, 1, 0, 1]"
11824,1,1,2,0.781748613358967,"[0, 1, 1, 1, 0, 0, 0, 1, 1, 1]"
11825,1,1,2,0.5168621034249122,"[1, 1, 0, 1, 1, 1, 1, 1, 0, 1]"
11826,1,1,2,0.09415837073552469,"[1, 1, 0, 0, 0, 1, 0, 1, 1, 0]"
11827,1,1,2,0.3962265952531142,"[0, 0, 1, 0, 0, 0, 1, 0, 0, 1]"
11828,2,2,4,0.2978935197483803,"[1, 1, 0, 0, 0, 1, 1, 0, 1, 1]"
11829,1,1,2,0.6585842258307667,"[1, 1, 0, 0, 0, 0, 0, 0, 0, 0]"
11830,1,1,2,0.22372129052092304,"[1, 0, 1, 1, 0, 1, 1, 0, 0, 1]"
11831,1,1,2,0.6608994694373609,"[0, 0, 1, 1, 1, 1, 1, 0, 1, 0]"
11832,1,1,2,0.9310397412213385,"[0, 1, 1, 0, 1, 0, 1, 0, 0, 0]"
11833,1,1,2,0.4149758920534733,"[1, 0, 1, 1, 1, 0, 0, 1, 0, 1]"
11834,1,1,2,0.36158047068153143,"[1, 1, 0, 0, 1, 0, 0, 1, 0, 1]"
11835,1,1,2,0.5952605695610295,"[0, 1, 1, 0, 0, 1, 0, 0, 0, 1]"
11836,1,1,2,0.7188652554568734,"[0, 1, 1, 0, 1, 0, 0, 1, 0, 0]"
11837,1,1,2,0.7973561124163796,"[0, 0, 1, 0, 0, 1, 0, 1, 0, 0]"
11838,1,1,2,0.24866795425444654,"[1, 1, 1, 0, 0, 0, 0, 0, 1, 1]"
11839,1,1,2,0.7183750409654386,"[0, 1, 0, 0, 1, 1, 1, 0, 1, 1]"
11840,1,1,2,0.4105602300512786,"[1, 0, 0, 0, 0, 0, 0, 0, 0, 1]"
11841,1,1,2,0.8288694698811279,"[0, 1, 1, 0, 0, 0, 1, 1, 1, 0]"
11842,1,1,2,0.40054182215121825,"[1, 0, 0, 0, 0, 1, 1, 1, 0, 0]"
11843,1,1,2,0.9356284679848034,"[0, 0, 1, 1, 1, 0, 0, 1, 0, 0]"
11844,1,1,2,0.8300938465913963,"[0, 1, 0, 0, 1, 1, 0, 0, 0, 0]"
11845,1,1,2,0.9498208720920854,"[0, 0, 0, 1, 1, 0, 0, 0, 0, 1]"
11846,2,2,4,0.4826541212195975,"[1, 0, 0, 0, 0, 0, 0, 1, 1, 0]"
11847,1,1,2,0.3090176027549537,"[0, 1, 0, 1, 1, 1, 1, 0, 1, 0]"
11848,1,1,2,0.04525174369878493,"[1, 0, 0, 0, 1, 0, 0, 1, 0, 1]"
11849,1,1,2,0.7034758577543895,"[0, 0, 0, 0, 1, 1, 0, 1, 0, 0]"
11850,1,1,2,0.3204121552685215,"[0, 0, 0, 1, 1, 0, 0, 0, 1, 0]"
11851,1,1,2,0.5158197516651952,"[1, 0, 1, 1, 0, 0, 1, 0, 1, 1]"
11852,1,1,2,0.8746176820777628,"[0, 0, 1, 1, 1, 1, 1, 1, 1, 1]"
11853,1,1,2,0.4474875643444912,"[1, 0, 1, 0, 0, 0, 0, 1, 0, 1]"
11854,2,2,4,0.37444165547057795,"[1, 0, 1, 0, 1, 1, 1, 1, 0, 0]"
11855,1,1,2,0.24997641263409276,"[1, 1, 0, 0, 0, 1, 1, 0, 1, 0]"
11856,1,1,2,0.22561720076339586,"[1, 0, 0, 0, 0, 0, 1, 1, 0, 0]"
11857,1,1,2,0.22435314304736953,"[0, 1, 1, 1, 1, 1, 1, 0, 1, 0]"
11858,1,1,2,0.00906119775145997,"[0, 1, 1, 0, 0, 0, 0, 1, 1, 0]"
11859,1,1,2,0.7854714729261556,"[1, 0, 1, 0, 1, 1, 0, 0, 0, 0]"
11860,1,1,2,0.5499220913268278,"[0, 1, 0, 0, 1, 1, 1, 0, 0, 1]"
11861,3,3,6,0.7468965973624845,"[0, 0, 1, 1, 0, 1, 1, 1, 0, 1]"
11862,2,2,4,0.46982040698539074,"[0, 1, 0, 1, 0, 1, 1, 0, 0, 0]"
11863,1,1,2,0.6095954356412355,"[0, 0, 0, 1, 1, 0, 0, 0, 1, 0]"
11864,1,1,2,0.8341488470041505,"[1, 0, 1, 1, 0, 0, 0, 1, 1, 1]"
11865,3,3,6,0.5915978115995696,"[1, 1, 0, 0, 1, 0, 0, 0, 1, 0]"
11866,1,1,2,0.6681887220834817,"[0, 0, 1, 1, 0, 1, 0, 1, 1, 0]"
11867,2,2,4,0.3202495159107316,"[1, 0, 0, 1, 0, 0, 0, 0, 0, 0]"
11868,1,1,2,0.17400481110630162,"[0, 1, 1, 0, 1, 0, 1, 0, 0, 0]"
11869,1,1,2,0.7746400048619124,"[0, 0, 0, 0, 0, 1, 0, 0, 1, 1]"
11870,2,2,4,0.8954214476549371,"[1, 1, 1, 0, 1, 1, 1, 0, 1, 0]"
11871,1,1,2,0.9439276583057089,"[0, 1, 0, 1, 1, 0, 0, 0, 1, 0]"
11872,2,2,4,0.9291871346477033,"[0, 1, 1, 0, 1, 0, 0, 1, 0, 0]"
11873,2,2,4,0.0239939884460455,"[0, 1, 0, 1, 0, 0, 0, 1, 1, 1]"
11874,1,1,2,0.03197947365334586,"[1, 0, 0, 0, 1, 1, 1, 0, 0, 0]"
11875,1,1,2,0.24450402591797316,"[1, 0, 0, 1, 1, 0, 1, 1, 0, 1]"
11876,1,1,2,0.2557502620984573,"[1, 0, 1, 0, 1, 0, 1, 1, 1, 1]"
11877,2,2,4,0.402039486833349,"[0, 0, 0, 1, 1, 0, 1, 0, 1, 1]"
11878,3,3,6,0.6678813144003729,"[1, 0, 1, 1, 1, 0, 1, 0, 1, 1]"
11879,1,1,2,0.5152040139161216,"[1, 0, 0, 1, 0, 1, 0, 1, 1, 0]"
11880,1,1,2,0.11968257543952854,"[1, 0, 0, 0, 1, 1, 1, 0, 1, 1]"
11881,3,3,6,0.9454621003180154,"[1, 1, 0, 1, 0, 1, 0, 1, 1, 0]"
11882,1,1,2,0.12126210005742077,"[1, 1, 0, 0, 1, 1, 1, 0, 1, 1]"
11883,2,2,4,0.4559024105490349,"[0, 1, 1, 1, 0, 0, 0, 0, 1, 0]"
11884,1,1,2,0.16294619147662603,"[0, 0, 1, 1, 0, 0, 0, 0, 0, 0]"
11885,4,4,8,0.13253869160885556,"[1, 1, 1, 1, 1, 1, 1, 0, 0, 1]"
11886,1,1,2,0.7088309580991583,"[1, 0, 0, 0, 0, 1, 0, 0, 0, 0]"
11887,1,1,2,0.20293959232613434,"[1, 1, 1, 1, 1, 0, 1, 0, 0, 0]"
11888,2,2,4,0.3417148656813408,"[0, 1, 0, 0, 1, 1, 1, 1, 1, 0]"
11889,1,1,2,0.09132882424892108,"[1, 1, 0, 0, 1, 1, 1, 0, 1, 0]"
11890,1,1,2,0.7247527135028703,"[0, 0, 0, 0, 0, 1, 0, 1, 1, 1]"
11891,1,1,2,0.03930492357231219,"[0, 1, 0, 0, 0, 1, 1, 0, 0, 1]"
11892,1,1,2,0.6557590903131008,"[1, 1, 1, 0, 1, 0, 1, 0, 1, 0]"
11893,1,1,2,0.6956878142852784,"[0, 0, 0, 1, 0, 1, 0, 1, 0, 1]"
11894,1,1,2,0.31202751125256767,"[0, 0, 1, 1, 0, 1, 0, 1, 1, 1]"
11895,1,1,2,0.3064833297355003,"[0, 1, 0, 1, 1, 0, 1, 1, 1, 0]"
11896,1,1,2,0.28905591911330486,"[1, 0, 0, 0, 0, 1, 0, 0, 1, 1]"
11897,1,1,2,0.9311011028395332,"[0, 0, 0, 1, 0, 1, 0, 0, 1, 1]"
11898,2,2,4,0.9270217456802039,"[0, 1, 0, 1, 1, 1, 1, 1, 1, 1]"
11899,2,2,4,0.7153328149495131,"[1, 0, 0, 0, 1, 0, 0, 0, 1, 0]"
11900,1,1,2,0.699561417752928,"[0, 1, 0, 1, 1, 1, 1, 1, 1, 0]"
11901,1,1,2,0.22840163364252808,"[0, 0, 1, 0, 0, 0, 0, 1, 0, 0]"
11902,1,1,2,0.028166002178990235,"[0, 0, 1, 0, 1, 0, 0, 1, 1, 1]"
11903,1,1,2,0.905144313959986,"[0, 0, 1, 1, 1, 1, 1, 0, 0, 1]"
11904,1,1,2,0.39044767772885325,"[0, 0, 0, 0, 1, 0, 1, 0, 1, 1]"
11905,1,1,2,0.42762502873012265,"[1, 0, 0, 0, 0, 1, 1, 0, 0, 0]"
11906,2,2,4,0.05051093255636041,"[0, 0, 1, 1, 1, 1, 0, 1, 0, 0]"
11907,1,1,2,0.06493545949685564,"[1, 0, 0, 1, 1, 0, 0, 1, 1, 0]"
11908,2,2,4,0.8421165337847163,"[0, 0, 1, 1, 0, 1, 1, 1, 0, 1]"
11909,1,1,2,0.6108245284312926,"[1, 1, 0, 1, 0, 1, 1, 0, 1, 1]"
11910,1,1,2,0.5460689902620253,"[0, 0, 0, 1, 0, 0, 1, 0, 0, 1]"
11911,1,1,2,0.2793904718667629,"[0, 0, 1, 0, 0, 0, 1, 1, 1, 0]"
11912,2,2,4,0.8831012355832515,"[1, 1, 1, 0, 1, 1, 1, 0, 0, 0]"
11913,1,1,2,0.09971614334284984,"[1, 1, 1, 0, 1, 1, 0, 0, 1, 1]"
11914,1,1,2,0.7609630683026501,"[0, 0, 1, 1, 1, 1, 0, 0, 1, 0]"
11915,1,1,2,0.7598427975362757,"[1, 0, 1, 1, 0, 0, 0, 0, 0, 0]"
11916,3,3,6,0.28644519143934866,"[1, 1, 0, 1, 1, 0, 1, 0, 1, 0]"
11917,1,1,2,0.5043264612103237,"[0, 0, 1, 0, 1, 0, 0, 1, 0, 0]"
11918,1,1,2,0.5756846212390967,"[0, 0, 1, 0, 1, 1, 1, 1, 1, 1]"
11919,1,1,2,0.8584310004075165,"[1, 0, 1, 0, 0, 1, 0, 0, 1, 0]"
11920,1,1,2,0.9722475446733627,"[1, 0, 1, 1, 0, 0, 1, 1, 1, 0]"
11921,1,1,2,0.6958191531146934,"[1, 1, 0, 0, 0, 0, 1, 0, 1, 0]"
11922,2,2,4,0.6299932830863813,"[1, 1, 1, 0, 0, 1, 1, 0, 1, 0]"
11923,3,3,6,0.3332069563939567,"[1, 0, 1, 1, 1, 1, 1, 1, 1, 0]"
11924,1,1,2,0.8280657452836787,"[1, 0, 1, 0, 1, 0, 0, 0, 0, 0]"
11925,3,3,6,0.2233710749580976,"[1, 0, 1, 1, 1, 1, 1, 1, 0, 0]"
11926,1,1,2,0.21605052692696458,"[1, 0, 0, 1, 1, 1, 0, 0, 0, 1]"
11927,3,3,6,0.614839786222336,"[0, 1, 1, 1, 1, 1, 0, 1, 0, 1]"
11928,1,1,2,0.8166541430771727,"[0, 1, 1, 1, 0, 1, 1, 0, 0, 1]"
11929,1,1,2,0.15353719598397508,"[1, 1, 0, 1, 0, 1, 0, 0, 1, 1]"
11930,1,1,2,0.8583832171713336,"[1, 0, 1, 0, 1, 1, 0, 1, 1, 1]"
11931,1,1,2,0.53188781660886,"[0, 0, 0, 1, 0, 1, 1, 0, 0, 0]"
11932,2,2,4,0.3189779362940274,"[1, 0, 1, 1, 0, 1, 1, 1, 1, 1]"
11933,1,1,2,0.032196879492528474,"[0, 0, 0, 1, 1, 1, 0, 0, 0, 1]"
11934,1,1,2,0.04318800002463452,"[0, 1, 1, 1, 0, 1, 0, 1, 1, 1]"
11935,1,1,2,0.5707181452032362,"[1, 0, 0, 0, 1, 1, 0, 0, 0, 0]"
11936,1,1,2,0.8586966247508766,"[0, 1, 1, 1, 1, 1, 0, 1, 0, 1]"
11937,1,1,2,0.44656725884446147,"[0, 0, 1, 1, 1, 0, 1, 0, 1, 1]"
11938,2,2,4,0.7555771480365068,"[0, 1, 1, 1, 0, 1, 1, 1, 1, 1]"
11939,1,1,2,0.52248466437935,"[1, 1, 0, 1, 1, 1, 0, 1, 0, 0]"
11940,1,1,2,0.7017803498108326,"[1, 0, 0, 0, 0, 0, 0, 0, 1, 0]"
11941,2,2,4,0.15884083706067664,"[0, 1, 1, 1, 1, 1, 1, 1, 1, 0]"
11942,3,3,6,0.22472616619185004,"[1, 1, 1, 0, 1, 1, 1, 1, 0, 1]"
11943,1,1,2,0.001622815563298352,"[0, 1, 1, 0, 0, 1, 0, 0, 1, 1]"
11944,1,1,2,0.31719036873145345,"[1, 1, 0, 0, 1, 0, 0, 0, 0, 1]"
11945,2,2,4,0.439845594310454,"[1, 1, 0, 1, 1, 1, 1, 0, 1, 0]"
11946,1,1,2,0.9875289269877336,"[1, 1, 0, 0, 1, 0, 1, 1, 1, 0]"
11947,1,1,2,0.1712815607833763,"[0, 1, 0, 1, 0, 1, 1, 1, 1, 0]"
11948,1,1,2,0.867961641372774,"[1, 0, 1, 0, 0, 1, 1, 1, 0, 1]"
11949,1,1,2,0.23779566100516247,"[1, 1, 1, 0, 0, 1, 1, 1, 0, 0]"
11950,2,2,4,0.5750411482054139,"[0, 0, 1, 1, 0, 0, 1, 1, 1, 1]"
11951,1,1,2,0.569452754451582,"[0, 0, 0, 0, 0, 0, 0, 1, 1, 1]"
11952,2,2,4,0.04598755358598994,"[0, 0, 1, 0, 1, 0, 0, 0, 1, 0]"
11953,1,1,2,0.46471266183568993,"[1, 0, 1, 0, 0, 1, 0, 1, 1, 0]"
11954,1,1,2,0.6493392171129004,"[0, 0, 0, 0, 0, 0, 0, 0, 0, 0]"
11955,1,1,2,0.05722056125894004,"[1, 1, 1, 1, 1, 0, 1, 1, 0, 1]"
11956,1,1,2,0.7695757977473333,"[0, 0, 1, 1, 0, 0, 0, 0, 0, 0]"
11957,1,1,2,0.7409726964150612,"[0, 0, 0, 0, 1, 1, 0, 1, 1, 1]"
11958,1,1,2,0.08277660287427635,"[0, 1, 1, 0, 1, 0, 0, 0, 0, 0]"
11959,2,2,4,0.9553065199283196,"[0, 0, 1, 1, 0, 0, 1, 1, 1, 0]"
11960,1,1,2,0.11623095961532515,"[1, 1, 0, 0, 0, 1, 0, 0, 1, 0]"
11961,2,2,4,0.8555209824047387,"[1, 1, 1, 1, 1, 1, 0, 1, 0, 1]"
11962,1,1,2,0.7900556928502178,"[1, 0, 0, 0, 0, 0, 1, 1, 0, 0]"
11963,1,1,2,0.2674847399501755,"[0, 1, 0, 1, 1, 1, 0, 0, 0, 0]"
11964,1,1,2,0.7069934235580511,"[1, 1, 1, 0, 0, 0, 1, 1, 1, 0]"
11965,2,2,4,0.7122099226208912,"[0, 1, 0, 1, 0, 1, 1, 1, 1, 1]"
11966,1,1,2,0.14143944998424485,"[1, 1, 0, 1, 0, 1, 0, 0, 0, 0]"
11967,1,1,2,0.49499270611460433,"[1, 0, 1, 0, 0, 1, 0, 1, 1, 1]"
11968,1,1,2,0.7565621137402531,"[0, 0, 0, 0, 1, 0, 1, 0, 1, 1]"
11969,1,1,2,0.7595026159170044,"[0, 0, 0, 1, 1, 0, 0, 1, 0, 1]"
11970,1,1,2,0.3865807058904266,"[0, 1, 0, 0, 0, 0, 1, 0, 1, 0]"
11971,1,1,2,0.5595185565255517,"[0, 1, 0, 0, 0, 0, 1, 1, 0, 1]"
11972,1,1,2,0.9768866380028712,"[1, 1, 1, 0, 1, 1, 1, 1, 1, 0]"
11973,1,1,2,0.8688605716499381,"[1, 0, 1, 1, 0, 0, 1, 0, 0, 0]"
11974,1,1,2,0.5243372547830195,"[1, 1, 1, 0, 0, 1, 0, 1, 1, 1]"
11975,1,1,2,0.32680118778458034,"[0, 0, 0, 1, 0, 1, 1, 1, 1, 1]"
11976,1,1,2,0.26823931278865354,"[0, 0, 0, 0, 1, 1, 1, 1, 0, 0]"
11977,1,1,2,0.32092405185130424,"[1, 1, 1, 1, 1, 0, 0, 0, 1, 1]"
11978,1,1,2,0.40506247016139263,"[1, 0, 0, 1, 1, 0, 1, 0, 0, 0]"
11979,2,2,4,0.3227096657498233,"[1, 1, 1, 1, 1, 0, 1, 1, 0, 1]"
11980,1,1,2,0.6882181958439418,"[0, 1, 0, 0, 0, 0, 1, 1, 0, 0]"
11981,1,1,2,0.47462814417232935,"[1, 1, 1, 0, 1, 1, 0, 1, 0, 0]"
11982,1,1,2,0.7151572848503431,"[0, 1, 1, 1, 0, 1, 0, 0, 1, 0]"
11983,1,1,2,0.8569721582602083,"[0, 1, 0, 0, 1, 0, 1, 1, 0, 1]"
11984,1,1,2,0.8183341173282398,"[0, 1, 1, 1, 1, 0, 1, 1, 0, 1]"
11985,1,1,2,0.016912404806365022,"[1, 1, 0, 0, 0, 1, 1, 0, 0, 0]"
11986,1,1,2,0.21281723428956545,"[1, 0, 0, 1, 1, 0, 0, 0, 1, 1]"
11987,1,1,2,0.16165194837551933,"[0, 0, 0, 0, 1, 0, 0, 1, 1, 0]"
11988,1,1,2,0.6566071402956943,"[1, 1, 0, 0, 1, 0, 0, 1, 1, 0]"
11989,1,1,2,0.5526526190377736,"[1, 1, 0, 0, 0, 0, 0, 1, 0, 0]"
11990,1,1,2,0.4124227579955583,"[1, 1, 1, 0, 1, 0, 1, 1, 0, 1]"
11991,2,2,4,0.15406836960364012,"[1, 0, 1, 0, 1, 0, 0, 1, 0, 1]"
11992,1,1,2,0.6068110470883111,"[0, 0, 0, 0, 0, 0, 0, 1, 0, 0]"
11993,1,1,2,0.7956168220095725,"[1, 0, 0, 0, 1, 0, 0, 1, 1, 1]"
11994,1,1,2,0.1762230528608174,"[1, 1, 1, 0, 0, 0, 1, 1, 0, 1]"
11995,1,1,2,0.6601036423376048,"[1, 1, 1, 0, 0, 1, 1, 1, 1, 1]"
11996,4,4,8,0.42459580158985855,"[1, 1, 1, 1, 1, 1, 1, 0, 0, 1]"
11997,1,1,2,0.10843942076150725,"[1, 1, 0, 0, 0, 0, 0, 1, 0, 0]"
11998,1,1,2,0.9679658881136547,"[1, 1, 0, 0, 0, 0, 1, 0, 0, 1]"
11999,2,2,4,0.41702867288469136,"[1, 1, 1, 0, 0, 1, 1, 1, 0, 0]"
12000,1,1,2,0.6149447308459776,"[0, 0, 0, 1, 0, 0, 1, 0, 0, 0]"
12001,1,1,2,0.33929800918097597,"[0, 0, 0, 1, 0, 1, 0, 0, 0, 0]"
12002,3,3,6,0.7530754305416462,"[1, 0, 1, 1, 1, 0, 1, 0, 0, 1]"
12003,2,2,4,0.9849975556372835,"[0, 0, 0, 1, 0, 0, 0, 0, 1, 0]"
12004,1,1,2,0.05823054080614776,"[1, 1, 1, 1, 0, 0, 1, 0, 0, 1]"
12005,1,1,2,0.36867262894140873,"[0, 1, 1, 0, 0, 0, 1, 0, 0, 0]"
12006,2,2,4,0.2628227708630796,"[0, 1, 1, 1, 0, 0, 1, 1, 0, 1]"
12007,2,2,4,0.7127933224039137,"[0, 1, 0, 1, 1, 0, 1, 1, 1, 1]"
12008,2,2,4,0.7932494393874312,"[1, 1, 1, 1, 1, 0, 1, 1, 1, 0]"
12009,1,1,2,0.5486904785164956,"[0, 1, 0, 0, 1, 0, 0, 0, 0, 0]"
12010,1,1,2,0.11505517140292099,"[0, 0, 0, 1, 0, 0, 1, 1, 0, 0]"
12011,2,2,4,0.6145383503070908,"[1, 1, 0, 0, 1, 1, 1, 0, 1, 0]"
12012,1,1,2,0.9302027387784007,"[1, 0, 1, 0, 1, 1, 1, 1, 1, 0]"
12013,1,1,2,0.45589511882553047,"[0, 1, 0, 0, 1, 0, 0, 0, 0, 0]"
12014,1,1,2,0.6986875838273898,"[1, 0, 0, 0, 0, 0, 0, 1, 1, 1]"
12015,2,2,4,0.544610326484991,"[0, 0, 0, 1, 0, 0, 1, 1, 0, 0]"
12016,1,1,2,0.1259219405214761,"[1, 0, 1, 1, 1, 1, 1, 0, 1, 0]"
12017,1,1,2,0.5521702084694665,"[1, 0, 0, 1, 1, 0, 0, 0, 0, 1]"
12018,1,1,2,0.177082119117128,"[0, 1, 1, 0, 1, 0, 1, 0, 1, 1]"
12019,1,1,2,0.6162580005485185,"[1, 1, 1, 0, 0, 1, 0, 1, 1, 0]"
12020,1,1,2,0.6916965987337762,"[0, 0, 0, 0, 0, 1, 1, 1, 1, 0]"
12021,1,1,2,0.29230196532231734,"[1, 1, 0, 1, 0, 0, 0, 1, 1, 0]"
12022,1,1,2,0.6795780218422599,"[1, 1, 0, 0, 0, 0, 1, 1, 1, 1]"
12023,1,1,2,0.6577507028879037,"[1, 0, 1, 0, 0, 1, 0, 0, 0, 0]"
12024,2,2,4,0.5457711417338513,"[0, 0, 0, 1, 1, 1, 0, 0, 1, 1]"
12025,1,1,2,0.3412700919508165,"[1, 1, 0, 0, 1, 1, 1, 1, 0, 1]"
12026,1,1,2,0.272283256300625,"[1, 0, 1, 0, 1, 0, 0, 1, 1, 0]"
12027,1,1,2,0.34987579107128297,"[1, 0, 0, 0, 1, 1, 0, 0, 1, 1]"
12028,1,1,2,0.11040682853504691,"[0, 1, 0, 1, 1, 0, 0, 0, 0, 1]"
12029,1,1,2,0.23464008494890998,"[1, 1, 0, 0, 0, 0, 1, 0, 1, 0]"
12030,1,1,2,0.8125539483123769,"[0, 1, 1, 0, 0, 0, 0, 1, 1, 1]"
12031,1,1,2,0.04450768739644928,"[1, 1, 1, 0, 0, 1, 1, 0, 0, 0]"
12032,1,1,2,0.8807515907099598,"[0, 1, 1, 0, 0, 0, 0, 1, 0, 1]"
12033,1,1,2,0.09568602890935296,"[0, 0, 1, 0, 1, 1, 1, 0, 1, 1]"
12034,1,1,2,0.6342119742240504,"[1, 1, 0, 1, 1, 0, 0, 0, 1, 1]"
12035,1,1,2,0.37773484797063084,"[0, 1, 1, 1, 1, 1, 0, 1, 0, 1]"
12036,1,1,2,0.4962763202677801,"[1, 0, 0, 1, 0, 1, 0, 1, 1, 1]"
12037,1,1,2,0.3104617924424178,"[1, 1, 1, 1, 1, 0, 0, 1, 0, 0]"
12038,1,1,2,0.7095624073272806,"[1, 1, 0, 0, 0, 1, 0, 1, 0, 0]"
12039,2,2,4,0.14490985209891116,"[1, 1, 0, 0, 1, 0, 1, 0, 0, 0]"
12040,1,1,2,0.22521964315025333,"[1, 1, 1, 0, 0, 0, 0, 1, 1, 1]"
12041,3,3,6,0.4130477614793542,"[1, 0, 1, 1, 0, 0, 1, 0, 1, 0]"
12042,1,1,2,0.6413953346206618,"[1, 1, 1, 0, 0, 1, 0, 0, 0, 1]"
12043,4,4,8,0.105685381369934,"[1, 0, 0, 1, 1, 1, 0, 0, 1, 1]"
12044,1,1,2,0.1279228156414307,"[1, 1, 0, 0, 0, 1, 1, 0, 1, 0]"
12045,1,1,2,0.20810371341919176,"[1, 0, 1, 1, 1, 0, 1, 1, 1, 0]"
12046,1,1,2,0.3073156239693787,"[0, 1, 1, 0, 0, 0, 1, 1, 0, 1]"
12047,2,2,4,0.9008258870693339,"[1, 1, 0, 0, 0, 0, 0, 1, 1, 0]"
12048,1,1,2,0.9130795043154071,"[0, 0, 1, 1, 1, 0, 1, 1, 0, 1]"
12049,1,1,2,0.48735959564943654,"[1, 1, 0, 1, 0, 1, 1, 0, 1, 0]"
12050,1,1,2,0.4271375951138602,"[1, 1, 1, 0, 1, 1, 1, 1, 0, 1]"
12051,1,1,2,0.3529592518200336,"[1, 1, 0, 0, 1, 1, 1, 1, 0, 0]"
12052,2,2,4,0.9100457233038485,"[1, 0, 0, 0, 0, 0, 1, 1, 1, 1]"
12053,2,2,4,0.7331889974203987,"[0, 1, 0, 0, 1, 1, 1, 1, 0, 0]"
12054,1,1,2,0.2688020940298306,"[0, 0, 0, 0, 1, 1, 1, 1, 1, 0]"
12055,1,1,2,0.7162014132051978,"[0, 0, 0, 1, 0, 0, 0, 1, 1, 0]"
12056,1,1,2,0.5429160638876872,"[0, 0, 0, 1, 1, 0, 1, 0, 0, 1]"
12057,1,1,2,0.8333055843673834,"[1, 0, 1, 1, 0, 0, 1, 0, 1, 1]"
12058,1,1,2,0.7336725236233348,"[0, 0, 1, 0, 0, 0, 0, 1, 1, 1]"
12059,1,1,2,0.018378018674013008,"[0, 0, 1, 0, 0, 0, 0, 1, 1, 0]"
12060,1,1,2,0.8725435958268951,"[0, 0, 1, 1, 1, 1, 1, 0, 0, 1]"
12061,1,1,2,0.2828290739742686,"[0, 0, 1, 0, 1, 0, 0, 1, 1, 1]"
12062,1,1,2,0.6918333082834253,"[1, 0, 0, 0, 1, 1, 1, 0, 0, 1]"
12063,1,1,2,0.5476260790920048,"[1, 1, 0, 0, 1, 1, 0, 1, 1, 0]"
12064,2,2,4,0.7327821390418051,"[0, 1, 0, 0, 0, 0, 1, 1, 1, 1]"
12065,1,1,2,0.9456286441332423,"[1, 1, 1, 1, 1, 0, 0, 0, 1, 0]"
12066,1,1,2,0.0987840719461257,"[0, 0, 1, 0, 1, 1, 1, 1, 1, 0]"
12067,1,1,2,0.49435638605785615,"[0, 0, 0, 0, 0, 1, 1, 1, 1, 1]"
12068,1,1,2,0.662302180092524,"[1, 1, 1, 0, 0, 1, 0, 1, 1, 0]"
12069,1,1,2,0.9165025972598274,"[1, 1, 0, 1, 0, 0, 0, 0, 1, 1]"
12070,1,1,2,0.38791613367135314,"[1, 1, 0, 0, 0, 0, 1, 1, 1, 1]"
12071,1,1,2,0.9163786210253212,"[0, 1, 0, 0, 0, 0, 1, 0, 0, 0]"
12072,1,1,2,0.657816349389941,"[1, 1, 0, 0, 0, 1, 1, 0, 1, 0]"
12073,2,2,4,0.3551992684550651,"[1, 1, 1, 1, 1, 0, 0, 0, 1, 1]"
12074,1,1,2,0.252276377548993,"[1, 0, 1, 1, 1, 1, 0, 1, 1, 1]"
12075,1,1,2,0.9160399305104933,"[0, 1, 1, 0, 0, 1, 1, 0, 1, 1]"
12076,1,1,2,0.7140746953379203,"[1, 0, 0, 1, 1, 1, 0, 0, 1, 0]"
12077,1,1,2,0.7540477198371719,"[0, 0, 1, 1, 1, 0, 0, 1, 1, 1]"
12078,1,1,2,0.852646013095703,"[0, 0, 1, 1, 1, 1, 1, 1, 0, 1]"
12079,1,1,2,0.625476962648364,"[1, 0, 1, 1, 1, 0, 1, 1, 0, 0]"
12080,2,2,4,0.786091499966953,"[1, 0, 0, 1, 0, 1, 0, 0, 1, 1]"
12081,1,1,2,0.057242961931567415,"[1, 0, 1, 0, 0, 0, 1, 1, 1, 0]"
12082,1,1,2,0.18041694303272826,"[1, 1, 0, 0, 0, 0, 1, 0, 0, 0]"
12083,1,1,2,0.9856918172403026,"[1, 1, 0, 1, 1, 0, 1, 1, 1, 1]"
12084,1,1,2,0.18375352185568128,"[0, 0, 1, 0, 1, 0, 0, 1, 1, 1]"
12085,1,1,2,0.3772977809336038,"[0, 1, 0, 1, 1, 1, 1, 0, 0, 0]"
12086,1,1,2,0.5354929862150426,"[1, 0, 0, 0, 1, 0, 0, 1, 1, 1]"
12087,1,1,2,0.09882968774028789,"[1, 0, 0, 1, 1, 0, 0, 1, 0, 0]"
12088,1,1,2,0.7425984882366619,"[1, 0, 0, 1, 0, 0, 1, 0, 1, 0]"
12089,2,2,4,0.7720913872798636,"[1, 0, 1, 1, 1, 1, 1, 0, 1, 1]"
12090,1,1,2,0.8624436259197643,"[0, 1, 0, 0, 0, 1, 0, 1, 0, 1]"
12091,1,1,2,0.8596016371494264,"[0, 0, 1, 0, 1, 1, 1, 1, 0, 0]"
12092,1,1,2,0.11022448162251341,"[1, 1, 1, 1, 0, 0, 0, 0, 1, 1]"
12093,1,1,2,0.08989355578916369,"[0, 1, 1, 0, 1, 0, 0, 0, 1, 1]"
12094,1,1,2,0.32298945688057445,"[0, 1, 0, 0, 1, 0, 1, 0, 1, 0]"
12095,1,1,2,0.957082643326349,"[1, 0, 1, 0, 1, 0, 0, 1, 1, 0]"
12096,1,1,2,0.3595860067610145,"[1, 1, 1, 0, 0, 0, 0, 1, 1, 0]"
12097,1,1,2,0.05036326126059776,"[0, 0, 0, 0, 0, 0, 0, 0, 1, 1]"
12098,1,1,2,0.9485995983449361,"[0, 1, 1, 0, 1, 1, 0, 1, 0, 0]"
12099,1,1,2,0.3120443847920993,"[1, 0, 0, 1, 1, 1, 1, 1, 0, 0]"
12100,1,1,2,0.7340082529411315,"[1, 1, 1, 0, 1, 1, 0, 1, 1, 1]"
12101,2,2,4,0.8931187964866324,"[1, 0, 0, 0, 0, 0, 1, 1, 1, 0]"
12102,1,1,2,0.709779652433527,"[0, 1, 0, 0, 0, 1, 1, 1, 0, 1]"
12103,1,1,2,0.576079221802905,"[0, 0, 1, 1, 1, 1, 0, 0, 0, 0]"
12104,1,1,2,0.5023932422242123,"[1, 0, 0, 0, 1, 0, 1, 0, 1, 0]"
12105,1,1,2,0.3913842714680029,"[1, 1, 0, 1, 0, 0, 0, 1, 1, 0]"
12106,1,1,2,0.5406913100985027,"[1, 0, 0, 0, 1, 0, 1, 0, 1, 1]"
12107,1,1,2,0.7773380961974313,"[1, 1, 1, 1, 0, 0, 0, 0, 0, 1]"
12108,1,1,2,0.37874176821305583,"[1, 1, 1, 1, 1, 1, 0, 1, 0, 1]"
12109,1,1,2,0.887078750581866,"[1, 1, 1, 0, 0, 1, 1, 0, 0, 0]"
12110,1,1,2,0.32804346523244876,"[0, 0, 1, 1, 0, 1, 0, 1, 1, 1]"
12111,1,1,2,0.6065669743319485,"[1, 1, 0, 1, 1, 1, 0, 1, 1, 0]"
12112,1,1,2,0.3395349441080202,"[0, 0, 0, 1, 1, 0, 1, 0, 0, 1]"
12113,1,1,2,0.764780183762436,"[0, 0, 0, 0, 1, 0, 0, 0, 1, 0]"
12114,2,2,4,0.7489641723536248,"[0, 0, 0, 0, 1, 1, 0, 1, 1, 1]"
12115,2,2,4,0.471307514298443,"[0, 1, 1, 1, 1, 1, 0, 0, 0, 1]"
12116,1,1,2,0.9535843449353892,"[0, 0, 1, 0, 1, 1, 0, 1, 0, 0]"
12117,1,1,2,0.23001389111274118,"[1, 0, 0, 1, 0, 0, 1, 1, 1, 1]"
12118,1,1,2,0.07243640614926594,"[1, 1, 1, 1, 1, 0, 0, 1, 0, 1]"
12119,1,1,2,0.6489286432670097,"[0, 1, 1, 0, 0, 1, 1, 0, 0, 1]"
12120,2,2,4,0.7377688002539226,"[0, 0, 1, 1, 0, 0, 1, 1, 1, 1]"
12121,1,1,2,0.772107760883199,"[0, 0, 0, 0, 0, 0, 1, 0, 1, 0]"
12122,1,1,2,0.21901513475051726,"[0, 0, 0, 1, 1, 0, 1, 0, 1, 1]"
12123,1,1,2,0.6432639353628111,"[1, 0, 0, 0, 0, 0, 1, 0, 0, 1]"
12124,1,1,2,0.08744361795350686,"[1, 1, 0, 0, 0, 0, 0, 0, 0, 1]"
12125,1,1,2,0.2901142672382384,"[0, 1, 0, 1, 0, 1, 1, 1, 1, 1]"
12126,1,1,2,0.3168758235648125,"[1, 1, 0, 0, 0, 0, 1, 0, 0, 1]"
12127,1,1,2,0.6879970601901533,"[1, 0, 1, 1, 1, 1, 1, 1, 0, 0]"
12128,1,1,2,0.14178350754947577,"[1, 1, 1, 1, 0, 0, 1, 0, 0, 0]"
12129,1,1,2,0.9562838375567355,"[0, 0, 1, 1, 1, 0, 0, 0, 1, 1]"
12130,1,1,2,0.8797816287442473,"[0, 1, 1, 1, 0, 1, 0, 0, 0, 1]"
12131,1,1,2,0.027161963616424645,"[1, 0, 0, 0, 1, 0, 0, 1, 0, 0]"
12132,1,1,2,0.7813432560592062,"[0, 0, 0, 0, 0, 0, 0, 0, 0, 1]"
12133,2,2,4,0.09946631517902882,"[1, 0, 0, 0, 0, 1, 1, 1, 1, 1]"
12134,1,1,2,0.9768295468886001,"[0, 0, 0, 0, 0, 0, 1, 0, 1, 0]"
12135,1,1,2,0.6491112502611922,"[1, 1, 1, 1, 0, 0, 1, 0, 1, 0]"
12136,1,1,2,0.02963473859131116,"[1, 0, 1, 1, 1, 1, 1, 0, 0, 0]"
12137,1,1,2,0.5653762202323732,"[1, 0, 1, 0, 0, 0, 0, 1, 1, 0]"
12138,1,1,2,0.5266086304515917,"[1, 0, 1, 1, 1, 0, 0, 1, 0, 0]"
12139,1,1,2,0.5278880089990469,"[0, 1, 1, 0, 1, 1, 1, 0, 0, 0]"
12140,2,2,4,0.02970729241516079,"[1, 1, 0, 0, 0, 0, 1, 0, 0, 0]"
12141,1,1,2,0.284882089817754,"[1, 0, 1, 0, 1, 0, 0, 0, 0, 1]"
12142,1,1,2,0.2944163178337361,"[1, 1, 1, 0, 0, 0, 0, 0, 1, 1]"
12143,1,1,2,0.22600144313150927,"[1, 0, 1, 0, 1, 0, 0, 0, 0, 0]"
12144,1,1,2,0.8602603376327067,"[1, 1, 0, 0, 0, 0, 1, 0, 1, 1]"
12145,3,3,6,0.6858463573026625,"[0, 1, 1, 1, 1, 1, 0, 1, 1, 0]"
12146,1,1,2,0.06870831204296357,"[1, 1, 0, 0, 0, 1, 1, 1, 0, 0]"
12147,1,1,2,0.191501755712287,"[1, 1, 0, 1, 1, 1, 1, 0, 1, 0]"
12148,1,1,2,0.48111722705274407,"[1, 0, 1, 0, 0, 0, 0, 0, 1, 1]"
12149,2,2,4,0.6955668363488521,"[0, 1, 1, 1, 0, 1, 1, 1, 0, 1]"
12150,2,2,4,0.781146139821882,"[1, 0, 0, 1, 0, 1, 1, 0, 1, 0]"
12151,1,1,2,0.5349472147661021,"[1, 0, 1, 0, 0, 1, 1, 0, 0, 0]"
12152,2,2,4,0.8468655655854521,"[0, 1, 0, 1, 0, 1, 1, 0, 1, 1]"
12153,2,2,4,0.6162216522655408,"[1, 0, 0, 1, 1, 0, 1, 0, 0, 1]"
12154,2,2,4,0.870727580578525,"[0, 0, 1, 1, 1, 1, 0, 0, 0, 1]"
12155,1,1,2,0.9021776391677355,"[1, 0, 1, 0, 1, 0, 1, 0, 1, 0]"
12156,1,1,2,0.4820147407844648,"[1, 0, 0, 0, 1, 1, 0, 0, 1, 1]"
12157,1,1,2,0.9289605855926222,"[0, 0, 0, 0, 0, 0, 0, 1, 0, 0]"
12158,1,1,2,0.5478511831382938,"[0, 1, 1, 1, 0, 0, 1, 1, 1, 1]"
12159,1,1,2,0.13362109282663437,"[1, 0, 1, 0, 0, 1, 0, 1, 0, 1]"
12160,1,1,2,0.9132639681381838,"[1, 1, 0, 1, 0, 0, 1, 0, 0, 1]"
12161,1,1,2,0.43521813865208003,"[0, 1, 0, 0, 0, 1, 0, 1, 0, 0]"
12162,1,1,2,0.29189383934936364,"[1, 1, 0, 0, 0, 1, 0, 0, 1, 0]"
12163,1,1,2,0.5552456372773062,"[1, 1, 0, 0, 1, 1, 0, 1, 0, 0]"
12164,1,1,2,0.07850086297530567,"[1, 1, 1, 1, 0, 0, 1, 0, 0, 0]"
12165,1,1,2,0.1932557511828389,"[1, 0, 0, 0, 0, 1, 0, 0, 1, 1]"
12166,1,1,2,0.06568318796011863,"[1, 0, 1, 1, 0, 0, 1, 1, 0, 1]"
12167,1,1,2,0.6770102606561125,"[0, 1, 1, 1, 0, 0, 1, 0, 0, 0]"
12168,1,1,2,0.2284919987337133,"[1, 0, 1, 0, 0, 1, 1, 1, 1, 1]"
12169,2,2,4,0.7974727725091143,"[0, 0, 1, 1, 0, 1, 1, 1, 1, 1]"
12170,2,2,4,0.5379435221881765,"[1, 1, 0, 0, 0, 1, 1, 1, 1, 1]"
12171,1,1,2,0.261498265946183,"[0, 0, 0, 1, 1, 1, 1, 0, 1, 1]"
12172,1,1,2,0.20499549640764658,"[0, 1, 1, 0, 1, 0, 1, 0, 1, 0]"
12173,1,1,2,0.09950322412952373,"[1, 1, 1, 0, 0, 0, 0, 0, 0, 1]"
12174,1,1,2,0.2650147232537835,"[0, 1, 0, 1, 0, 1, 0, 1, 1, 0]"
12175,1,1,2,0.8120127259403936,"[0, 0, 0, 0, 1, 1, 1, 0, 0, 1]"
12176,2,2,4,0.8072183508379795,"[0, 1, 1, 0, 0, 0, 1, 1, 0, 0]"
12177,1,1,2,0.3546678032710102,"[0, 1, 0, 0, 1, 0, 1, 1, 0, 1]"
12178,2,2,4,0.9317954804053074,"[0, 0, 1, 1, 0, 1, 1, 0, 1, 1]"
12179,1,1,2,0.5712064181729616,"[0, 0, 1, 1, 0, 0, 0, 0, 1, 0]"
12180,1,1,2,0.7640158769523664,"[0, 0, 0, 0, 1, 0, 0, 1, 0, 1]"
12181,2,2,4,0.77507398220393,"[0, 1, 1, 0, 0, 1, 0, 1, 1, 1]"
12182,1,1,2,0.9443338417212784,"[0, 0, 0, 0, 1, 0, 0, 1, 1, 0]"
12183,2,2,4,0.8775104635702167,"[1, 1, 0, 1, 1, 0, 1, 1, 1, 1]"
12184,1,1,2,0.3797602536417535,"[0, 1, 1, 1, 1, 0, 0, 1, 1, 0]"
12185,1,1,2,0.9686643166659981,"[1, 1, 0, 1, 0, 1, 0, 1, 0, 1]"
12186,1,1,2,0.585435343094279,"[1, 0, 1, 1, 1, 0, 0, 1, 0, 1]"
12187,3,3,6,0.23596908450032195,"[1, 0, 0, 1, 0, 1, 1, 1, 1, 0]"
12188,2,2,4,0.24392847282575592,"[0, 0, 0, 0, 0, 1, 1, 0, 1, 1]"
12189,1,1,2,0.09445360934736402,"[1, 0, 1, 1, 1, 0, 1, 1, 1, 0]"
12190,1,1,2,0.34410925998395103,"[1, 0, 0, 1, 1, 0, 0, 1, 1, 0]"
12191,2,2,4,0.17168387461838408,"[1, 0, 1, 0, 1, 1, 1, 1, 1, 1]"
12192,1,1,2,0.5725786947045717,"[0, 1, 1, 1, 0, 1, 0, 0, 0, 0]"
12193,4,4,8,0.7669238967430269,"[1, 0, 0, 1, 0, 0, 1, 0, 1, 1]"
12194,1,1,2,0.3841713077818647,"[1, 0, 0, 1, 1, 0, 0, 1, 0, 1]"
12195,1,1,2,0.6886228603799137,"[0, 0, 0, 1, 0, 1, 0, 0, 0, 0]"
12196,1,1,2,0.3723297665766143,"[1, 1, 1, 0, 1, 1, 0, 0, 0, 1]"
12197,1,1,2,0.06831182822762816,"[0, 0, 1, 1, 0, 1, 0, 1, 1, 1]"
12198,1,1,2,0.5478771992808293,"[0, 0, 1, 1, 1, 0, 1, 0, 0, 1]"
12199,1,1,2,0.4761546734642663,"[1, 0, 0, 0, 1, 0, 0, 0, 1, 0]"
12200,1,1,2,0.7618774078904471,"[1, 1, 1, 0, 0, 0, 1, 1, 0, 1]"
12201,1,1,2,0.4569189021001162,"[0, 1, 0, 1, 1, 0, 1, 0, 0, 1]"
12202,1,1,2,0.23266413745935122,"[1, 1, 0, 1, 0, 1, 1, 0, 0, 1]"
12203,1,1,2,0.8009490943941207,"[0, 0, 0, 0, 0, 0, 0, 1, 1, 0]"
12204,1,1,2,0.8658605952265804,"[0, 1, 0, 1, 0, 0, 0, 1, 1, 0]"
12205,1,1,2,0.2184639271295351,"[0, 0, 1, 0, 1, 1, 1, 1, 1, 0]"
12206,1,1,2,0.8349087923129217,"[0, 1, 0, 0, 1, 0, 1, 0, 1, 1]"
12207,2,2,4,0.28995741629495786,"[0, 0, 0, 1, 1, 0, 1, 1, 1, 0]"
12208,1,1,2,0.4232844536123993,"[1, 0, 1, 1, 0, 0, 0, 1, 0, 0]"
12209,1,1,2,0.4206798283749331,"[1, 0, 1, 0, 1, 1, 1, 0, 0, 0]"
12210,1,1,2,0.7529347482695964,"[0, 0, 0, 1, 1, 1, 0, 1, 1, 0]"
12211,1,1,2,0.2239037156685243,"[1, 1, 0, 0, 1, 0, 1, 0, 1, 1]"
12212,1,1,2,0.3693837298058815,"[1, 1, 0, 0, 0, 0, 1, 0, 0, 1]"
12213,1,1,2,0.4001957092233752,"[1, 0, 1, 0, 0, 1, 0, 0, 0, 0]"
12214,1,1,2,0.8904937293925953,"[1, 1, 1, 1, 0, 1, 1, 0, 1, 0]"
12215,1,1,2,0.7712021077987424,"[0, 1, 1, 0, 0, 0, 0, 0, 0, 0]"
12216,1,1,2,0.14314196859025052,"[1, 1, 0, 0, 0, 0, 1, 1, 1, 0]"
12217,1,1,2,0.19565330624776633,"[1, 1, 1, 1, 1, 0, 1, 1, 1, 1]"
12218,2,2,4,0.7118078215863511,"[0, 0, 1, 1, 1, 1, 0, 1, 0, 1]"
12219,2,2,4,0.2988408671705376,"[0, 0, 1, 0, 0, 1, 0, 1, 0, 1]"
12220,1,1,2,0.5591211291871843,"[0, 0, 1, 0, 0, 1, 1, 1, 0, 0]"
12221,1,1,2,0.22309770742585833,"[0, 0, 1, 0, 1, 0, 0, 1, 0, 1]"
12222,2,2,4,0.4193729615876497,"[0, 1, 1, 1, 0, 1, 1, 1, 0, 1]"
12223,2,2,4,0.3193078903575828,"[1, 0, 1, 1, 0, 1, 1, 0, 0, 0]"
12224,1,1,2,0.9978481283962527,"[1, 1, 0, 1, 0, 1, 0, 1, 0, 0]"
12225,1,1,2,0.13776634772905727,"[1, 1, 1, 1, 0, 0, 0, 1, 1, 0]"
12226,4,4,8,0.832177104064975,"[0, 1, 1, 0, 1, 1, 1, 1, 0, 1]"
12227,1,1,2,0.3259934742131966,"[1, 0, 0, 0, 0, 1, 1, 0, 1, 0]"
12228,1,1,2,0.2966919927319278,"[0, 0, 1, 0, 1, 1, 0, 0, 0, 0]"
12229,1,1,2,0.5297543609546093,"[0, 1, 1, 0, 0, 0, 1, 0, 0, 0]"
12230,1,1,2,0.4468903156195331,"[0, 1, 0, 1, 0, 0, 1, 0, 0, 0]"
12231,1,1,2,0.6570637299212722,"[0, 0, 1, 1, 1, 0, 0, 0, 0, 1]"
12232,1,1,2,0.06557116976564947,"[1, 0, 0, 0, 1, 0, 1, 1, 0, 0]"
12233,1,1,2,0.8286772161281941,"[1, 0, 1, 0, 1, 0, 0, 1, 1, 1]"
12234,2,2,4,0.5994896365305731,"[1, 1, 0, 0, 1, 1, 1, 1, 0, 0]"
12235,1,1,2,0.22521479638406505,"[0, 1, 0, 0, 1, 0, 1, 1, 0, 0]"
12236,1,1,2,0.4953573333338036,"[1, 0, 1, 0, 0, 0, 0, 0, 0, 1]"
12237,1,1,2,0.09863370612315947,"[0, 1, 1, 1, 1, 0, 0, 0, 0, 0]"
12238,1,1,2,0.9402829198382293,"[1, 1, 0, 1, 0, 1, 0, 1, 0, 1]"
12239,2,2,4,0.6042904269930627,"[0, 0, 1, 0, 1, 1, 1, 0, 0, 0]"
12240,1,1,2,0.14935513266588507,"[0, 0, 1, 0, 0, 0, 1, 0, 0, 0]"
12241,2,2,4,0.1854551632745839,"[0, 0, 1, 0, 1, 0, 0, 0, 1, 1]"
12242,1,1,2,0.13705720897673657,"[1, 1, 1, 0, 0, 0, 0, 1, 1, 1]"
12243,1,1,2,0.6395114059582031,"[0, 0, 0, 0, 1, 0, 1, 1, 0, 0]"
12244,1,1,2,0.6763820978247248,"[0, 0, 1, 1, 1, 1, 0, 0, 0, 1]"
12245,2,2,4,0.7592846139186995,"[1, 0, 0, 0, 1, 1, 0, 1, 1, 1]"
12246,1,1,2,0.7284531499775274,"[0, 0, 1, 1, 1, 0, 1, 1, 0, 0]"
12247,2,2,4,0.9575894939305148,"[0, 0, 1, 0, 1, 0, 0, 0, 1, 0]"
12248,3,3,6,0.8498177173121076,"[1, 1, 1, 0, 0, 1, 0, 1, 0, 1]"
12249,1,1,2,0.00018456946104550287,"[0, 0, 1, 1, 0, 0, 0, 1, 0, 1]"
12250,1,1,2,0.7799171835444731,"[0, 0, 1, 0, 1, 1, 1, 1, 1, 0]"
12251,4,4,8,0.6855258926924933,"[1, 0, 1, 1, 1, 0, 1, 1, 1, 1]"
12252,1,1,2,0.7071200614399702,"[1, 0, 1, 0, 1, 1, 0, 0, 1, 1]"
12253,1,1,2,0.41444164310425413,"[1, 0, 1, 0, 1, 0, 1, 1, 1, 0]"
12254,1,1,2,0.29923339054444453,"[0, 1, 0, 1, 1, 1, 0, 0, 1, 0]"
12255,1,1,2,0.5603250149111875,"[0, 0, 0, 0, 0, 1, 0, 1, 1, 0]"
12256,3,3,6,0.871312001866317,"[1, 1, 1, 1, 0, 1, 1, 1, 1, 0]"
12257,1,1,2,0.663178439241927,"[0, 1, 1, 1, 0, 0, 1, 0, 1, 0]"
12258,1,1,2,0.07226737742800804,"[0, 0, 0, 1, 0, 0, 0, 0, 0, 0]"
12259,1,1,2,0.8360571549361373,"[1, 1, 1, 1, 1, 0, 1, 1, 1, 0]"
12260,2,2,4,0.7435207458234495,"[0, 1, 0, 0, 1, 1, 1, 0, 0, 0]"
12261,1,1,2,0.2721532618865372,"[1, 1, 1, 0, 0, 0, 0, 1, 1, 1]"
12262,1,1,2,0.7852998958801727,"[0, 1, 1, 1, 0, 1, 0, 0, 0, 0]"
12263,1,1,2,0.15580921955972116,"[1, 1, 0, 0, 1, 0, 0, 1, 0, 1]"
12264,1,1,2,0.12216722179825956,"[1, 1, 0, 0, 1, 1, 0, 0, 1, 1]"
12265,1,1,2,0.9548116071137509,"[1, 1, 0, 1, 1, 1, 1, 0, 1, 0]"
12266,1,1,2,0.8866811228785298,"[0, 0, 0, 0, 0, 1, 1, 0, 1, 0]"
12267,2,2,4,0.8985436264924328,"[0, 1, 0, 0, 1, 0, 1, 0, 1, 0]"
12268,2,2,4,0.5085759535071753,"[0, 0, 1, 0, 0, 0, 1, 0, 0, 1]"
12269,1,1,2,0.7347304280314394,"[1, 0, 1, 0, 1, 0, 0, 1, 1, 1]"
12270,2,2,4,0.677981700868215,"[0, 0, 1, 0, 1, 0, 0, 1, 1, 1]"
12271,1,1,2,0.3442858015418212,"[0, 0, 0, 0, 1, 0, 0, 0, 0, 0]"
12272,1,1,2,0.33403381176885627,"[1, 0, 0, 1, 0, 0, 1, 1, 0, 1]"
12273,2,2,4,0.35370591199004076,"[0, 1, 1, 1, 1, 1, 0, 1, 1, 0]"
12274,1,1,2,0.16597580020813862,"[0, 1, 0, 0, 1, 0, 0, 1, 0, 1]"
12275,1,1,2,0.665968307775993,"[0, 1, 0, 1, 0, 0, 1, 0, 0, 0]"
12276,1,1,2,0.7310171204475779,"[1, 1, 1, 1, 0, 1, 0, 1, 1, 1]"
12277,1,1,2,0.853615407777407,"[1, 1, 1, 0, 1, 1, 0, 0, 0, 0]"
12278,1,1,2,0.5389246952353177,"[1, 1, 0, 1, 1, 1, 0, 0, 0, 1]"
12279,2,2,4,0.40817090083511354,"[1, 1, 0, 1, 1, 1, 0, 0, 1, 0]"
12280,1,1,2,0.2411891970580533,"[0, 1, 0, 0, 0, 0, 0, 1, 1, 1]"
12281,2,2,4,0.7073040762097861,"[0, 0, 0, 0, 1, 0, 1, 1, 1, 0]"
12282,1,1,2,0.2563204157752804,"[0, 0, 1, 0, 1, 1, 0, 0, 1, 1]"
12283,2,2,4,0.3537739168441094,"[0, 0, 1, 0, 0, 1, 1, 0, 1, 1]"
12284,1,1,2,0.4628851930353858,"[1, 0, 0, 0, 1, 1, 1, 0, 1, 0]"
12285,1,1,2,0.6778930769721644,"[0, 1, 0, 1, 0, 1, 0, 0, 0, 1]"
12286,1,1,2,0.3323763387872092,"[0, 0, 1, 1, 0, 0, 1, 1, 0, 1]"
12287,1,1,2,0.8469570612588876,"[0, 1, 0, 1, 0, 1, 0, 1, 1, 1]"
12288,1,1,2,0.49627781466531473,"[0, 1, 1, 1, 1, 1, 1, 1, 1, 0]"
12289,1,1,2,0.06987688007628234,"[1, 0, 1, 0, 1, 0, 0, 1, 0, 1]"
12290,1,1,2,0.7619679511487103,"[1, 1, 1, 1, 0, 0, 0, 1, 1, 1]"
12291,1,1,2,0.9961776500345563,"[1, 1, 1, 0, 1, 1, 0, 1, 0, 0]"
12292,1,1,2,0.7955907644791157,"[1, 0, 1, 1, 0, 1, 1, 0, 1, 0]"
12293,1,1,2,0.7397279280110551,"[1, 1, 0, 1, 0, 1, 1, 1, 1, 0]"
12294,1,1,2,0.35191103677027313,"[0, 0, 0, 1, 0, 1, 1, 0, 0, 1]"
12295,2,2,4,0.4785823069164724,"[0, 0, 0, 1, 1, 0, 0, 1, 1, 0]"
12296,1,1,2,0.46377178136589914,"[0, 0, 1, 0, 1, 1, 0, 0, 0, 1]"
12297,3,3,6,0.6097356562188788,"[0, 1, 1, 1, 0, 0, 1, 1, 1, 0]"
12298,1,1,2,0.27627268028238694,"[1, 0, 1, 1, 0, 0, 1, 0, 0, 1]"
12299,1,1,2,0.5354026181779797,"[0, 0, 1, 0, 0, 1, 0, 0, 1, 0]"
12300,1,1,2,0.9210608320530485,"[1, 1, 0, 1, 0, 0, 1, 1, 1, 1]"
12301,1,1,2,0.004076069629749268,"[1, 0, 0, 1, 1, 1, 1, 1, 0, 1]"
12302,2,2,4,0.2182399350555687,"[1, 0, 0, 1, 1, 1, 1, 0, 1, 0]"
12303,3,3,6,0.6500352655514094,"[0, 0, 1, 1, 0, 0, 0, 1, 1, 1]"
12304,1,1,2,0.05703558331575753,"[0, 0, 1, 1, 0, 1, 1, 0, 1, 0]"
12305,1,1,2,0.5497557631279145,"[0, 0, 0, 1, 0, 1, 0, 0, 0, 1]"
12306,1,1,2,0.5021582399870446,"[1, 0, 1, 1, 0, 1, 0, 0, 0, 0]"
12307,1,1,2,0.2565201576801531,"[1, 0, 1, 1, 0, 1, 0, 0, 0, 0]"
12308,1,1,2,0.5496403255406546,"[1, 0, 1, 0, 0, 1, 0, 0, 1, 1]"
12309,1,1,2,0.5827273641780649,"[1, 0, 1, 0, 1, 0, 1, 1, 0, 1]"
12310,1,1,2,0.8746812238282514,"[1, 0, 1, 0, 0, 1, 0, 0, 1, 1]"
12311,1,1,2,0.972088382670389,"[0, 1, 1, 1, 0, 1, 1, 0, 1, 1]"
12312,1,1,2,0.6690127429850395,"[0, 0, 0, 0, 0, 0, 0, 1, 1, 1]"
12313,1,1,2,0.9830162053279281,"[0, 0, 0, 0, 1, 1, 1, 0, 0, 0]"
12314,1,1,2,0.23945534881565078,"[0, 1, 0, 0, 1, 1, 1, 1, 0, 0]"
12315,1,1,2,0.6130710637874477,"[1, 0, 1, 0, 1, 0, 0, 1, 1, 0]"
12316,1,1,2,0.9647570621706828,"[0, 0, 1, 0, 0, 1, 0, 0, 1, 1]"
12317,1,1,2,0.7751366665224545,"[0, 1, 1, 0, 1, 1, 0, 0, 0, 1]"
12318,1,1,2,0.6041085200303292,"[1, 0, 1, 1, 1, 0, 1, 0, 1, 1]"
12319,1,1,2,0.11342361224850372,"[0, 0, 1, 0, 0, 1, 1, 1, 0, 0]"
12320,1,1,2,0.3803798949106866,"[0, 1, 1, 0, 1, 1, 1, 0, 0, 0]"
12321,1,1,2,0.34880072387181804,"[1, 0, 0, 0, 1, 0, 0, 0, 1, 0]"
12322,2,2,4,0.6001993103728698,"[0, 0, 0, 0, 1, 0, 1, 0, 0, 1]"
12323,1,1,2,0.761835939681109,"[0, 1, 1, 0, 1, 0, 0, 0, 0, 1]"
12324,1,1,2,0.664592965195795,"[1, 0, 0, 0, 0, 0, 1, 1, 1, 0]"
12325,2,2,4,0.9120438327362763,"[0, 0, 0, 0, 1, 1, 1, 0, 0, 1]"
12326,1,1,2,0.5599347414065401,"[1, 0, 1, 1, 0, 0, 1, 1, 1, 1]"
12327,1,1,2,0.03165905000740843,"[1, 0, 1, 1, 0, 0, 1, 0, 0, 0]"
12328,2,2,4,0.06027570260768944,"[0, 1, 0, 1, 0, 0, 0, 0, 0, 1]"
12329,2,2,4,0.5710142987640098,"[1, 1, 1, 0, 1, 0, 0, 1, 0, 0]"
12330,1,1,2,0.3044631056914523,"[0, 0, 1, 0, 1, 0, 1, 1, 0, 1]"
12331,1,1,2,0.20117877734789602,"[0, 1, 0, 0, 0, 0, 0, 0, 1, 1]"
12332,2,2,4,0.8326628664996262,"[0, 1, 0, 0, 0, 1, 1, 1, 1, 1]"
12333,1,1,2,0.5668278307756855,"[0, 1, 1, 0, 0, 1, 0, 1, 1, 0]"
12334,1,1,2,0.9139264923947689,"[0, 1, 1, 0, 0, 1, 1, 0, 1, 0]"
12335,1,1,2,0.26127197247565603,"[1, 1, 1, 1, 0, 0, 0, 0, 0, 0]"
12336,2,2,4,0.51098525757213,"[1, 1, 1, 1, 1, 1, 1, 0, 1, 0]"
12337,1,1,2,0.08082492054083934,"[0, 1, 0, 0, 1, 0, 1, 1, 1, 0]"
12338,2,2,4,0.965720945586699,"[1, 1, 1, 0, 1, 1, 1, 1, 1, 0]"
12339,3,3,6,0.6638726007017348,"[0, 0, 1, 1, 1, 1, 0, 1, 0, 1]"
12340,1,1,2,0.1539556003452225,"[0, 1, 0, 0, 1, 1, 0, 1, 1, 0]"
12341,1,1,2,0.9991131455281631,"[1, 0, 1, 1, 1, 0, 1, 1, 1, 0]"
12342,1,1,2,0.8441561429427336,"[0, 1, 0, 0, 0, 0, 1, 1, 0, 1]"
12343,1,1,2,0.2330272855734904,"[0, 0, 1, 1, 0, 1, 1, 0, 0, 0]"
12344,1,1,2,0.6966814171001239,"[1, 0, 0, 0, 1, 0, 0, 1, 0, 0]"
12345,1,1,2,0.418595908803683,"[0, 1, 1, 0, 1, 0, 1, 1, 1, 0]"
12346,2,2,4,0.8355378266941595,"[1, 0, 0, 1, 1, 0, 0, 0, 1, 0]"
12347,1,1,2,0.2721295886159524,"[1, 1, 0, 1, 0, 0, 0, 1, 0, 1]"
12348,1,1,2,0.40741943842610395,"[0, 1, 1, 1, 1, 0, 1, 1, 0, 0]"
12349,1,1,2,0.8376641734387127,"[1, 1, 0, 1, 1, 1, 1, 1, 1, 0]"
12350,2,2,4,0.8660080192177809,"[1, 0, 0, 1, 0, 1, 1, 0, 1, 1]"
12351,4,4,8,0.6116172900963456,"[1, 0, 1, 0, 1, 1, 0, 1, 1, 1]"
12352,2,2,4,0.545777115239155,"[0, 1, 1, 1, 1, 1, 1, 0, 0, 1]"
12353,1,1,2,0.11067104634961644,"[0, 1, 0, 0, 0, 1, 0, 1, 0, 1]"
12354,2,2,4,0.5497292057120857,"[1, 0, 1, 1, 1, 1, 1, 1, 0, 1]"
12355,1,1,2,0.7453820026781199,"[0, 1, 0, 1, 0, 1, 0, 0, 0, 0]"
12356,1,1,2,0.06600706718258054,"[1, 0, 1, 0, 1, 0, 0, 0, 0, 0]"
12357,1,1,2,0.27087727940331896,"[1, 0, 1, 1, 0, 0, 0, 1, 1, 0]"
12358,1,1,2,0.4586915837048454,"[1, 1, 1, 0, 0, 1, 0, 1, 0, 1]"
12359,1,1,2,0.4964955903692664,"[1, 1, 0, 1, 0, 0, 0, 1, 0, 0]"
12360,1,1,2,0.6535233824431202,"[0, 0, 1, 1, 1, 1, 0, 1, 1, 1]"
12361,1,1,2,0.48626987749762884,"[1, 1, 0, 0, 0, 0, 1, 0, 1, 0]"
12362,1,1,2,0.5680028418917082,"[0, 0, 1, 1, 0, 0, 0, 0, 1, 1]"
12363,2,2,4,0.7152291597712752,"[0, 1, 1, 1, 0, 0, 1, 0, 1, 1]"
12364,2,2,4,0.8110736533135282,"[0, 0, 1, 1, 0, 0, 0, 1, 1, 1]"
12365,1,1,2,0.3800194361852286,"[0, 0, 1, 0, 1, 1, 0, 1, 0, 1]"
12366,1,1,2,0.6190652513690582,"[0, 1, 0, 0, 1, 1, 0, 1, 1, 1]"
12367,1,1,2,0.7443585733295928,"[1, 0, 1, 1, 0, 0, 1, 0, 0, 1]"
12368,1,1,2,0.952945740597201,"[1, 0, 1, 1, 1, 0, 1, 0, 0, 1]"
12369,1,1,2,0.11672186429886189,"[0, 0, 0, 0, 0, 1, 1, 1, 0, 1]"
12370,2,2,4,0.12170337664088071,"[0, 0, 1, 0, 0, 0, 1, 0, 1, 0]"
12371,1,1,2,0.6916331213659223,"[0, 0, 1, 1, 1, 0, 1, 0, 1, 0]"
12372,1,1,2,0.9598297705709241,"[1, 0, 1, 1, 0, 1, 1, 1, 1, 1]"
12373,2,2,4,0.5083486628592,"[0, 1, 1, 0, 1, 0, 1, 1, 0, 1]"
12374,2,2,4,0.7077114159905363,"[1, 0, 0, 1, 1, 0, 1, 0, 0, 1]"
12375,1,1,2,0.8933852473736443,"[1, 0, 0, 1, 1, 1, 0, 1, 1, 0]"
12376,1,1,2,0.8360428655318889,"[0, 1, 0, 0, 0, 1, 1, 0, 0, 0]"
12377,1,1,2,0.7642417785518514,"[1, 1, 0, 1, 0, 0, 0, 0, 0, 0]"
12378,2,2,4,0.8633891100675462,"[1, 0, 0, 1, 0, 0, 0, 0, 0, 0]"
12379,1,1,2,0.8765500599973416,"[0, 1, 1, 1, 1, 0, 1, 1, 1, 1]"
12380,1,1,2,0.1441536554527485,"[1, 1, 1, 1, 1, 0, 0, 1, 0, 1]"
12381,1,1,2,0.7815689598833176,"[0, 1, 1, 1, 1, 1, 0, 0, 1, 1]"
12382,1,1,2,0.31780067097297293,"[0, 0, 0, 0, 1, 0, 1, 0, 0, 0]"
12383,1,1,2,0.5938180141365821,"[1, 1, 0, 1, 0, 1, 0, 0, 0, 1]"
12384,1,1,2,0.8133244453723061,"[1, 1, 1, 1, 0, 0, 0, 1, 1, 0]"
12385,1,1,2,0.1980824343793539,"[1, 1, 0, 1, 0, 1, 1, 0, 1, 1]"
12386,1,1,2,0.2242916017243063,"[0, 0, 0, 0, 1, 0, 1, 1, 1, 0]"
12387,3,3,6,0.21312124375259622,"[1, 1, 0, 1, 0, 1, 0, 1, 1, 1]"
12388,2,2,4,0.07322559533666184,"[1, 1, 0, 1, 1, 1, 1, 1, 1, 1]"
12389,1,1,2,0.5822501835552741,"[0, 0, 1, 1, 0, 1, 1, 0, 1, 1]"
12390,1,1,2,0.5147748152245482,"[1, 0, 0, 1, 0, 1, 1, 0, 0, 0]"
12391,1,1,2,0.05010200270426268,"[0, 1, 1, 1, 0, 0, 0, 1, 0, 0]"
12392,1,1,2,0.7844451162565699,"[1, 1, 1, 1, 0, 1, 1, 1, 0, 0]"
12393,1,1,2,0.5967885963899945,"[1, 0, 1, 0, 1, 1, 0, 0, 1, 1]"
12394,1,1,2,0.8169085047823207,"[1, 1, 0, 1, 1, 1, 0, 0, 0, 1]"
12395,1,1,2,0.9972896825668673,"[1, 0, 0, 1, 1, 1, 1, 0, 0, 0]"
12396,1,1,2,0.8216397244288537,"[0, 1, 0, 1, 0, 1, 0, 0, 1, 1]"
12397,1,1,2,0.09203541328998566,"[1, 1, 1, 0, 0, 0, 1, 1, 0, 1]"
12398,2,2,4,0.4754500708638144,"[0, 0, 0, 1, 0, 1, 1, 1, 1, 1]"
12399,1,1,2,0.46691870389650547,"[1, 0, 0, 0, 1, 0, 1, 1, 0, 1]"
12400,2,2,4,0.26129575065124355,"[0, 1, 1, 0, 1, 1, 0, 1, 0, 1]"
12401,1,1,2,0.4320427318802179,"[1, 1, 0, 0, 1, 1, 1, 0, 1, 0]"
12402,3,3,6,0.8233041571374343,"[0, 0, 0, 1, 0, 1, 1, 1, 1, 1]"
12403,1,1,2,0.6952402363957079,"[1, 0, 1, 0, 0, 0, 0, 0, 1, 0]"
12404,1,1,2,0.7802427290980931,"[1, 0, 1, 0, 1, 1, 1, 0, 0, 1]"
12405,1,1,2,0.910076749769592,"[0, 0, 0, 1, 0, 0, 1, 0, 0, 0]"
12406,1,1,2,0.8458768903239883,"[1, 1, 0, 1, 0, 0, 0, 0, 0, 1]"
12407,3,3,6,0.6199214113165027,"[0, 0, 0, 1, 0, 1, 1, 0, 0, 0]"
12408,1,1,2,0.2769059767586961,"[0, 0, 0, 1, 1, 1, 0, 1, 1, 1]"
12409,1,1,2,0.14374033927677476,"[0, 1, 0, 1, 0, 0, 1, 0, 0, 1]"
12410,1,1,2,0.6888584827163272,"[1, 1, 1, 0, 0, 1, 1, 0, 1, 0]"
12411,1,1,2,0.7890997469626311,"[1, 1, 0, 1, 0, 0, 0, 1, 1, 0]"
12412,1,1,2,0.6064006134186257,"[1, 1, 0, 1, 1, 0, 1, 0, 1, 1]"
12413,1,1,2,0.8272052476304216,"[0, 0, 0, 0, 1, 1, 0, 0, 1, 0]"
12414,1,1,2,0.7788797986463157,"[1, 0, 1, 0, 1, 1, 0, 0, 0, 0]"
12415,2,2,4,0.14983932639821806,"[1, 1, 0, 1, 1, 0, 0, 1, 1, 0]"
12416,1,1,2,0.8753215514986084,"[1, 0, 0, 1, 1, 0, 1, 0, 1, 0]"
12417,2,2,4,0.4640870473372267,"[1, 1, 1, 0, 1, 0, 0, 0, 1, 0]"
12418,1,1,2,0.7955486864023993,"[0, 0, 0, 1, 1, 1, 1, 0, 0, 1]"
12419,1,1,2,0.2266092064359998,"[1, 1, 0, 1, 1, 1, 1, 1, 1, 1]"
12420,1,1,2,0.5220597210779839,"[0, 1, 0, 0, 1, 1, 0, 1, 0, 0]"
12421,1,1,2,0.07773250337250759,"[0, 1, 0, 0, 0, 1, 1, 0, 0, 0]"
12422,1,1,2,0.9541670873195363,"[1, 0, 1, 1, 1, 1, 0, 1, 0, 0]"
12423,3,3,6,0.06071047734929991,"[0, 0, 1, 1, 1, 1, 1, 1, 1, 1]"
12424,1,1,2,0.3249251129841487,"[0, 1, 0, 1, 1, 0, 0, 0, 1, 1]"
12425,1,1,2,0.13120584650492007,"[1, 1, 1, 0, 0, 0, 1, 0, 1, 1]"
12426,1,1,2,0.4936422205635912,"[0, 1, 0, 1, 0, 1, 1, 0, 1, 0]"
12427,1,1,2,0.3827478075945836,"[1, 1, 0, 1, 0, 1, 1, 1, 0, 0]"
12428,1,1,2,0.7767243962518385,"[0, 0, 1, 0, 1, 0, 1, 1, 1, 0]"
12429,1,1,2,0.5010249122212823,"[1, 0, 0, 0, 1, 1, 0, 1, 0, 0]"
12430,1,1,2,0.6815850682035762,"[0, 0, 0, 1, 0, 0, 0, 0, 1, 0]"
12431,1,1,2,0.4870956738287856,"[0, 0, 0, 1, 1, 1, 1, 1, 1, 1]"
12432,1,1,2,0.19478430400761915,"[0, 0, 0, 0, 1, 1, 1, 1, 0, 0]"
12433,1,1,2,0.3252910030034112,"[0, 1, 0, 1, 1, 0, 1, 1, 0, 0]"
12434,1,1,2,0.1747732162997443,"[0, 0, 1, 1, 1, 1, 0, 0, 1, 0]"
12435,1,1,2,0.2742666278054402,"[1, 1, 1, 0, 1, 0, 0, 1, 0, 1]"
12436,1,1,2,0.4282903354034999,"[0, 1, 1, 0, 1, 1, 0, 0, 1, 1]"
12437,1,1,2,0.9312137619589255,"[0, 1, 0, 0, 0, 0, 1, 1, 0, 0]"
12438,2,2,4,0.8102445176672486,"[0, 0, 1, 0, 1, 1, 1, 1, 0, 1]"
12439,1,1,2,0.9808444963210942,"[1, 0, 0, 0, 0, 0, 0, 1, 0, 0]"
12440,1,1,2,0.7477993949658155,"[0, 1, 0, 1, 1, 1, 1, 1, 1, 0]"
12441,1,1,2,0.8510638159214282,"[0, 0, 0, 1, 1, 0, 1, 1, 0, 1]"
12442,1,1,2,0.3697053323870053,"[0, 1, 0, 1, 1, 1, 0, 1, 0, 0]"
12443,1,1,2,0.47179292298018005,"[1, 0, 0, 0, 1, 1, 1, 1, 1, 0]"
12444,1,1,2,0.4439708556203571,"[1, 0, 0, 0, 1, 0, 1, 1, 1, 0]"
12445,1,1,2,0.6146471373932217,"[1, 1, 1, 1, 1, 0, 0, 0, 1, 1]"
12446,1,1,2,0.0012177189596219717,"[1, 1, 0, 0, 0, 1, 1, 0, 0, 1]"
12447,1,1,2,0.9370843469309816,"[0, 0, 1, 1, 0, 1, 0, 1, 0, 1]"
12448,1,1,2,0.6508767240630435,"[0, 0, 0, 0, 0, 0, 1, 1, 1, 1]"
12449,1,1,2,0.8318697331253215,"[1, 0, 1, 0, 0, 0, 0, 1, 1, 1]"
12450,2,2,4,0.8210262762541748,"[0, 0, 1, 0, 1, 1, 1, 0, 1, 1]"
12451,2,2,4,0.3610935938672798,"[1, 0, 1, 0, 1, 1, 1, 0, 1, 0]"
12452,1,1,2,0.9694305122189603,"[0, 0, 1, 0, 0, 1, 1, 1, 0, 1]"
12453,1,1,2,0.09796627340950437,"[0, 0, 1, 1, 0, 1, 0, 1, 0, 0]"
12454,1,1,2,0.828218147553638,"[0, 0, 0, 0, 1, 1, 0, 1, 1, 1]"
12455,2,2,4,0.3083093845263578,"[0, 0, 1, 0, 0, 0, 1, 0, 1, 1]"
12456,1,1,2,0.6099657093684764,"[1, 0, 1, 0, 0, 0, 0, 0, 0, 0]"
12457,1,1,2,0.2260065359617296,"[1, 1, 1, 1, 1, 0, 1, 0, 0, 0]"
12458,1,1,2,0.9428016158976211,"[0, 1, 0, 0, 1, 1, 0, 1, 0, 1]"
12459,1,1,2,0.5338783675756927,"[0, 0, 1, 1, 1, 0, 0, 0, 0, 0]"
12460,1,1,2,0.033847045637011686,"[1, 1, 0, 0, 1, 0, 0, 1, 1, 1]"
12461,1,1,2,0.9262707832868777,"[0, 1, 1, 1, 1, 0, 1, 0, 0, 1]"
12462,1,1,2,0.46533616408585643,"[1, 1, 1, 1, 1, 1, 1, 1, 1, 0]"
12463,1,1,2,0.19396575886383716,"[0, 1, 0, 1, 0, 1, 0, 1, 1, 1]"
12464,2,2,4,0.2545926984051996,"[1, 0, 1, 0, 0, 1, 0, 1, 1, 0]"
12465,2,2,4,0.5107814408724082,"[0, 1, 0, 0, 0, 1, 0, 1, 0, 1]"
12466,1,1,2,0.657657300548757,"[1, 0, 0, 0, 1, 1, 1, 0, 1, 1]"
12467,2,2,4,0.4986774950580958,"[1, 1, 1, 1, 1, 0, 1, 0, 1, 1]"
12468,1,1,2,0.8320746225994557,"[0, 1, 1, 0, 1, 1, 0, 1, 0, 1]"
12469,1,1,2,0.9517332453219723,"[1, 1, 0, 0, 1, 0, 0, 0, 0, 0]"
12470,1,1,2,0.003524525108677734,"[1, 1, 0, 0, 1, 0, 1, 0, 1, 0]"
12471,1,1,2,0.4324159855317633,"[1, 0, 0, 1, 1, 1, 1, 1, 1, 0]"
12472,3,3,6,0.5491034194532222,"[1, 1, 1, 1, 0, 1, 1, 0, 0, 0]"
12473,1,1,2,0.7797613370954449,"[1, 0, 1, 1, 0, 1, 1, 0, 1, 1]"
12474,1,1,2,0.41943261506771523,"[1, 0, 0, 0, 1, 1, 0, 1, 0, 0]"
12475,1,1,2,0.6516444512804871,"[1, 1, 0, 0, 0, 0, 1, 1, 1, 0]"
12476,1,1,2,0.5200919822666136,"[1, 0, 1, 0, 0, 1, 1, 1, 1, 0]"
12477,1,1,2,0.290764306088534,"[1, 0, 1, 1, 0, 0, 0, 1, 1, 0]"
12478,1,1,2,0.8397092710984874,"[0, 0, 0, 0, 1, 0, 1, 0, 0, 0]"
12479,1,1,2,0.6101485329591572,"[1, 0, 1, 0, 1, 1, 1, 0, 1, 0]"
12480,2,2,4,0.4036151447667783,"[1, 1, 0, 1, 0, 0, 0, 0, 0, 1]"
12481,1,1,2,0.38605203971946345,"[0, 1, 1, 1, 0, 1, 0, 0, 0, 1]"
12482,1,1,2,0.47608979360485426,"[1, 1, 0, 0, 1, 0, 0, 0, 0, 1]"
12483,1,1,2,0.6996974647679897,"[1, 0, 1, 1, 1, 0, 1, 0, 1, 0]"
12484,1,1,2,0.8054221340329195,"[1, 1, 1, 0, 0, 1, 1, 1, 0, 0]"
12485,1,1,2,0.16774580227543245,"[1, 0, 0, 1, 0, 1, 0, 0, 0, 0]"
12486,1,1,2,0.07413386667763888,"[0, 1, 0, 1, 0, 0, 0, 1, 0, 1]"
12487,1,1,2,0.7559682264911078,"[0, 1, 0, 1, 0, 1, 1, 0, 1, 0]"
12488,1,1,2,0.7578583703918669,"[0, 0, 0, 1, 1, 0, 1, 1, 1, 0]"
12489,1,1,2,0.3428458271339785,"[1, 0, 0, 1, 0, 1, 1, 1, 1, 1]"
12490,1,1,2,0.554012908253999,"[1, 0, 0, 0, 0, 0, 1, 1, 0, 0]"
12491,1,1,2,0.26658860570054754,"[1, 0, 0, 1, 0, 0, 0, 0, 0, 1]"
12492,1,1,2,0.5360899390103355,"[1, 1, 0, 0, 1, 0, 0, 1, 1, 0]"
12493,2,2,4,0.4704798977357868,"[0, 0, 0, 1, 0, 0, 1, 0, 1, 1]"
12494,1,1,2,0.6646422982133049,"[1, 1, 0, 1, 0, 0, 0, 0, 0, 0]"
12495,1,1,2,0.1937721225720569,"[0, 0, 0, 0, 0, 0, 1, 1, 0, 1]"
12496,1,1,2,0.31717299336618243,"[1, 1, 0, 1, 1, 0, 1, 0, 0, 1]"
12497,2,2,4,0.5229601006305435,"[1, 0, 0, 1, 0, 1, 1, 0, 1, 0]"
12498,1,1,2,0.2572467792360116,"[0, 1, 0, 1, 1, 0, 1, 1, 1, 0]"
12499,1,1,2,0.2956000388563076,"[1, 1, 1, 1, 0, 1, 0, 0, 0, 0]"
12500,1,1,2,0.4907756835492171,"[0, 0, 0, 0, 1, 0, 0, 0, 0, 1]"
12501,1,1,2,0.2885241416772649,"[0, 0, 1, 1, 1, 0, 1, 0, 1, 0]"
12502,1,1,2,0.9091080013390286,"[1, 1, 0, 0, 0, 0, 0, 0, 0, 1]"
12503,1,1,2,0.853283093272554,"[1, 0, 1, 1, 0, 1, 0, 0, 0, 1]"
12504,1,1,2,0.9507637810402332,"[0, 0, 1, 0, 1, 1, 0, 1, 0, 1]"
12505,2,2,4,0.27517707913499434,"[0, 1, 1, 1, 0, 0, 1, 0, 0, 1]"
12506,3,3,6,0.632969820255768,"[1, 1, 1, 1, 0, 0, 0, 0, 1, 1]"
12507,1,1,2,0.7060684239310598,"[1, 0, 0, 0, 1, 1, 0, 0, 1, 1]"
12508,1,1,2,0.7825448575664772,"[0, 0, 1, 1, 0, 0, 0, 0, 0, 0]"
12509,1,1,2,0.6726492433712427,"[0, 0, 1, 0, 1, 0, 0, 1, 0, 0]"
12510,1,1,2,0.33753991492270297,"[0, 0, 1, 0, 0, 1, 0, 0, 1, 1]"
12511,2,2,4,0.6016366996146174,"[0, 0, 1, 0, 1, 0, 0, 0, 1, 1]"
12512,2,2,4,0.35506823463731685,"[1, 0, 0, 1, 1, 0, 0, 1, 1, 0]"
12513,1,1,2,0.8488255499513703,"[1, 0, 1, 0, 1, 0, 1, 0, 1, 1]"
12514,1,1,2,0.0048141202466798205,"[0, 0, 1, 0, 0, 1, 1, 0, 0, 1]"
12515,1,1,2,0.2485507477748189,"[0, 1, 1, 1, 0, 1, 0, 0, 0, 1]"
12516,1,1,2,0.23007538752555234,"[0, 0, 0, 1, 0, 1, 0, 0, 1, 1]"
12517,1,1,2,0.5535375472735028,"[1, 1, 1, 0, 0, 1, 1, 0, 0, 0]"
12518,1,1,2,0.9967644242087983,"[1, 0, 1, 0, 0, 1, 1, 0, 0, 0]"
12519,1,1,2,0.5373751532574756,"[0, 1, 0, 0, 1, 0, 0, 1, 0, 0]"
12520,1,1,2,0.314413972680577,"[1, 0, 0, 1, 1, 1, 0, 0, 0, 1]"
12521,1,1,2,0.5144783680468415,"[1, 0, 0, 0, 1, 0, 1, 0, 0, 1]"
12522,1,1,2,0.994530532246777,"[0, 1, 0, 0, 0, 0, 1, 1, 0, 0]"
12523,1,1,2,0.1019828800165824,"[1, 1, 0, 1, 1, 1, 0, 0, 0, 1]"
12524,1,1,2,0.6497940142111553,"[1, 1, 1, 1, 0, 0, 0, 1, 0, 1]"
12525,2,2,4,0.2977800170414938,"[0, 0, 0, 0, 0, 1, 1, 0, 0, 1]"
12526,1,1,2,0.5860625403758354,"[0, 1, 0, 1, 1, 1, 0, 1, 1, 0]"
12527,1,1,2,0.09138772398283457,"[0, 0, 0, 0, 1, 1, 1, 0, 0, 1]"
12528,2,2,4,0.40385832193104565,"[1, 0, 0, 1, 1, 1, 0, 0, 0, 1]"
12529,3,3,6,0.25320433602582226,"[1, 0, 0, 0, 0, 1, 0, 0, 1, 1]"
12530,1,1,2,0.5671017965056262,"[0, 0, 0, 0, 0, 1, 1, 0, 0, 0]"
12531,1,1,2,0.5432639578722105,"[1, 0, 1, 0, 0, 0, 1, 0, 0, 0]"
12532,1,1,2,0.4016135772846027,"[1, 1, 1, 1, 1, 1, 1, 0, 1, 1]"
12533,1,1,2,0.5666250877450854,"[0, 1, 0, 1, 1, 1, 1, 0, 0, 1]"
12534,1,1,2,0.6978959621838057,"[0, 1, 0, 1, 1, 0, 1, 1, 0, 0]"
12535,1,1,2,0.39998066314260705,"[0, 0, 0, 1, 1, 0, 1, 1, 0, 0]"
12536,1,1,2,0.6024423005718923,"[1, 0, 1, 1, 0, 0, 0, 0, 1, 1]"
12537,1,1,2,0.5138517253785131,"[1, 1, 0, 1, 1, 1, 1, 0, 1, 0]"
12538,1,1,2,0.11588220818222306,"[0, 0, 0, 1, 1, 1, 1, 0, 0, 1]"
12539,1,1,2,0.46765959315832406,"[0, 1, 1, 0, 0, 0, 1, 0, 0, 1]"
12540,1,1,2,0.11401088575443363,"[1, 0, 0, 0, 0, 1, 0, 1, 0, 0]"
12541,1,1,2,0.9222855028021509,"[0, 0, 0, 1, 0, 1, 0, 1, 0, 1]"
12542,1,1,2,0.42608852553394483,"[0, 0, 0, 0, 0, 0, 0, 1, 0, 1]"
12543,2,2,4,0.8800479864957067,"[1, 1, 1, 1, 1, 0, 1, 0, 0, 1]"
12544,2,2,4,0.3723978012621967,"[1, 1, 0, 1, 1, 0, 0, 1, 1, 1]"
12545,1,1,2,0.7037210644366545,"[0, 0, 1, 0, 0, 1, 1, 0, 1, 1]"
12546,1,1,2,0.18375337773378242,"[1, 0, 0, 1, 0, 1, 0, 0, 1, 1]"
12547,1,1,2,0.3799865450283676,"[1, 1, 0, 0, 0, 0, 1, 1, 1, 1]"
12548,1,1,2,0.8160001110236376,"[0, 0, 0, 1, 0, 1, 0, 0, 0, 0]"
12549,1,1,2,0.302703307159945,"[1, 1, 0, 0, 1, 1, 0, 1, 1, 0]"
12550,2,2,4,0.4253125782904872,"[0, 1, 1, 0, 0, 1, 1, 1, 0, 1]"
12551,1,1,2,0.8703022565830657,"[0, 0, 1, 1, 0, 0, 0, 1, 1, 0]"
12552,2,2,4,0.6861228696414146,"[0, 1, 0, 1, 1, 0, 1, 1, 1, 0]"
12553,2,2,4,0.39755666397607736,"[1, 0, 1, 0, 0, 0, 1, 1, 1, 1]"
12554,1,1,2,0.8256245918900484,"[0, 1, 0, 1, 1, 0, 0, 0, 1, 1]"
12555,1,1,2,0.932409093327763,"[1, 1, 1, 0, 0, 1, 0, 0, 0, 1]"
12556,1,1,2,0.6024954188585033,"[0, 1, 0, 1, 1, 0, 1, 1, 0, 0]"
12557,1,1,2,0.058429912015744434,"[0, 1, 1, 1, 0, 0, 0, 1, 1, 1]"
12558,1,1,2,0.6416904164281534,"[1, 0, 0, 0, 0, 0, 1, 1, 0, 0]"
12559,1,1,2,0.003323590132665921,"[0, 0, 1, 0, 1, 0, 1, 0, 0, 0]"
12560,2,2,4,0.6896502399679099,"[0, 0, 1, 1, 0, 0, 1, 1, 1, 1]"
12561,2,2,4,0.5024565360351433,"[0, 1, 1, 1, 0, 0, 1, 0, 1, 1]"
12562,2,2,4,0.5431268542986565,"[1, 0, 1, 0, 1, 0, 0, 0, 0, 1]"
12563,1,1,2,0.887440487333198,"[1, 0, 1, 1, 0, 1, 1, 0, 1, 0]"
12564,1,1,2,0.5824583520525227,"[1, 0, 0, 1, 1, 0, 0, 1, 1, 1]"
12565,1,1,2,0.03589743294949144,"[0, 0, 0, 0, 0, 0, 0, 0, 1, 1]"
12566,1,1,2,0.19105353271019165,"[0, 1, 0, 0, 1, 1, 0, 0, 1, 1]"
12567,1,1,2,0.3660785562103558,"[0, 0, 1, 0, 0, 1, 1, 1, 0, 0]"
12568,1,1,2,0.5867851925581852,"[1, 0, 0, 0, 1, 0, 1, 0, 0, 1]"
12569,1,1,2,0.7391990693086027,"[1, 0, 1, 0, 1, 0, 0, 0, 0, 1]"
12570,1,1,2,0.49442952418295605,"[0, 1, 0, 0, 1, 0, 0, 0, 1, 1]"
12571,1,1,2,0.8652440778734729,"[0, 1, 1, 0, 0, 0, 0, 0, 1, 0]"
12572,1,1,2,0.181364903503915,"[1, 1, 0, 1, 0, 1, 1, 0, 1, 1]"
12573,1,1,2,0.0282681809536508,"[0, 0, 1, 1, 1, 1, 1, 0, 1, 1]"
12574,2,2,4,0.9750873519566554,"[1, 1, 0, 1, 0, 0, 0, 0, 1, 0]"
12575,2,2,4,0.24401202680635592,"[1, 0, 1, 1, 1, 0, 1, 0, 0, 0]"
12576,1,1,2,0.9430624865475274,"[0, 0, 1, 1, 1, 0, 1, 1, 1, 0]"
12577,1,1,2,0.3544739445941022,"[1, 1, 1, 0, 0, 0, 1, 1, 0, 1]"
12578,1,1,2,0.2261294725280525,"[0, 0, 1, 1, 0, 0, 1, 1, 0, 1]"
12579,1,1,2,0.4781152956008581,"[0, 1, 1, 1, 1, 1, 1, 1, 1, 1]"
12580,1,1,2,0.45812252985989455,"[0, 1, 1, 1, 0, 0, 1, 0, 1, 1]"
12581,1,1,2,0.41917233902966966,"[1, 1, 0, 1, 0, 1, 0, 0, 0, 0]"
12582,1,1,2,0.7983699786310281,"[0, 1, 0, 1, 0, 1, 0, 0, 1, 0]"
12583,1,1,2,0.6103334301605351,"[1, 0, 1, 0, 0, 1, 0, 1, 0, 0]"
12584,1,1,2,0.366671676964881,"[0, 0, 1, 0, 1, 0, 0, 1, 0, 1]"
12585,2,2,4,0.44613116229598426,"[0, 1, 1, 0, 1, 1, 1, 1, 0, 0]"
12586,3,3,6,0.3216281484460156,"[0, 0, 0, 1, 1, 0, 1, 1, 1, 0]"
12587,2,2,4,0.4497999039871994,"[1, 0, 0, 1, 0, 0, 1, 0, 1, 1]"
12588,1,1,2,0.15092187816686786,"[1, 0, 0, 0, 0, 1, 1, 1, 1, 1]"
12589,1,1,2,0.11579365987760915,"[1, 0, 1, 1, 1, 0, 1, 1, 0, 0]"
12590,1,1,2,0.6738090217730903,"[0, 1, 1, 0, 1, 1, 0, 1, 0, 1]"
12591,1,1,2,0.7868738265966815,"[0, 1, 0, 0, 0, 1, 1, 1, 1, 0]"
12592,1,1,2,0.5206836815676624,"[0, 1, 0, 1, 1, 0, 0, 1, 0, 1]"
12593,1,1,2,0.49522224454164643,"[0, 1, 0, 0, 0, 1, 0, 1, 0, 0]"
12594,1,1,2,0.16065932313983877,"[0, 0, 1, 1, 1, 1, 0, 0, 0, 0]"
12595,1,1,2,0.15112408303874825,"[0, 0, 0, 1, 1, 1, 1, 1, 1, 0]"
12596,1,1,2,0.3416911446172377,"[0, 0, 0, 0, 0, 0, 0, 1, 1, 1]"
12597,2,2,4,0.24025238164240115,"[0, 0, 0, 1, 1, 0, 0, 1, 0, 0]"
12598,1,1,2,0.9336323771880921,"[0, 0, 0, 0, 1, 1, 1, 1, 1, 1]"
12599,1,1,2,0.3050633425894337,"[0, 0, 1, 1, 0, 1, 0, 1, 0, 0]"
12600,2,2,4,0.873350902154087,"[1, 0, 1, 1, 0, 1, 0, 1, 0, 0]"
12601,1,1,2,0.3136255115761818,"[1, 0, 0, 1, 0, 0, 0, 1, 1, 0]"
12602,1,1,2,0.5245585874028091,"[1, 0, 0, 0, 1, 1, 1, 1, 0, 0]"
12603,1,1,2,0.8066026775118049,"[1, 1, 0, 0, 1, 1, 0, 0, 1, 1]"
12604,1,1,2,0.0411267718766134,"[0, 1, 0, 0, 0, 0, 0, 1, 1, 0]"
12605,1,1,2,0.7776565024767531,"[0, 0, 1, 1, 0, 0, 1, 1, 0, 1]"
12606,1,1,2,0.4629644308066885,"[0, 0, 1, 0, 0, 0, 0, 0, 0, 0]"
12607,1,1,2,0.9442807028590977,"[1, 1, 0, 0, 1, 1, 0, 0, 1, 1]"
12608,1,1,2,0.6721241936530101,"[0, 0, 0, 0, 0, 0, 1, 0, 1, 0]"
12609,1,1,2,0.5135811918234334,"[0, 0, 0, 1, 0, 1, 1, 0, 0, 0]"
12610,1,1,2,0.2628363527826052,"[1, 0, 0, 0, 1, 1, 0, 0, 0, 1]"
12611,1,1,2,0.36414055571307224,"[0, 1, 0, 1, 0, 0, 0, 0, 0, 0]"
12612,1,1,2,0.3131543416729531,"[1, 0, 0, 0, 1, 0, 0, 1, 1, 1]"
12613,1,1,2,0.3877029652977354,"[1, 1, 0, 1, 0, 0, 1, 0, 0, 1]"
12614,2,2,4,0.45673271695335405,"[0, 1, 0, 1, 1, 0, 0, 0, 0, 1]"
12615,3,3,6,0.31183460565360543,"[0, 0, 1, 1, 0, 1, 0, 0, 1, 0]"
12616,1,1,2,0.6653855023359587,"[1, 0, 0, 1, 0, 0, 0, 1, 0, 1]"
12617,1,1,2,0.35665116813596676,"[1, 0, 1, 1, 0, 0, 1, 0, 0, 1]"
12618,1,1,2,0.7034212625341681,"[0, 1, 1, 0, 0, 0, 1, 1, 0, 1]"
12619,1,1,2,0.4745850920211282,"[1, 1, 1, 1, 1, 0, 0, 0, 0, 1]"
12620,1,1,2,0.3016163876100799,"[0, 1, 0, 1, 1, 1, 0, 0, 1, 0]"
12621,1,1,2,0.9991709116979623,"[1, 0, 0, 1, 0, 1, 1, 0, 1, 1]"
12622,1,1,2,0.3387400547999686,"[0, 1, 0, 1, 1, 1, 1, 0, 1, 1]"
12623,3,3,6,0.92602186188044,"[1, 0, 1, 1, 0, 1, 0, 1, 1, 0]"
12624,1,1,2,0.24074342995763864,"[0, 1, 1, 1, 0, 1, 0, 0, 0, 0]"
12625,1,1,2,0.06100676428210983,"[1, 1, 1, 1, 1, 0, 0, 0, 0, 1]"
12626,1,1,2,0.19834566598085857,"[0, 0, 1, 0, 1, 0, 1, 1, 1, 1]"
12627,1,1,2,0.28705246808459584,"[0, 0, 1, 0, 1, 0, 0, 1, 0, 1]"
12628,1,1,2,0.22580697845125175,"[0, 0, 0, 0, 1, 1, 0, 0, 1, 1]"
12629,1,1,2,0.2238658287692471,"[0, 0, 0, 1, 1, 0, 0, 1, 0, 1]"
12630,1,1,2,0.5383306939276913,"[1, 1, 1, 1, 1, 1, 1, 0, 0, 0]"
12631,1,1,2,0.0946882862891576,"[1, 0, 1, 1, 1, 0, 0, 0, 1, 0]"
12632,1,1,2,0.9889224228531595,"[0, 0, 0, 0, 0, 0, 1, 1, 1, 1]"
12633,2,2,4,0.06811340386068954,"[1, 1, 1, 0, 1, 0, 1, 1, 0, 0]"
12634,2,2,4,0.7432178168689697,"[1, 0, 0, 0, 0, 1, 0, 1, 0, 1]"
12635,1,1,2,0.3180614910664502,"[1, 0, 1, 1, 0, 1, 0, 1, 1, 0]"
12636,1,1,2,0.40564163862566327,"[1, 0, 1, 0, 0, 0, 1, 1, 0, 0]"
12637,1,1,2,0.03463867645686891,"[0, 0, 0, 1, 0, 1, 1, 1, 0, 0]"
12638,1,1,2,0.7683097223963347,"[0, 1, 0, 0, 0, 0, 0, 0, 1, 0]"
12639,2,2,4,0.4571380034788538,"[1, 0, 0, 1, 1, 0, 1, 1, 1, 1]"
12640,2,2,4,0.2913691986463889,"[0, 1, 1, 1, 1, 0, 1, 1, 1, 1]"
12641,2,2,4,0.193294272849295,"[1, 0, 1, 1, 0, 1, 0, 0, 0, 1]"
12642,1,1,2,0.6029584171909449,"[0, 1, 0, 1, 0, 0, 1, 0, 0, 0]"
12643,1,1,2,0.7031476481207557,"[0, 0, 0, 0, 0, 1, 1, 1, 1, 1]"
12644,1,1,2,0.4790190847996747,"[1, 1, 0, 1, 1, 0, 0, 0, 0, 1]"
12645,1,1,2,0.6808910653401611,"[1, 0, 1, 1, 0, 0, 1, 1, 0, 1]"
12646,1,1,2,0.3524406460968773,"[1, 1, 0, 0, 1, 0, 1, 0, 0, 1]"
12647,2,2,4,0.1442646868236238,"[1, 1, 1, 1, 0, 0, 0, 1, 0, 1]"
12648,1,1,2,0.47241301492279997,"[1, 0, 1, 0, 0, 0, 1, 1, 1, 0]"
12649,1,1,2,0.3776423493394301,"[1, 1, 0, 0, 0, 1, 0, 0, 0, 1]"
12650,1,1,2,0.5756473319463059,"[0, 1, 1, 0, 1, 1, 1, 0, 0, 1]"
12651,1,1,2,0.5721356309095924,"[0, 1, 0, 1, 1, 1, 1, 0, 1, 1]"
12652,1,1,2,0.4893081577381757,"[0, 1, 0, 1, 1, 0, 1, 0, 1, 0]"
12653,1,1,2,0.9999609642530672,"[1, 1, 0, 1, 0, 1, 0, 0, 0, 0]"
12654,1,1,2,0.6985658545847574,"[1, 1, 1, 0, 1, 0, 1, 1, 1, 0]"
12655,1,1,2,0.10774590602679535,"[1, 0, 0, 1, 0, 0, 1, 0, 0, 0]"
12656,1,1,2,0.22648044536800238,"[0, 1, 1, 0, 0, 0, 1, 1, 1, 0]"
12657,1,1,2,0.7630612685461274,"[0, 1, 1, 1, 1, 1, 1, 1, 0, 0]"
12658,1,1,2,0.7847432637249118,"[0, 0, 0, 1, 0, 1, 0, 1, 0, 0]"
12659,1,1,2,0.2982654232993107,"[1, 0, 1, 1, 1, 1, 1, 1, 0, 1]"
12660,1,1,2,0.08446359990933838,"[1, 1, 1, 1, 0, 0, 0, 1, 0, 0]"
12661,2,2,4,0.883765922293128,"[0, 0, 0, 0, 0, 1, 0, 1, 1, 1]"
12662,1,1,2,0.5186100043416239,"[0, 1, 1, 1, 0, 1, 1, 1, 0, 0]"
12663,1,1,2,0.6048663203782141,"[1, 0, 0, 0, 0, 0, 1, 0, 0, 1]"
12664,1,1,2,0.4052363071844427,"[1, 0, 0, 1, 1, 0, 0, 0, 0, 0]"
12665,1,1,2,0.41993227878505834,"[0, 1, 1, 0, 1, 0, 0, 0, 0, 0]"
12666,2,2,4,0.6577832055540257,"[1, 1, 0, 1, 1, 1, 1, 0, 0, 0]"
12667,1,1,2,0.9018203924043717,"[0, 0, 1, 0, 1, 1, 0, 0, 1, 1]"
12668,1,1,2,0.5264728633261514,"[0, 0, 0, 0, 0, 0, 0, 1, 1, 1]"
12669,1,1,2,0.9082925201978754,"[1, 0, 0, 0, 0, 0, 0, 1, 1, 0]"
12670,1,1,2,0.12217762822124867,"[1, 0, 1, 0, 1, 0, 0, 0, 0, 1]"
12671,1,1,2,0.5279690165384989,"[1, 1, 0, 0, 1, 1, 1, 1, 0, 1]"
12672,2,2,4,0.8438650989091118,"[1, 1, 0, 0, 1, 1, 0, 0, 1, 1]"
12673,1,1,2,0.8090650109202608,"[1, 0, 0, 1, 0, 1, 0, 0, 0, 1]"
12674,1,1,2,0.9227053370007364,"[0, 0, 0, 0, 1, 1, 0, 1, 0, 0]"
12675,2,2,4,0.8292090721633876,"[1, 1, 1, 0, 1, 1, 1, 0, 1, 1]"
12676,1,1,2,0.13841708849982903,"[1, 1, 1, 1, 0, 1, 0, 1, 0, 0]"
12677,1,1,2,0.37962479065557886,"[1, 0, 1, 1, 1, 0, 1, 0, 1, 1]"
12678,1,1,2,0.741809696761567,"[0, 0, 1, 1, 1, 1, 0, 0, 1, 0]"
12679,1,1,2,0.7437713420056273,"[0, 1, 0, 0, 1, 0, 1, 1, 0, 1]"
12680,1,1,2,0.5306407365778999,"[1, 1, 0, 1, 1, 1, 1, 0, 1, 0]"
12681,2,2,4,0.8070200562085601,"[1, 0, 1, 1, 1, 0, 1, 1, 1, 1]"
12682,1,1,2,0.8192655451876938,"[0, 0, 1, 1, 1, 1, 1, 1, 0, 1]"
12683,1,1,2,0.6843304733264154,"[1, 1, 0, 0, 1, 1, 1, 0, 1, 0]"
12684,2,2,4,0.8780889987877847,"[0, 1, 0, 1, 1, 0, 1, 1, 0, 0]"
12685,2,2,4,0.900695578189835,"[1, 0, 1, 0, 0, 1, 1, 0, 0, 1]"
12686,1,1,2,0.7802555415073733,"[0, 1, 1, 0, 0, 0, 0, 1, 0, 1]"
12687,1,1,2,0.20251606446596448,"[0, 1, 1, 1, 0, 0, 1, 0, 1, 1]"
12688,1,1,2,0.24306634139308447,"[0, 0, 1, 1, 1, 1, 1, 1, 0, 1]"
12689,1,1,2,0.5555488735401415,"[0, 1, 0, 1, 1, 0, 0, 0, 1, 1]"
12690,1,1,2,0.3846256799223906,"[0, 0, 1, 1, 0, 1, 0, 1, 0, 0]"
12691,1,1,2,0.9509293532407265,"[0, 1, 1, 0, 0, 0, 0, 0, 0, 0]"
12692,1,1,2,0.34589617372142234,"[1, 0, 1, 0, 0, 1, 0, 0, 0, 1]"
12693,1,1,2,0.8128706709268231,"[0, 0, 1, 1, 0, 0, 1, 0, 0, 0]"
12694,1,1,2,0.9382818217602007,"[1, 1, 0, 1, 0, 1, 0, 0, 1, 0]"
12695,2,2,4,0.6203508281650564,"[0, 1, 1, 1, 0, 1, 1, 1, 1, 1]"
12696,1,1,2,0.18435126612274655,"[0, 0, 0, 0, 0, 0, 1, 1, 0, 0]"
12697,1,1,2,0.2571934142732507,"[0, 1, 0, 1, 0, 1, 1, 0, 0, 0]"
12698,1,1,2,0.6035495132440779,"[1, 1, 0, 1, 0, 0, 0, 1, 1, 0]"
12699,1,1,2,0.25997749162053463,"[0, 0, 0, 0, 0, 1, 1, 0, 1, 0]"
12700,1,1,2,0.8841338860530981,"[1, 0, 1, 1, 1, 1, 0, 0, 0, 0]"
12701,1,1,2,0.8034309921642367,"[0, 0, 0, 1, 1, 1, 0, 0, 1, 0]"
12702,1,1,2,0.648267341056441,"[1, 0, 1, 0, 0, 1, 0, 0, 0, 1]"
12703,1,1,2,0.22221146861939556,"[1, 0, 1, 1, 1, 1, 0, 1, 0, 0]"
12704,1,1,2,0.6444540976828312,"[0, 0, 0, 0, 1, 1, 1, 0, 0, 1]"
12705,1,1,2,0.6440976940313419,"[0, 0, 0, 1, 0, 1, 0, 0, 0, 1]"
12706,2,2,4,0.6275655675226364,"[1, 0, 1, 0, 1, 0, 0, 1, 1, 0]"
12707,1,1,2,0.055145480958693205,"[0, 0, 1, 0, 0, 1, 0, 1, 0, 0]"
12708,1,1,2,0.04349115313881835,"[0, 0, 1, 1, 1, 0, 1, 1, 0, 0]"
12709,1,1,2,0.6367690108398902,"[1, 0, 0, 1, 0, 0, 0, 1, 1, 1]"
12710,1,1,2,0.9667069828277027,"[0, 1, 0, 1, 0, 0, 0, 1, 1, 0]"
12711,2,2,4,0.9572757025670627,"[1, 0, 0, 1, 1, 1, 1, 0, 1, 1]"
12712,2,2,4,0.3223289140675437,"[0, 1, 1, 1, 1, 1, 0, 1, 1, 0]"
12713,1,1,2,0.9185915881835198,"[0, 1, 1, 0, 1, 0, 1, 0, 1, 0]"
12714,1,1,2,0.8810393684005894,"[1, 1, 0, 1, 0, 0, 0, 1, 0, 1]"
12715,1,1,2,0.2884657684034193,"[0, 0, 1, 1, 0, 1, 0, 0, 1, 0]"
12716,1,1,2,0.37345724107205835,"[0, 1, 0, 0, 0, 1, 0, 1, 1, 1]"
12717,1,1,2,0.2769530106565634,"[1, 1, 0, 0, 0, 0, 1, 1, 0, 0]"
12718,1,1,2,0.6922611489122802,"[0, 0, 0, 0, 1, 1, 0, 1, 0, 1]"
12719,1,1,2,0.017130291362963512,"[1, 0, 1, 0, 1, 0, 1, 1, 1, 1]"
12720,1,1,2,0.02116972407620088,"[1, 0, 0, 0, 1, 0, 0, 1, 0, 1]"
12721,1,1,2,0.970362967210882,"[1, 0, 0, 1, 1, 1, 1, 1, 1, 0]"
12722,1,1,2,0.0916711098754972,"[1, 0, 1, 0, 0, 0, 1, 1, 0, 1]"
12723,1,1,2,0.9666438628794451,"[1, 0, 1, 0, 0, 1, 1, 1, 0, 1]"
12724,1,1,2,0.057798719701319445,"[1, 1, 0, 0, 0, 0, 0, 0, 1, 1]"
12725,1,1,2,0.9767999739136509,"[0, 0, 0, 1, 1, 1, 1, 1, 0, 1]"
12726,3,3,6,0.9850391738560935,"[0, 0, 0, 1, 1, 1, 0, 1, 0, 0]"
12727,3,3,6,0.7256614080174603,"[1, 0, 1, 1, 0, 1, 1, 0, 1, 1]"
12728,1,1,2,0.22470780145955593,"[1, 0, 1, 0, 1, 0, 1, 1, 1, 0]"
12729,1,1,2,0.15408175587834771,"[0, 0, 0, 1, 1, 1, 0, 1, 0, 1]"
12730,1,1,2,0.6243993113377925,"[0, 1, 1, 0, 0, 0, 1, 1, 0, 1]"
12731,1,1,2,0.9046185472810149,"[0, 1, 1, 1, 0, 0, 0, 0, 0, 1]"
12732,1,1,2,0.43673345925442963,"[1, 1, 1, 1, 0, 0, 1, 0, 0, 0]"
12733,1,1,2,0.1905181792943843,"[1, 0, 1, 1, 1, 1, 1, 0, 0, 0]"
12734,2,2,4,0.6850335109251304,"[0, 1, 1, 0, 1, 1, 0, 1, 1, 1]"
12735,1,1,2,0.8208930880630633,"[1, 0, 0, 1, 0, 1, 1, 0, 1, 0]"
12736,1,1,2,0.027903452132333695,"[1, 0, 0, 1, 0, 1, 1, 1, 1, 0]"
12737,1,1,2,0.6009318997059852,"[1, 1, 0, 0, 1, 1, 1, 0, 1, 0]"
12738,1,1,2,0.3337350235795812,"[0, 0, 0, 0, 1, 0, 0, 1, 1, 0]"
12739,1,1,2,0.632570538012936,"[0, 0, 1, 1, 0, 1, 0, 0, 1, 0]"
12740,1,1,2,0.8762089464334688,"[0, 0, 1, 0, 1, 0, 1, 1, 0, 0]"
12741,1,1,2,0.09334773624460424,"[1, 1, 1, 0, 1, 0, 1, 1, 1, 1]"
12742,1,1,2,0.2084463347316876,"[1, 0, 1, 0, 0, 1, 1, 1, 1, 1]"
12743,2,2,4,0.940803024199847,"[1, 1, 0, 0, 0, 0, 1, 0, 0, 1]"
12744,2,2,4,0.7924329664758868,"[0, 0, 0, 1, 1, 1, 1, 0, 0, 0]"
12745,1,1,2,0.5587394265608018,"[0, 0, 1, 0, 1, 1, 0, 1, 0, 0]"
12746,1,1,2,0.5342344647212146,"[0, 0, 1, 1, 1, 0, 0, 0, 0, 1]"
12747,1,1,2,0.8839011542369752,"[1, 1, 1, 1, 1, 1, 1, 0, 0, 1]"
12748,1,1,2,0.08657495800901394,"[0, 0, 0, 1, 0, 0, 1, 1, 0, 0]"
12749,2,2,4,0.3952251739280328,"[0, 0, 0, 0, 1, 1, 1, 0, 1, 0]"
12750,1,1,2,0.13653201603818343,"[1, 0, 0, 1, 0, 0, 1, 0, 1, 0]"
12751,1,1,2,0.46243794893376666,"[0, 0, 1, 1, 1, 0, 0, 0, 1, 1]"
12752,1,1,2,0.09998421353578468,"[0, 1, 0, 1, 0, 0, 1, 1, 0, 1]"
12753,1,1,2,0.10030012450317749,"[1, 0, 1, 0, 0, 1, 1, 0, 1, 0]"
12754,1,1,2,0.044637277258070096,"[1, 1, 1, 0, 0, 0, 1, 1, 1, 0]"
12755,1,1,2,0.5581895500736282,"[0, 1, 1, 1, 1, 0, 1, 1, 0, 0]"
12756,1,1,2,0.3766075712679725,"[0, 1, 1, 1, 1, 1, 0, 1, 1, 1]"
12757,1,1,2,0.4077864590210585,"[1, 1, 1, 1, 0, 1, 1, 0, 0, 0]"
12758,1,1,2,0.5963285198320547,"[0, 1, 0, 1, 0, 1, 1, 1, 1, 1]"
12759,1,1,2,0.8990170692510493,"[0, 0, 1, 0, 0, 0, 1, 0, 0, 1]"
12760,1,1,2,0.3497245306017509,"[1, 1, 1, 0, 1, 1, 1, 0, 0, 0]"
12761,1,1,2,0.8618683575395234,"[0, 0, 0, 0, 0, 1, 0, 0, 0, 1]"
12762,1,1,2,0.09139433795257246,"[1, 0, 0, 0, 0, 1, 0, 1, 0, 0]"
12763,1,1,2,0.10554489744094508,"[0, 0, 0, 1, 1, 1, 0, 1, 1, 1]"
12764,2,2,4,0.04844861549196067,"[1, 1, 0, 1, 0, 1, 0, 0, 0, 1]"
12765,2,2,4,0.4744693264290506,"[0, 0, 0, 1, 0, 1, 1, 1, 0, 0]"
12766,1,1,2,0.6856938069849252,"[0, 0, 0, 1, 0, 1, 0, 0, 1, 0]"
12767,1,1,2,0.6435990663769828,"[1, 0, 1, 1, 0, 1, 1, 1, 1, 0]"
12768,1,1,2,0.20946731726843093,"[1, 0, 1, 0, 1, 0, 0, 0, 1, 0]"
12769,1,1,2,0.8966213379563256,"[1, 0, 1, 0, 1, 1, 0, 1, 1, 0]"
12770,1,1,2,0.6827470068293761,"[1, 1, 1, 0, 1, 1, 1, 0, 0, 1]"
12771,1,1,2,0.3512678686945445,"[1, 1, 0, 1, 0, 0, 0, 0, 1, 0]"
12772,1,1,2,0.0005257351754218709,"[0, 1, 0, 0, 1, 1, 0, 0, 0, 0]"
12773,1,1,2,0.36014517328200935,"[1, 1, 0, 0, 0, 1, 0, 0, 0, 1]"
12774,2,2,4,0.6575003534984528,"[0, 1, 1, 1, 0, 0, 0, 1, 0, 1]"
12775,1,1,2,0.69361353263239,"[1, 0, 1, 1, 0, 0, 0, 1, 1, 1]"
12776,1,1,2,0.2828104316997374,"[0, 1, 0, 0, 1, 0, 0, 1, 0, 1]"
12777,1,1,2,0.22087254099417142,"[1, 1, 1, 0, 1, 0, 1, 0, 1, 1]"
12778,1,1,2,0.24709547301630985,"[0, 0, 0, 0, 1, 1, 0, 1, 1, 0]"
12779,1,1,2,0.4410811278322849,"[1, 0, 1, 0, 0, 0, 1, 1, 0, 1]"
12780,1,1,2,0.27628821930011205,"[0, 0, 0, 0, 1, 1, 0, 1, 0, 1]"
12781,1,1,2,0.8114376505248383,"[0, 0, 1, 1, 1, 1, 0, 1, 0, 0]"
12782,1,1,2,0.6101967416459184,"[1, 1, 1, 0, 1, 1, 0, 0, 1, 1]"
12783,1,1,2,0.17064439340105775,"[0, 1, 0, 1, 0, 0, 1, 0, 0, 1]"
12784,1,1,2,0.05484010916158233,"[1, 1, 1, 0, 0, 0, 0, 0, 0, 1]"
12785,2,2,4,0.6164972833412393,"[0, 0, 1, 1, 1, 1, 1, 1, 0, 1]"
12786,2,2,4,0.7123809019695642,"[0, 1, 0, 1, 1, 1, 1, 1, 1, 1]"
12787,1,1,2,0.49488754372688226,"[1, 0, 0, 0, 1, 0, 0, 1, 0, 0]"
12788,1,1,2,0.9977872706246758,"[1, 1, 1, 0, 1, 0, 0, 0, 0, 0]"
12789,1,1,2,0.0925234682230548,"[0, 1, 0, 1, 1, 1, 0, 1, 1, 1]"
12790,1,1,2,0.20517739065091523,"[0, 0, 1, 0, 1, 0, 1, 1, 1, 1]"
12791,1,1,2,0.3657126996281582,"[1, 0, 0, 0, 1, 0, 1, 1, 0, 1]"
12792,2,2,4,0.23087116341746317,"[0, 1, 0, 0, 1, 1, 0, 0, 1, 1]"
12793,2,2,4,0.1698360182021691,"[1, 0, 0, 0, 0, 1, 0, 1, 1, 0]"
12794,1,1,2,0.9189521935280202,"[0, 1, 0, 0, 0, 1, 1, 1, 1, 0]"
12795,1,1,2,0.07063207608052258,"[0, 1, 0, 0, 0, 1, 1, 1, 0, 0]"
12796,1,1,2,0.10445796663539197,"[1, 0, 1, 0, 1, 1, 1, 1, 0, 0]"
12797,1,1,2,0.3492592992733802,"[0, 1, 1, 1, 0, 1, 0, 0, 0, 1]"
12798,1,1,2,0.7141015896522999,"[0, 1, 1, 0, 1, 1, 0, 0, 0, 0]"
12799,1,1,2,0.009988462181001245,"[0, 1, 1, 0, 1, 1, 1, 1, 0, 1]"
12800,1,1,2,0.5683193301264818,"[0, 0, 0, 0, 0, 0, 0, 1, 1, 0]"
12801,1,1,2,0.34180942659448155,"[1, 0, 0, 1, 0, 1, 0, 0, 0, 1]"
12802,1,1,2,0.3921158451258546,"[0, 0, 0, 1, 1, 0, 1, 0, 0, 0]"
12803,1,1,2,0.3678553654765838,"[1, 0, 1, 1, 0, 0, 0, 0, 0, 0]"
12804,2,2,4,0.3645236798039855,"[0, 0, 0, 1, 0, 1, 1, 0, 0, 0]"
12805,1,1,2,0.39016080111640505,"[1, 0, 0, 1, 1, 1, 0, 0, 1, 0]"
12806,2,2,4,0.04835716117995925,"[1, 1, 0, 1, 0, 1, 1, 0, 0, 1]"
12807,1,1,2,0.04417769576120745,"[0, 0, 0, 1, 0, 0, 0, 0, 1, 0]"
12808,1,1,2,0.14616127952108815,"[0, 1, 1, 0, 0, 0, 0, 1, 0, 1]"
12809,1,1,2,0.45403865436158397,"[1, 0, 0, 0, 0, 1, 1, 0, 1, 1]"
12810,1,1,2,0.7860568446937087,"[0, 1, 0, 0, 1, 1, 0, 0, 0, 0]"
12811,1,1,2,0.24581320249113592,"[1, 1, 1, 0, 1, 1, 0, 1, 1, 1]"
12812,1,1,2,0.4541035840530747,"[0, 0, 1, 1, 0, 0, 0, 1, 0, 0]"
12813,1,1,2,0.324126964991416,"[0, 1, 1, 1, 0, 0, 0, 0, 1, 1]"
12814,1,1,2,0.8202045529457584,"[1, 1, 1, 1, 0, 1, 1, 1, 0, 0]"
12815,2,2,4,0.8434921032612779,"[0, 0, 0, 1, 0, 0, 1, 1, 1, 1]"
12816,1,1,2,0.6716853412122292,"[1, 1, 0, 0, 1, 1, 0, 1, 0, 0]"
12817,2,2,4,0.5636868728521272,"[0, 1, 0, 0, 1, 0, 0, 0, 1, 1]"
12818,1,1,2,0.18916026948328446,"[0, 0, 0, 0, 1, 1, 1, 0, 1, 0]"
12819,1,1,2,0.9809364678630169,"[1, 0, 1, 1, 1, 1, 0, 0, 1, 1]"
12820,1,1,2,0.8874981777939507,"[0, 1, 0, 1, 0, 0, 0, 0, 0, 0]"
12821,1,1,2,0.5276539483706049,"[1, 0, 1, 0, 0, 1, 0, 1, 0, 0]"
12822,2,2,4,0.3733382442777702,"[0, 0, 1, 0, 0, 1, 0, 1, 1, 1]"
12823,1,1,2,0.641004538710972,"[0, 0, 0, 1, 0, 1, 1, 1, 1, 0]"
12824,1,1,2,0.7890331279518447,"[0, 1, 0, 1, 0, 0, 1, 1, 0, 0]"
12825,2,2,4,0.054655261101213326,"[0, 0, 1, 1, 1, 0, 0, 1, 1, 0]"
12826,1,1,2,0.2626345902686742,"[0, 1, 0, 0, 1, 1, 1, 1, 1, 1]"
12827,1,1,2,0.2357809027355523,"[0, 0, 0, 1, 1, 0, 0, 0, 1, 0]"
12828,2,2,4,0.45470520672472314,"[1, 1, 0, 1, 1, 0, 0, 1, 0, 1]"
12829,1,1,2,0.731542992347967,"[0, 0, 1, 1, 1, 0, 0, 0, 1, 0]"
12830,1,1,2,0.8868784591294181,"[0, 0, 1, 1, 1, 1, 0, 1, 0, 1]"
12831,2,2,4,0.5210740224692941,"[0, 1, 1, 1, 0, 1, 0, 1, 0, 0]"
12832,1,1,2,0.10072903170632874,"[0, 0, 0, 0, 1, 0, 0, 0, 1, 1]"
12833,1,1,2,0.21061214317761823,"[1, 0, 1, 0, 1, 1, 0, 1, 0, 1]"
12834,1,1,2,0.6205183129240579,"[1, 1, 1, 0, 0, 0, 0, 0, 0, 0]"
12835,2,2,4,0.15103013142074762,"[1, 0, 0, 1, 1, 1, 0, 0, 1, 1]"
12836,1,1,2,0.2779309903372009,"[0, 1, 0, 1, 0, 0, 1, 0, 0, 1]"
12837,1,1,2,0.40831173797165055,"[1, 1, 1, 0, 0, 0, 0, 1, 0, 0]"
12838,1,1,2,0.10150574454408812,"[0, 1, 1, 0, 0, 1, 0, 1, 1, 0]"
12839,1,1,2,0.27925947051804056,"[1, 1, 1, 1, 0, 0, 1, 1, 0, 1]"
12840,1,1,2,0.49093939611340054,"[0, 1, 1, 1, 0, 0, 0, 1, 0, 0]"
12841,1,1,2,0.12529183297823432,"[1, 0, 1, 1, 0, 0, 1, 1, 0, 0]"
12842,2,2,4,0.5108699050839136,"[1, 0, 1, 0, 0, 0, 0, 1, 0, 1]"
12843,1,1,2,0.6046849002331601,"[0, 1, 1, 1, 1, 1, 1, 1, 0, 0]"
12844,1,1,2,0.795596772110906,"[0, 1, 0, 0, 1, 1, 0, 0, 1, 1]"
12845,1,1,2,0.2229370597623852,"[0, 0, 0, 0, 0, 1, 1, 0, 0, 1]"
12846,1,1,2,0.5829090172303037,"[0, 0, 1, 1, 1, 0, 0, 1, 1, 0]"
12847,1,1,2,0.29613404932015497,"[0, 1, 1, 1, 1, 0, 1, 1, 1, 0]"
12848,1,1,2,0.8537090165932656,"[1, 1, 0, 1, 1, 0, 0, 0, 1, 0]"
12849,1,1,2,0.07566568407456609,"[1, 0, 0, 0, 0, 1, 1, 0, 0, 0]"
12850,1,1,2,0.9822413233112789,"[0, 1, 0, 1, 1, 0, 0, 1, 0, 0]"
12851,1,1,2,0.5652999238881243,"[1, 1, 0, 0, 1, 0, 1, 0, 1, 1]"
12852,2,2,4,0.3379983662479159,"[0, 1, 0, 1, 1, 0, 1, 1, 0, 1]"
12853,1,1,2,0.23448327932285873,"[0, 1, 0, 0, 1, 1, 1, 1, 1, 1]"
12854,1,1,2,0.47830316615939705,"[1, 1, 1, 0, 1, 0, 1, 1, 1, 0]"
12855,1,1,2,0.9705075102913875,"[1, 1, 0, 1, 1, 1, 1, 0, 1, 1]"
12856,1,1,2,0.41150717164471706,"[0, 0, 1, 0, 0, 1, 1, 1, 0, 1]"
12857,1,1,2,0.6240819239081301,"[0, 0, 1, 1, 0, 0, 0, 1, 1, 1]"
12858,1,1,2,0.8242622043567098,"[0, 1, 0, 1, 1, 0, 1, 0, 1, 0]"
12859,1,1,2,0.8860507112721685,"[0, 0, 1, 0, 0, 0, 0, 1, 1, 0]"
12860,1,1,2,0.09551027307978788,"[1, 1, 1, 0, 0, 1, 1, 0, 0, 1]"
12861,1,1,2,0.9281789382171746,"[0, 1, 1, 1, 0, 1, 0, 1, 0, 0]"
12862,1,1,2,0.5099775796821905,"[0, 1, 1, 1, 0, 1, 1, 0, 1, 0]"
12863,3,3,6,0.8136757016694658,"[1, 0, 0, 1, 1, 0, 1, 0, 1, 1]"
12864,1,1,2,0.23935082012352948,"[1, 1, 1, 0, 0, 0, 1, 1, 0, 0]"
12865,1,1,2,0.6587385242385496,"[1, 1, 1, 0, 0, 0, 1, 1, 0, 0]"
12866,1,1,2,0.6075682137680568,"[0, 0, 0, 1, 0, 0, 0, 0, 1, 1]"
12867,4,4,8,0.47471277755330177,"[1, 0, 0, 1, 0, 0, 1, 0, 0, 1]"
12868,2,2,4,0.1152954452148458,"[0, 1, 1, 1, 1, 1, 0, 1, 0, 1]"
12869,2,2,4,0.7310880222789552,"[1, 1, 0, 0, 1, 0, 1, 1, 0, 1]"
12870,1,1,2,0.6422666080269789,"[0, 1, 0, 1, 1, 1, 1, 1, 0, 0]"
12871,1,1,2,0.9276437017073694,"[0, 0, 1, 0, 1, 0, 1, 0, 0, 0]"
12872,1,1,2,0.35618300323539187,"[1, 1, 0, 0, 1, 1, 0, 0, 1, 1]"
12873,1,1,2,0.4724233789894915,"[0, 0, 1, 1, 1, 0, 0, 1, 0, 1]"
12874,1,1,2,0.014619406528104006,"[1, 0, 0, 0, 0, 1, 1, 1, 0, 1]"
12875,1,1,2,0.4176130759406378,"[0, 1, 0, 0, 0, 1, 0, 1, 1, 1]"
12876,2,2,4,0.5219541663951747,"[0, 0, 0, 0, 1, 1, 1, 1, 1, 0]"
12877,1,1,2,0.6165652804294144,"[1, 1, 0, 1, 1, 1, 0, 1, 1, 0]"
12878,1,1,2,0.6483533498671068,"[1, 0, 1, 0, 1, 0, 1, 0, 0, 0]"
12879,1,1,2,0.6451194441017432,"[0, 0, 0, 1, 1, 0, 0, 0, 1, 1]"
12880,1,1,2,0.3667307148399791,"[0, 1, 1, 1, 1, 0, 0, 1, 0, 0]"
12881,2,2,4,0.8190656835062394,"[1, 1, 1, 0, 1, 0, 1, 1, 0, 1]"
12882,1,1,2,0.8640638604135706,"[1, 0, 1, 1, 1, 0, 1, 1, 0, 0]"
12883,1,1,2,0.1362098346398678,"[1, 0, 1, 1, 1, 0, 1, 0, 0, 1]"
12884,1,1,2,0.5718456949090112,"[1, 0, 1, 1, 1, 1, 1, 1, 1, 1]"
12885,1,1,2,0.7390697072633864,"[0, 1, 1, 0, 1, 0, 1, 1, 0, 0]"
12886,1,1,2,0.0395306248503734,"[0, 0, 1, 1, 1, 0, 1, 0, 1, 1]"
12887,3,3,6,0.4205884305913079,"[1, 0, 0, 1, 0, 0, 1, 1, 0, 0]"
12888,1,1,2,0.7910774650583547,"[1, 0, 0, 0, 1, 1, 0, 0, 0, 0]"
12889,1,1,2,0.34284857576287664,"[0, 0, 0, 1, 1, 0, 1, 0, 0, 1]"
12890,1,1,2,0.7496117484113364,"[1, 0, 1, 1, 1, 1, 0, 1, 0, 1]"
12891,1,1,2,0.47507203335120385,"[1, 1, 1, 0, 0, 1, 1, 1, 1, 1]"
12892,1,1,2,0.6875568979362011,"[1, 0, 1, 0, 0, 0, 0, 1, 0, 1]"
12893,1,1,2,0.9100567589931924,"[1, 1, 1, 0, 0, 0, 1, 0, 1, 1]"
12894,1,1,2,0.0847201519266314,"[0, 0, 0, 1, 1, 0, 0, 1, 0, 0]"
12895,1,1,2,0.7861178740954426,"[1, 0, 0, 0, 0, 1, 0, 1, 0, 0]"
12896,1,1,2,0.11083959257923304,"[0, 0, 1, 0, 1, 1, 0, 0, 1, 1]"
12897,1,1,2,0.8861744155351864,"[0, 0, 1, 1, 1, 0, 1, 1, 0, 1]"
12898,2,2,4,0.8276538455027672,"[0, 1, 0, 1, 1, 0, 1, 0, 0, 1]"
12899,1,1,2,0.28522719333400115,"[0, 1, 0, 1, 1, 1, 0, 0, 1, 0]"
12900,1,1,2,0.4992725075177661,"[0, 1, 0, 1, 0, 0, 0, 1, 0, 1]"
12901,1,1,2,0.48647388635659583,"[0, 0, 1, 1, 1, 1, 1, 0, 0, 1]"
12902,1,1,2,0.7509841327633492,"[1, 1, 1, 1, 0, 1, 0, 0, 1, 0]"
12903,1,1,2,0.7069154224173727,"[1, 0, 1, 0, 1, 1, 1, 1, 1, 0]"
12904,1,1,2,0.4829695241129406,"[0, 0, 1, 0, 1, 1, 0, 0, 0, 0]"
12905,1,1,2,0.3335446870736051,"[1, 1, 1, 0, 0, 0, 1, 1, 0, 1]"
12906,1,1,2,0.9675754846029787,"[0, 1, 0, 1, 0, 0, 0, 1, 0, 1]"
12907,2,2,4,0.759032242880142,"[0, 1, 1, 0, 0, 0, 1, 1, 1, 1]"
12908,1,1,2,0.6461073087153897,"[1, 1, 0, 1, 0, 0, 0, 1, 0, 1]"
12909,2,2,4,0.2650592472156177,"[1, 1, 1, 1, 0, 0, 1, 1, 0, 0]"
12910,1,1,2,0.130063860898898,"[0, 1, 1, 1, 1, 0, 0, 0, 1, 0]"
12911,1,1,2,0.008823525678874677,"[1, 0, 1, 0, 0, 1, 1, 1, 0, 1]"
12912,1,1,2,0.32054840603262813,"[1, 0, 0, 0, 0, 0, 1, 0, 0, 1]"
12913,1,1,2,0.7115308616645085,"[1, 0, 1, 0, 0, 1, 1, 0, 1, 0]"
12914,1,1,2,0.1443632104420841,"[1, 1, 1, 0, 1, 0, 0, 1, 0, 1]"
12915,2,2,4,0.41978042724669007,"[0, 1, 0, 1, 0, 0, 0, 0, 1, 1]"
12916,1,1,2,0.824315253558809,"[0, 1, 0, 0, 0, 0, 0, 1, 0, 1]"
12917,1,1,2,0.2504134619278906,"[0, 1, 0, 1, 1, 0, 0, 0, 0, 0]"
12918,2,2,4,0.9159760766996424,"[1, 0, 0, 0, 1, 1, 0, 1, 1, 1]"
12919,3,3,6,0.8289451622101736,"[0, 0, 1, 0, 1, 1, 0, 0, 1, 1]"
12920,2,2,4,0.6865388992824982,"[1, 1, 0, 1, 1, 1, 1, 0, 1, 1]"
12921,1,1,2,0.8960804893692914,"[1, 1, 0, 0, 1, 0, 1, 0, 1, 0]"
12922,3,3,6,0.5140439821790618,"[0, 1, 1, 1, 1, 1, 0, 1, 1, 1]"
12923,1,1,2,0.7715292999393972,"[0, 0, 1, 0, 1, 0, 1, 1, 1, 0]"
12924,1,1,2,0.9205437317370029,"[0, 0, 1, 0, 1, 0, 1, 1, 1, 1]"
12925,2,2,4,0.724189725644349,"[0, 1, 0, 0, 1, 1, 1, 0, 0, 1]"
12926,1,1,2,0.930390340610008,"[0, 1, 0, 1, 0, 1, 1, 0, 1, 0]"
12927,1,1,2,0.4599225542970413,"[1, 1, 0, 0, 0, 0, 0, 0, 0, 0]"
12928,1,1,2,0.7471086580465476,"[1, 1, 1, 1, 1, 1, 1, 0, 0, 0]"
12929,1,1,2,0.08550385662388837,"[1, 1, 1, 0, 1, 1, 0, 0, 1, 0]"
12930,1,1,2,0.7825800551783928,"[1, 1, 0, 0, 0, 0, 0, 0, 0, 1]"
12931,1,1,2,0.20368954604727252,"[0, 0, 0, 1, 1, 0, 0, 1, 0, 1]"
12932,1,1,2,0.27524395759036,"[1, 0, 0, 1, 0, 1, 0, 1, 1, 0]"
12933,1,1,2,0.8071735418306132,"[0, 1, 1, 0, 0, 0, 0, 0, 1, 1]"
12934,1,1,2,0.7677216162684724,"[1, 0, 1, 1, 0, 1, 0, 1, 1, 1]"
12935,1,1,2,0.8068338307514574,"[0, 0, 0, 0, 0, 1, 1, 0, 0, 0]"
12936,1,1,2,0.045793832945268176,"[0, 1, 0, 0, 1, 0, 0, 0, 1, 0]"
12937,2,2,4,0.8603952322331757,"[1, 1, 1, 1, 1, 0, 1, 1, 1, 0]"
12938,1,1,2,0.1857116087791406,"[0, 1, 0, 0, 0, 0, 0, 0, 1, 1]"
12939,4,4,8,0.4053286904970955,"[0, 1, 0, 1, 1, 0, 0, 1, 0, 1]"
12940,1,1,2,0.7590754669566433,"[0, 0, 0, 1, 1, 1, 0, 1, 1, 1]"
12941,1,1,2,0.4414553750976835,"[1, 0, 0, 0, 0, 0, 0, 0, 1, 1]"
12942,1,1,2,0.7933944463968735,"[0, 1, 1, 0, 0, 1, 0, 0, 0, 1]"
12943,3,3,6,0.38763947956653144,"[1, 0, 1, 0, 1, 1, 1, 1, 1, 1]"
12944,1,1,2,0.8315998315734924,"[1, 1, 0, 0, 1, 1, 1, 1, 0, 1]"
12945,1,1,2,0.09830249657858547,"[1, 0, 1, 1, 1, 0, 1, 0, 0, 1]"
12946,1,1,2,0.5157070676656593,"[1, 0, 0, 0, 0, 1, 0, 0, 0, 0]"
12947,1,1,2,0.2740898876135781,"[1, 1, 0, 1, 0, 1, 0, 0, 1, 0]"
12948,1,1,2,0.32916129602098,"[1, 1, 0, 1, 1, 1, 1, 1, 1, 1]"
12949,1,1,2,0.2261242679024532,"[0, 0, 1, 1, 1, 0, 0, 1, 0, 0]"
12950,1,1,2,0.1354463040498548,"[1, 1, 1, 0, 1, 0, 0, 1, 0, 0]"
12951,2,2,4,0.4707778022838158,"[1, 0, 1, 0, 1, 0, 0, 1, 0, 0]"
12952,1,1,2,0.8853768031017059,"[0, 0, 0, 0, 1, 0, 1, 0, 1, 0]"
12953,1,1,2,0.9598965788824549,"[0, 1, 1, 0, 0, 0, 0, 1, 0, 1]"
12954,1,1,2,0.8027700293750863,"[0, 1, 0, 0, 0, 1, 0, 1, 0, 1]"
12955,1,1,2,0.15536076639883567,"[1, 1, 0, 0, 1, 0, 1, 0, 0, 0]"
12956,2,2,4,0.27923860849609095,"[0, 0, 0, 1, 1, 1, 1, 0, 0, 1]"
12957,1,1,2,0.3794349725747971,"[0, 0, 1, 1, 0, 1, 0, 1, 0, 1]"
12958,2,2,4,0.7460046421129726,"[0, 0, 1, 0, 1, 1, 0, 0, 1, 1]"
12959,1,1,2,0.025475492917485076,"[0, 0, 0, 0, 0, 1, 0, 1, 1, 1]"
12960,1,1,2,0.38074442425345434,"[1, 1, 0, 1, 0, 1, 1, 0, 1, 1]"
12961,1,1,2,0.6176744630125275,"[1, 1, 0, 1, 1, 1, 1, 1, 0, 1]"
12962,1,1,2,0.6783563984870676,"[1, 1, 0, 1, 0, 0, 1, 0, 1, 0]"
12963,1,1,2,0.9729045809167693,"[0, 0, 0, 1, 0, 0, 1, 0, 0, 0]"
12964,3,3,6,0.7414735872863661,"[1, 0, 1, 0, 0, 1, 1, 0, 1, 1]"
12965,1,1,2,0.7393172279772167,"[1, 1, 1, 0, 0, 1, 1, 0, 1, 0]"
12966,2,2,4,0.6176326761464251,"[0, 0, 0, 0, 1, 1, 1, 0, 1, 0]"
12967,1,1,2,0.0345946133422943,"[1, 1, 1, 1, 1, 0, 1, 1, 1, 0]"
12968,1,1,2,0.9261260387874163,"[0, 1, 0, 0, 1, 1, 0, 0, 0, 1]"
12969,1,1,2,0.1326506561523929,"[0, 0, 1, 0, 0, 1, 1, 1, 0, 0]"
12970,1,1,2,0.593217162327762,"[0, 1, 0, 1, 0, 0, 0, 1, 0, 1]"
12971,1,1,2,0.05568866964299202,"[0, 0, 1, 1, 0, 1, 1, 0, 0, 0]"
12972,1,1,2,0.08739594834913988,"[0, 1, 0, 1, 0, 0, 0, 0, 0, 1]"
12973,1,1,2,0.4066053890373289,"[1, 0, 1, 1, 1, 1, 0, 0, 1, 1]"
12974,2,2,4,0.5722985253639616,"[1, 1, 0, 1, 1, 1, 1, 1, 1, 0]"
12975,1,1,2,0.8547037581194046,"[1, 0, 1, 0, 0, 1, 1, 1, 0, 0]"
12976,1,1,2,0.3987599293654637,"[1, 0, 0, 0, 1, 0, 1, 0, 1, 0]"
12977,1,1,2,0.11107171631506885,"[0, 0, 1, 0, 1, 0, 0, 0, 1, 0]"
12978,1,1,2,0.5374488439028179,"[0, 0, 0, 0, 0, 1, 0, 1, 1, 0]"
12979,1,1,2,0.4268752376713102,"[1, 0, 0, 0, 0, 1, 0, 1, 1, 0]"
12980,1,1,2,0.7981418927629569,"[0, 0, 1, 0, 1, 0, 0, 1, 0, 1]"
12981,1,1,2,0.684088240402518,"[0, 1, 1, 1, 1, 0, 0, 0, 1, 1]"
12982,1,1,2,0.7802405799457517,"[1, 0, 1, 0, 0, 0, 0, 0, 0, 1]"
12983,1,1,2,0.7458499845585261,"[0, 0, 1, 1, 0, 0, 0, 0, 0, 1]"
12984,1,1,2,0.3837572354555373,"[0, 0, 0, 1, 1, 0, 0, 0, 0, 0]"
12985,2,2,4,0.004458165190127428,"[1, 1, 0, 1, 0, 0, 0, 0, 0, 0]"
12986,2,2,4,0.7593586319064359,"[0, 1, 0, 1, 1, 0, 0, 1, 0, 1]"
12987,1,1,2,0.9859372946814662,"[0, 0, 1, 1, 1, 1, 1, 1, 0, 0]"
12988,1,1,2,0.14710819309814194,"[0, 1, 1, 1, 0, 0, 0, 0, 1, 1]"
12989,1,1,2,0.01755824223288316,"[0, 0, 1, 0, 1, 0, 1, 0, 0, 1]"
12990,1,1,2,0.9561431602197268,"[0, 0, 1, 0, 1, 1, 1, 1, 1, 0]"
12991,1,1,2,0.4152272068328726,"[1, 0, 0, 1, 1, 1, 1, 1, 0, 0]"
12992,1,1,2,0.4351033519152532,"[0, 0, 0, 1, 0, 1, 0, 1, 0, 0]"
12993,1,1,2,0.1744100986306325,"[1, 0, 0, 0, 1, 1, 0, 0, 1, 1]"
12994,1,1,2,0.04761630545445428,"[1, 0, 1, 1, 0, 1, 0, 1, 1, 1]"
12995,1,1,2,0.1654459412567042,"[1, 1, 1, 1, 0, 0, 1, 1, 0, 1]"
12996,1,1,2,0.09747608944054442,"[1, 0, 0, 0, 1, 0, 0, 1, 0, 1]"
12997,1,1,2,0.15453983615582256,"[0, 1, 0, 1, 1, 0, 0, 0, 1, 0]"
12998,1,1,2,0.6116710635864184,"[0, 1, 0, 0, 0, 1, 1, 0, 1, 0]"
12999,1,1,2,0.11180014751741119,"[0, 0, 1, 0, 1, 1, 0, 0, 0, 1]"
13000,1,1,2,0.7700692143883071,"[1, 0, 0, 0, 1, 0, 1, 1, 0, 1]"
13001,1,1,2,0.5239641658248348,"[0, 1, 1, 0, 1, 1, 0, 1, 0, 0]"
13002,1,1,2,0.049220611130724845,"[1, 0, 1, 1, 1, 0, 0, 0, 0, 0]"
13003,1,1,2,0.36815971011013326,"[1, 1, 0, 0, 1, 0, 0, 0, 0, 0]"
13004,2,2,4,0.2358752955806036,"[0, 0, 1, 1, 1, 1, 1, 0, 1, 0]"
13005,1,1,2,0.07304722704070887,"[1, 1, 1, 1, 1, 1, 1, 1, 1, 0]"
13006,2,2,4,0.6384135184562051,"[0, 0, 1, 0, 1, 1, 1, 0, 0, 0]"
13007,1,1,2,0.5957057136114414,"[0, 1, 0, 1, 0, 1, 0, 0, 1, 0]"
13008,1,1,2,0.23917310297715655,"[1, 0, 1, 0, 0, 0, 0, 0, 0, 0]"
13009,1,1,2,0.405330290360137,"[0, 0, 0, 0, 0, 0, 0, 1, 0, 1]"
13010,1,1,2,0.49679720921357373,"[0, 0, 1, 1, 0, 1, 1, 1, 0, 1]"
13011,1,1,2,0.6792069518425933,"[1, 0, 0, 0, 0, 1, 1, 1, 0, 1]"
13012,1,1,2,0.835389239600401,"[1, 1, 1, 1, 0, 0, 0, 0, 0, 0]"
13013,1,1,2,0.5000067585694643,"[0, 0, 1, 0, 0, 0, 1, 0, 0, 0]"
13014,1,1,2,0.9836507138235394,"[0, 0, 0, 0, 1, 0, 1, 1, 0, 0]"
13015,1,1,2,0.7331994428173368,"[0, 1, 0, 0, 1, 0, 1, 0, 1, 0]"
13016,3,3,6,0.9480203571828737,"[0, 0, 0, 1, 1, 1, 1, 0, 1, 0]"
13017,1,1,2,0.4936347980761272,"[1, 0, 0, 0, 0, 0, 1, 1, 1, 1]"
13018,2,2,4,0.7550060452860858,"[0, 1, 0, 1, 0, 1, 1, 1, 0, 0]"
13019,1,1,2,0.5211732769041414,"[1, 1, 1, 1, 0, 0, 1, 0, 0, 0]"
13020,1,1,2,0.8790303729045879,"[0, 0, 1, 0, 0, 1, 0, 0, 0, 0]"
13021,3,3,6,0.030805016557255427,"[1, 1, 0, 1, 0, 0, 1, 0, 0, 1]"
13022,1,1,2,0.9552488702751759,"[0, 0, 0, 1, 0, 0, 0, 1, 0, 0]"
13023,1,1,2,0.16018614539717346,"[1, 0, 1, 1, 0, 0, 1, 1, 0, 0]"
13024,1,1,2,0.6566451405071717,"[1, 1, 0, 1, 0, 0, 0, 0, 0, 1]"
13025,1,1,2,0.04987486873852398,"[0, 0, 0, 0, 1, 1, 0, 1, 1, 0]"
13026,1,1,2,0.4653833137829443,"[1, 0, 1, 0, 0, 0, 0, 1, 0, 1]"
13027,1,1,2,0.7871286445466359,"[1, 0, 0, 0, 0, 1, 1, 1, 1, 0]"
13028,1,1,2,0.038354891704663996,"[0, 0, 1, 0, 0, 1, 0, 1, 0, 0]"
13029,1,1,2,0.3342517645331654,"[0, 0, 0, 1, 1, 0, 1, 0, 0, 1]"
13030,1,1,2,0.9155407334791078,"[0, 0, 0, 1, 1, 1, 0, 0, 1, 1]"
13031,1,1,2,0.36887158175037704,"[0, 0, 1, 1, 0, 1, 1, 1, 1, 1]"
13032,1,1,2,0.8724402821417541,"[1, 0, 1, 0, 1, 0, 1, 1, 0, 0]"
13033,2,2,4,0.06468350020366731,"[1, 1, 1, 1, 1, 0, 1, 0, 1, 0]"
13034,1,1,2,0.9327980307433101,"[0, 1, 1, 1, 0, 0, 0, 1, 1, 0]"
13035,1,1,2,0.5631847184615232,"[0, 1, 0, 1, 1, 1, 1, 0, 0, 0]"
13036,1,1,2,0.6852231883168802,"[0, 0, 1, 0, 1, 1, 0, 0, 1, 1]"
13037,1,1,2,0.8930360744340408,"[0, 0, 0, 1, 0, 1, 1, 0, 0, 0]"
13038,1,1,2,0.45507980910109236,"[1, 0, 0, 1, 0, 0, 0, 0, 1, 1]"
13039,1,1,2,0.7223578276091617,"[0, 0, 1, 1, 1, 0, 1, 0, 1, 1]"
13040,1,1,2,0.418127061446501,"[0, 0, 1, 1, 0, 1, 0, 0, 0, 0]"
13041,1,1,2,0.6488986999755649,"[0, 1, 0, 0, 0, 0, 0, 1, 1, 1]"
13042,1,1,2,0.17943257579722582,"[1, 0, 0, 1, 1, 1, 0, 0, 1, 0]"
13043,1,1,2,0.020474209519196207,"[1, 0, 0, 0, 0, 0, 1, 0, 0, 1]"
13044,1,1,2,0.8747433024202992,"[1, 1, 1, 0, 1, 0, 0, 1, 1, 1]"
13045,1,1,2,0.5927359040242053,"[0, 1, 0, 0, 1, 1, 1, 1, 1, 0]"
13046,2,2,4,0.23405837165502663,"[1, 1, 1, 1, 0, 1, 1, 1, 0, 1]"
13047,1,1,2,0.6147057303899875,"[1, 1, 1, 1, 1, 0, 0, 0, 1, 1]"
13048,1,1,2,0.2308250593404112,"[0, 0, 0, 0, 0, 0, 1, 1, 0, 0]"
13049,1,1,2,0.2118539847327615,"[0, 1, 0, 1, 0, 1, 1, 1, 1, 1]"
13050,1,1,2,0.11757054695001057,"[0, 1, 1, 0, 0, 1, 0, 1, 0, 1]"
13051,1,1,2,0.7258368026234701,"[1, 1, 1, 1, 1, 0, 1, 1, 1, 0]"
13052,1,1,2,0.692628052214327,"[0, 0, 1, 0, 0, 0, 0, 0, 1, 0]"
13053,2,2,4,0.005167599105789011,"[0, 0, 0, 0, 0, 0, 1, 1, 1, 1]"
13054,1,1,2,0.48789619800138173,"[1, 1, 0, 0, 1, 1, 0, 1, 1, 0]"
13055,1,1,2,0.7689936026202565,"[0, 0, 1, 0, 0, 1, 0, 0, 1, 1]"
13056,1,1,2,0.7460244040617026,"[1, 0, 0, 0, 1, 1, 1, 1, 0, 1]"
13057,1,1,2,0.07233640395972085,"[0, 0, 0, 0, 0, 0, 0, 1, 0, 1]"
13058,1,1,2,0.05561924342454172,"[0, 1, 0, 0, 1, 0, 0, 0, 1, 0]"
13059,1,1,2,0.4718403772970734,"[0, 1, 1, 1, 1, 0, 0, 0, 0, 0]"
13060,1,1,2,0.47426528107756205,"[1, 1, 0, 1, 1, 1, 0, 0, 0, 1]"
13061,1,1,2,0.3477388260195764,"[0, 1, 0, 0, 1, 0, 1, 0, 0, 0]"
13062,2,2,4,0.6382322819218355,"[0, 1, 1, 1, 1, 0, 0, 1, 0, 0]"
13063,1,1,2,0.8376841047065549,"[1, 1, 0, 1, 1, 0, 0, 1, 1, 1]"
13064,1,1,2,0.9550314764072916,"[0, 1, 0, 0, 0, 0, 0, 1, 0, 0]"
13065,1,1,2,0.6959180619922324,"[0, 0, 1, 0, 0, 1, 1, 0, 1, 0]"
13066,3,3,6,0.3124375451247816,"[1, 0, 1, 1, 1, 1, 0, 0, 1, 0]"
13067,1,1,2,0.2276431744151749,"[0, 1, 0, 0, 0, 0, 1, 1, 0, 1]"
13068,1,1,2,0.5121834663686665,"[0, 0, 0, 1, 1, 0, 1, 0, 1, 0]"
13069,1,1,2,0.3936203114458342,"[1, 1, 0, 0, 0, 0, 1, 1, 1, 0]"
13070,1,1,2,0.22170670284651472,"[0, 1, 1, 0, 0, 1, 1, 1, 1, 1]"
13071,1,1,2,0.9835730129969069,"[1, 1, 0, 0, 1, 0, 1, 0, 1, 1]"
13072,2,2,4,0.0057691957447592035,"[1, 0, 0, 1, 1, 0, 0, 1, 0, 1]"
13073,3,3,6,0.5743844381132452,"[1, 1, 0, 1, 0, 0, 0, 1, 0, 0]"
13074,2,2,4,0.7236093206538607,"[0, 1, 0, 1, 0, 0, 0, 1, 1, 1]"
13075,3,3,6,0.8413436810049932,"[0, 1, 1, 1, 1, 1, 0, 0, 1, 0]"
13076,2,2,4,0.22847418609786596,"[1, 0, 0, 0, 1, 1, 1, 1, 0, 1]"
13077,3,3,6,0.3118187882390604,"[1, 1, 1, 1, 1, 0, 0, 0, 1, 0]"
13078,1,1,2,0.1734852765298629,"[1, 1, 0, 0, 1, 1, 1, 1, 0, 1]"
13079,1,1,2,0.974112961246381,"[0, 1, 1, 1, 1, 1, 1, 0, 0, 1]"
13080,1,1,2,0.1548969077257627,"[1, 0, 1, 1, 1, 0, 1, 0, 0, 1]"
13081,1,1,2,0.943485158912491,"[0, 0, 0, 1, 1, 1, 1, 0, 1, 1]"
13082,1,1,2,0.7137277048287308,"[1, 0, 1, 1, 0, 1, 0, 1, 1, 0]"
13083,1,1,2,0.26321417067071984,"[1, 0, 0, 1, 0, 1, 1, 1, 1, 1]"
13084,1,1,2,0.7355981273045158,"[1, 1, 0, 0, 1, 1, 0, 0, 0, 1]"
13085,1,1,2,0.5305408846172845,"[1, 0, 0, 0, 1, 0, 1, 1, 1, 0]"
13086,1,1,2,0.6566898050573649,"[1, 1, 0, 0, 1, 0, 1, 1, 1, 1]"
13087,1,1,2,0.9146817590576071,"[1, 1, 0, 0, 1, 0, 0, 0, 1, 1]"
13088,1,1,2,0.008514455785618158,"[0, 1, 1, 1, 1, 0, 0, 0, 1, 0]"
13089,1,1,2,0.8022549776045617,"[0, 1, 1, 1, 0, 1, 1, 1, 1, 1]"
13090,1,1,2,0.2885690426617896,"[0, 1, 1, 0, 1, 0, 0, 0, 1, 0]"
13091,1,1,2,0.07147174976109605,"[1, 0, 0, 0, 1, 1, 0, 0, 1, 0]"
13092,1,1,2,0.8509063135870368,"[1, 0, 0, 0, 1, 1, 1, 0, 1, 1]"
13093,1,1,2,0.2846032530538778,"[0, 1, 0, 0, 1, 1, 1, 0, 0, 1]"
13094,2,2,4,0.7874342968629324,"[0, 1, 1, 1, 0, 1, 1, 1, 1, 0]"
13095,1,1,2,0.49728971904945707,"[0, 0, 1, 0, 1, 1, 1, 1, 0, 1]"
13096,1,1,2,0.6288656392920764,"[1, 1, 1, 1, 1, 1, 1, 1, 0, 1]"
13097,1,1,2,0.2614379656699872,"[0, 1, 0, 1, 0, 1, 1, 1, 0, 1]"
13098,1,1,2,0.2976375802661798,"[0, 1, 0, 1, 1, 0, 1, 1, 0, 1]"
13099,1,1,2,0.6130472441402918,"[0, 0, 0, 0, 0, 0, 1, 0, 0, 1]"
13100,1,1,2,0.02595564270897166,"[1, 1, 0, 1, 0, 1, 0, 1, 1, 1]"
13101,1,1,2,0.09111983230500997,"[0, 0, 0, 1, 0, 0, 1, 1, 0, 1]"
13102,1,1,2,0.9499179295804994,"[0, 1, 1, 0, 1, 0, 0, 0, 0, 0]"
13103,1,1,2,0.10847160164321801,"[0, 1, 0, 1, 1, 1, 1, 1, 1, 1]"
13104,2,2,4,0.5175007154502751,"[0, 0, 1, 1, 0, 1, 0, 1, 1, 0]"
13105,1,1,2,0.6915892199187993,"[1, 0, 0, 0, 1, 0, 0, 0, 1, 0]"
13106,1,1,2,0.27431227421325965,"[0, 1, 1, 0, 0, 0, 0, 1, 0, 1]"
13107,1,1,2,0.2546604616442071,"[0, 1, 0, 0, 0, 0, 0, 0, 1, 0]"
13108,1,1,2,0.2539441647344568,"[0, 0, 1, 1, 0, 0, 0, 1, 0, 0]"
13109,1,1,2,0.6198318763395245,"[0, 1, 0, 1, 0, 0, 1, 0, 0, 0]"
13110,1,1,2,0.7933870323227834,"[0, 1, 1, 1, 0, 1, 1, 0, 0, 1]"
13111,1,1,2,0.2012571541081306,"[1, 0, 1, 1, 0, 0, 1, 1, 0, 0]"
13112,2,2,4,0.5370764642824141,"[1, 1, 0, 0, 0, 0, 1, 1, 0, 1]"
13113,1,1,2,0.20890082287850276,"[1, 1, 0, 0, 0, 0, 0, 1, 1, 0]"
13114,1,1,2,0.47576094813794645,"[1, 1, 0, 0, 0, 0, 1, 0, 1, 0]"
13115,2,2,4,0.6575383016713287,"[1, 0, 1, 1, 1, 1, 0, 0, 0, 0]"
13116,1,1,2,0.41186402971215086,"[0, 0, 1, 0, 1, 1, 0, 1, 0, 0]"
13117,1,1,2,0.03646973402136844,"[1, 0, 1, 1, 1, 0, 1, 1, 1, 0]"
13118,1,1,2,0.17996442604518237,"[1, 1, 0, 1, 1, 1, 0, 0, 1, 1]"
13119,1,1,2,0.2257790037999594,"[0, 0, 0, 0, 0, 0, 1, 0, 1, 0]"
13120,1,1,2,0.600685047218513,"[0, 0, 0, 0, 1, 0, 1, 1, 0, 0]"
13121,1,1,2,0.577649549056683,"[1, 0, 1, 0, 1, 1, 1, 0, 0, 0]"
13122,1,1,2,0.287452565694981,"[1, 0, 0, 0, 1, 1, 0, 0, 1, 1]"
13123,1,1,2,0.7864152485037919,"[0, 0, 0, 0, 1, 1, 1, 1, 1, 0]"
13124,1,1,2,0.46694524865233333,"[0, 0, 0, 1, 1, 1, 1, 0, 1, 1]"
13125,1,1,2,0.44982651055265865,"[0, 1, 0, 1, 0, 0, 1, 1, 0, 0]"
13126,2,2,4,0.49576849962669023,"[0, 1, 0, 0, 1, 0, 1, 0, 0, 1]"
13127,1,1,2,0.45205263320808975,"[1, 1, 0, 0, 0, 0, 0, 1, 1, 1]"
13128,1,1,2,0.9200553714304219,"[1, 0, 0, 0, 0, 1, 1, 1, 1, 0]"
13129,2,2,4,0.03379180123247805,"[1, 0, 1, 0, 0, 0, 1, 1, 1, 1]"
13130,1,1,2,0.13420802307242485,"[0, 1, 0, 1, 0, 1, 1, 0, 0, 0]"
13131,1,1,2,0.47154958028096006,"[0, 0, 0, 0, 1, 1, 0, 0, 0, 0]"
13132,1,1,2,0.1863721101993776,"[0, 1, 0, 1, 1, 1, 0, 1, 0, 1]"
13133,1,1,2,0.12758856599239288,"[0, 1, 0, 1, 0, 0, 1, 1, 0, 1]"
13134,1,1,2,0.2063394322631933,"[1, 1, 0, 1, 0, 0, 0, 1, 0, 1]"
13135,1,1,2,0.3100547363350652,"[0, 1, 1, 0, 0, 0, 1, 0, 0, 1]"
13136,1,1,2,0.20831883932665707,"[0, 1, 1, 0, 0, 1, 1, 0, 1, 0]"
13137,1,1,2,0.30071619612686007,"[0, 1, 1, 1, 1, 0, 1, 0, 0, 1]"
13138,2,2,4,0.34918464727552356,"[0, 1, 0, 1, 1, 1, 1, 0, 1, 0]"
13139,2,2,4,0.4517666135861751,"[0, 1, 1, 1, 0, 1, 0, 0, 1, 0]"
13140,1,1,2,0.36861515086386054,"[1, 0, 1, 1, 0, 0, 0, 0, 1, 1]"
13141,1,1,2,0.5136881288482542,"[1, 1, 1, 0, 0, 0, 0, 0, 1, 1]"
13142,1,1,2,0.8132254980322792,"[0, 0, 1, 1, 0, 0, 0, 1, 1, 1]"
13143,1,1,2,0.6719832793682907,"[1, 1, 1, 0, 1, 1, 1, 0, 1, 1]"
13144,1,1,2,0.3804264411573348,"[0, 0, 1, 0, 1, 0, 1, 1, 0, 0]"
13145,1,1,2,0.9654046763235223,"[1, 1, 0, 1, 1, 0, 0, 1, 0, 0]"
13146,1,1,2,0.5951101981745343,"[0, 0, 0, 1, 0, 0, 0, 1, 1, 1]"
13147,1,1,2,0.6051292337363016,"[0, 0, 0, 0, 0, 0, 0, 0, 0, 1]"
13148,1,1,2,0.8869113154888036,"[0, 0, 1, 1, 1, 1, 1, 0, 0, 0]"
13149,1,1,2,0.42446579485590286,"[0, 0, 0, 0, 0, 0, 1, 0, 1, 0]"
13150,1,1,2,0.5785859471568816,"[1, 0, 1, 0, 0, 1, 1, 0, 1, 1]"
13151,1,1,2,0.6506279307814853,"[1, 0, 0, 0, 1, 1, 1, 1, 0, 0]"
13152,2,2,4,0.5654000683670176,"[1, 1, 1, 0, 1, 0, 0, 1, 1, 0]"
13153,1,1,2,0.9461430852511252,"[0, 1, 1, 0, 0, 0, 1, 1, 1, 1]"
13154,1,1,2,0.3685928373543421,"[0, 0, 1, 1, 0, 1, 1, 1, 0, 0]"
13155,5,5,10,0.260799192831901,"[1, 1, 0, 0, 0, 0, 1, 1, 1, 1]"
13156,1,1,2,0.6360222461667903,"[1, 0, 1, 1, 0, 0, 0, 1, 1, 1]"
13157,1,1,2,0.5045557035874796,"[0, 0, 1, 1, 0, 0, 0, 0, 1, 1]"
13158,1,1,2,0.8337353894392919,"[0, 1, 0, 0, 0, 1, 0, 0, 1, 1]"
13159,1,1,2,0.5756215195139692,"[0, 0, 0, 1, 1, 0, 1, 1, 0, 1]"
13160,1,1,2,0.8340214749859857,"[0, 1, 0, 1, 0, 0, 0, 1, 1, 1]"
13161,1,1,2,0.554023011911025,"[0, 1, 1, 0, 0, 1, 1, 0, 1, 1]"
13162,1,1,2,0.22110654151890108,"[0, 1, 0, 1, 1, 1, 0, 0, 0, 0]"
13163,1,1,2,0.312289212975968,"[1, 0, 0, 1, 1, 0, 0, 1, 1, 0]"
13164,1,1,2,0.25517408450686585,"[0, 0, 0, 1, 0, 0, 0, 1, 1, 0]"
13165,1,1,2,0.8751818823171847,"[0, 1, 1, 0, 0, 0, 0, 1, 1, 1]"
13166,1,1,2,0.03402079612706044,"[1, 0, 1, 1, 0, 1, 0, 1, 0, 0]"
13167,1,1,2,0.18158423069506702,"[1, 0, 0, 1, 1, 1, 0, 0, 0, 0]"
13168,1,1,2,0.2685078011616133,"[0, 0, 1, 0, 1, 0, 1, 1, 0, 0]"
13169,1,1,2,0.9453845687347638,"[1, 1, 1, 1, 0, 1, 0, 0, 0, 1]"
13170,1,1,2,0.15967798201814398,"[0, 0, 1, 1, 0, 1, 1, 1, 1, 1]"
13171,1,1,2,0.22980847446534347,"[1, 0, 0, 1, 1, 0, 0, 0, 1, 1]"
13172,1,1,2,0.4271529574895544,"[0, 1, 0, 1, 0, 0, 0, 0, 1, 1]"
13173,1,1,2,0.6754557117407379,"[1, 1, 1, 0, 0, 1, 0, 0, 0, 0]"
13174,3,3,6,0.8236606272189229,"[1, 0, 1, 0, 1, 1, 1, 0, 0, 0]"
13175,2,2,4,0.3924976236675066,"[0, 0, 1, 1, 0, 1, 0, 1, 0, 1]"
13176,1,1,2,0.908943694195431,"[0, 0, 1, 0, 1, 1, 0, 0, 1, 1]"
13177,1,1,2,0.4800821798749083,"[1, 0, 0, 1, 1, 1, 0, 0, 0, 1]"
13178,1,1,2,0.5380166425818236,"[1, 1, 1, 1, 0, 1, 0, 1, 1, 1]"
13179,1,1,2,0.8233853793265503,"[1, 0, 0, 0, 0, 1, 1, 1, 1, 0]"
13180,1,1,2,0.3327783261373708,"[1, 1, 1, 1, 0, 0, 1, 1, 1, 1]"
13181,1,1,2,0.21810952411515805,"[0, 1, 1, 0, 1, 0, 1, 1, 1, 0]"
13182,1,1,2,0.7179101728674065,"[1, 1, 1, 1, 0, 1, 1, 0, 0, 0]"
13183,2,2,4,0.5275038192037779,"[1, 0, 0, 0, 1, 1, 0, 1, 0, 0]"
13184,2,2,4,0.992133262751086,"[1, 1, 1, 0, 0, 1, 0, 1, 1, 1]"
13185,1,1,2,0.395986463322775,"[0, 1, 0, 0, 1, 1, 1, 1, 0, 1]"
13186,1,1,2,0.13399286948293831,"[0, 0, 1, 0, 0, 1, 0, 1, 1, 1]"
13187,1,1,2,0.8663464818056849,"[0, 1, 0, 1, 0, 0, 1, 0, 1, 1]"
13188,2,2,4,0.2496811693622103,"[1, 0, 1, 1, 1, 1, 0, 1, 1, 1]"
13189,1,1,2,0.017566358193365272,"[1, 0, 0, 0, 0, 1, 1, 0, 1, 1]"
13190,1,1,2,0.944126248799568,"[0, 0, 0, 1, 1, 1, 0, 1, 0, 0]"
13191,1,1,2,0.6670444010645614,"[0, 0, 1, 0, 0, 0, 0, 1, 0, 0]"
13192,1,1,2,0.9542894008075046,"[1, 1, 1, 0, 1, 1, 1, 0, 0, 0]"
13193,1,1,2,0.07171621199053657,"[1, 1, 0, 1, 1, 1, 1, 0, 0, 0]"
13194,1,1,2,0.2799473744704274,"[0, 0, 0, 1, 1, 1, 0, 1, 0, 1]"
13195,1,1,2,0.20027228293438382,"[0, 1, 0, 0, 1, 0, 0, 0, 0, 0]"
13196,1,1,2,0.02512940835051869,"[1, 0, 0, 0, 0, 0, 0, 0, 1, 1]"
13197,2,2,4,0.18422541587165298,"[1, 1, 1, 0, 0, 1, 1, 0, 1, 1]"
13198,1,1,2,0.5813112455692433,"[1, 1, 0, 0, 1, 1, 1, 0, 1, 1]"
13199,1,1,2,0.678813920431585,"[0, 0, 0, 0, 0, 1, 1, 0, 1, 0]"
13200,1,1,2,0.22184055734088381,"[1, 1, 1, 0, 1, 0, 0, 0, 1, 0]"
13201,1,1,2,0.85872208804448,"[1, 0, 1, 0, 1, 0, 1, 1, 1, 0]"
13202,1,1,2,0.4952072507367846,"[0, 0, 0, 0, 0, 0, 1, 1, 1, 1]"
13203,2,2,4,0.6760509310877926,"[0, 0, 1, 1, 0, 1, 1, 1, 1, 1]"
13204,1,1,2,0.3945914242167957,"[0, 0, 1, 0, 0, 1, 0, 0, 0, 1]"
13205,2,2,4,0.5738658422210868,"[0, 0, 1, 1, 1, 1, 1, 0, 1, 0]"
13206,1,1,2,0.048108966850578416,"[1, 1, 1, 0, 0, 1, 1, 0, 0, 0]"
13207,1,1,2,0.3721415939081627,"[1, 1, 0, 1, 1, 1, 0, 0, 1, 0]"
13208,2,2,4,0.12262124520645912,"[1, 0, 1, 0, 1, 1, 0, 1, 0, 0]"
13209,1,1,2,0.9647808284495897,"[0, 1, 0, 1, 1, 0, 0, 1, 0, 1]"
13210,2,2,4,0.8825253874467532,"[1, 0, 0, 0, 1, 0, 1, 1, 0, 0]"
13211,1,1,2,0.6397105864073037,"[0, 0, 0, 1, 1, 0, 0, 0, 1, 1]"
13212,1,1,2,0.5869182657994134,"[1, 1, 0, 1, 1, 1, 0, 1, 0, 0]"
13213,1,1,2,0.7014678619485321,"[0, 0, 0, 1, 1, 1, 1, 0, 0, 1]"
13214,1,1,2,0.9283406099916766,"[0, 0, 0, 0, 1, 1, 1, 1, 0, 0]"
13215,2,2,4,0.7559260800995636,"[0, 1, 1, 0, 1, 1, 1, 0, 1, 0]"
13216,1,1,2,0.4713727099097669,"[0, 1, 0, 1, 1, 0, 0, 1, 0, 0]"
13217,1,1,2,0.004816755321664701,"[1, 1, 0, 1, 1, 1, 1, 1, 0, 0]"
13218,1,1,2,0.39013357595234577,"[0, 0, 0, 1, 1, 1, 0, 1, 0, 0]"
13219,2,2,4,0.07018400010045578,"[1, 1, 0, 0, 0, 1, 0, 0, 0, 1]"
13220,2,2,4,0.9416100955565551,"[1, 0, 0, 1, 1, 1, 0, 1, 1, 1]"
13221,1,1,2,0.26459113973411186,"[0, 0, 0, 0, 1, 0, 1, 1, 1, 0]"
13222,1,1,2,0.2057243873521435,"[1, 1, 1, 1, 1, 1, 1, 1, 1, 1]"
13223,1,1,2,0.37969835515091366,"[0, 0, 1, 0, 1, 0, 1, 1, 1, 0]"
13224,1,1,2,0.11371597124545108,"[1, 0, 1, 1, 0, 1, 1, 0, 1, 0]"
13225,1,1,2,0.16327163844241976,"[0, 1, 0, 1, 1, 1, 1, 1, 0, 1]"
13226,1,1,2,0.2734075821729276,"[0, 0, 0, 0, 1, 1, 0, 0, 0, 0]"
13227,1,1,2,0.5973057851157403,"[1, 0, 1, 1, 1, 0, 0, 0, 1, 1]"
13228,1,1,2,0.5043020336997617,"[0, 0, 0, 0, 1, 0, 1, 1, 0, 1]"
13229,1,1,2,0.8170557875825127,"[0, 1, 1, 1, 0, 1, 0, 0, 1, 0]"
13230,1,1,2,0.8073586705016396,"[0, 0, 1, 0, 1, 0, 0, 0, 0, 0]"
13231,1,1,2,0.3292118744575745,"[1, 1, 0, 1, 0, 1, 1, 1, 0, 0]"
13232,2,2,4,0.7804882096333159,"[0, 1, 0, 1, 1, 0, 0, 1, 0, 1]"
13233,1,1,2,0.24050928233938196,"[0, 0, 1, 0, 1, 1, 1, 1, 1, 1]"
13234,1,1,2,0.9698421480286011,"[1, 0, 1, 1, 1, 0, 0, 0, 1, 0]"
13235,1,1,2,0.6260624608048206,"[0, 1, 0, 0, 0, 0, 0, 1, 1, 0]"
13236,1,1,2,0.9906651433386474,"[0, 1, 0, 0, 0, 1, 1, 0, 0, 0]"
13237,1,1,2,0.28862934640509086,"[0, 1, 0, 1, 1, 1, 1, 0, 0, 1]"
13238,2,2,4,0.6467077604621617,"[1, 1, 1, 0, 0, 0, 0, 0, 0, 1]"
13239,1,1,2,0.9372418787055726,"[1, 0, 1, 1, 1, 0, 0, 1, 0, 1]"
13240,1,1,2,0.8373118702317923,"[1, 1, 0, 1, 0, 1, 1, 0, 1, 1]"
13241,1,1,2,0.6339967670257304,"[0, 0, 0, 0, 0, 1, 0, 1, 0, 1]"
13242,1,1,2,0.4966680119523811,"[0, 1, 1, 1, 1, 1, 1, 0, 1, 0]"
13243,1,1,2,0.49907160678356943,"[0, 0, 1, 0, 1, 1, 1, 1, 0, 0]"
13244,1,1,2,0.9449605214441541,"[1, 0, 0, 1, 0, 1, 0, 0, 0, 1]"
13245,2,2,4,0.796941499738081,"[1, 0, 1, 0, 1, 0, 0, 0, 0, 1]"
13246,1,1,2,0.593993012070168,"[0, 1, 0, 1, 1, 1, 1, 0, 1, 1]"
13247,1,1,2,0.9578278219015772,"[1, 0, 1, 0, 1, 1, 0, 0, 0, 1]"
13248,1,1,2,0.4370422495182531,"[0, 1, 1, 1, 0, 0, 0, 1, 1, 1]"
13249,2,2,4,0.5292556948183471,"[1, 1, 1, 0, 0, 0, 1, 0, 0, 0]"
13250,1,1,2,0.48716952210459274,"[1, 0, 0, 1, 0, 1, 1, 1, 0, 1]"
13251,1,1,2,0.4047238610490218,"[1, 0, 0, 1, 1, 1, 1, 0, 0, 0]"
13252,1,1,2,0.15880924964687948,"[0, 1, 0, 0, 0, 1, 0, 0, 0, 0]"
13253,1,1,2,0.0782770950024142,"[0, 0, 1, 1, 1, 0, 0, 0, 0, 1]"
13254,1,1,2,0.3140737013636109,"[1, 0, 1, 1, 0, 1, 1, 0, 0, 1]"
13255,1,1,2,0.2747775449200711,"[1, 0, 1, 1, 0, 1, 0, 1, 0, 1]"
13256,1,1,2,0.9215514125777555,"[1, 1, 1, 1, 0, 1, 0, 1, 0, 0]"
13257,1,1,2,0.7642161740886437,"[1, 0, 0, 0, 1, 0, 0, 0, 1, 0]"
13258,1,1,2,0.8840805374372557,"[0, 0, 1, 0, 1, 1, 0, 0, 1, 0]"
13259,1,1,2,0.8735679822083127,"[1, 0, 0, 0, 0, 1, 0, 1, 0, 0]"
13260,1,1,2,0.18877729694282464,"[0, 0, 0, 1, 0, 1, 0, 1, 0, 1]"
13261,1,1,2,0.13500164370488166,"[0, 0, 1, 0, 0, 1, 1, 1, 1, 1]"
13262,2,2,4,0.07494688438887143,"[1, 1, 1, 1, 1, 1, 1, 1, 1, 1]"
13263,1,1,2,0.04882658905550863,"[1, 0, 0, 0, 1, 0, 0, 1, 1, 0]"
13264,1,1,2,0.6142762510018248,"[0, 0, 0, 0, 1, 0, 1, 0, 0, 1]"
13265,1,1,2,0.9902441033507249,"[1, 1, 0, 0, 0, 1, 1, 0, 1, 0]"
13266,1,1,2,0.6938198539897779,"[0, 0, 1, 0, 0, 0, 1, 1, 0, 1]"
13267,1,1,2,0.7591018929368624,"[1, 0, 0, 0, 0, 0, 0, 1, 1, 0]"
13268,1,1,2,0.30887612297094247,"[1, 1, 0, 1, 1, 1, 0, 1, 1, 1]"
13269,1,1,2,0.8870203679358217,"[0, 1, 1, 1, 0, 1, 0, 0, 0, 1]"
13270,1,1,2,0.2972943234483417,"[1, 1, 1, 0, 0, 0, 1, 0, 0, 0]"
13271,1,1,2,0.784289715483029,"[1, 1, 0, 1, 0, 1, 0, 0, 0, 0]"
13272,1,1,2,0.08875486659405796,"[1, 1, 1, 1, 0, 1, 1, 1, 0, 0]"
13273,1,1,2,0.46949063030438487,"[0, 0, 1, 1, 1, 0, 0, 1, 1, 1]"
13274,1,1,2,0.6929704905378115,"[0, 0, 0, 0, 0, 0, 1, 1, 1, 0]"
13275,1,1,2,0.33993255202897943,"[0, 0, 0, 0, 0, 0, 1, 1, 1, 0]"
13276,1,1,2,0.30119205648706093,"[1, 1, 0, 1, 0, 1, 0, 0, 0, 0]"
13277,1,1,2,0.8500018315627211,"[0, 1, 0, 1, 1, 0, 0, 1, 1, 0]"
13278,1,1,2,0.13148587102535292,"[0, 1, 1, 1, 1, 0, 1, 1, 1, 1]"
13279,1,1,2,0.09427265468660151,"[1, 1, 0, 0, 0, 1, 1, 0, 0, 1]"
13280,1,1,2,0.7079816495464288,"[0, 1, 0, 0, 1, 1, 0, 0, 1, 0]"
13281,1,1,2,0.8796805795431552,"[0, 0, 0, 0, 1, 1, 1, 1, 1, 0]"
13282,1,1,2,0.3579919455644006,"[0, 1, 1, 0, 0, 0, 1, 1, 1, 1]"
13283,2,2,4,0.8589786998455623,"[0, 0, 1, 1, 0, 0, 1, 1, 0, 0]"
13284,2,2,4,0.5679005081619014,"[0, 0, 1, 0, 1, 0, 1, 1, 0, 1]"
13285,2,2,4,0.8756248107492605,"[0, 1, 0, 1, 1, 0, 1, 1, 0, 0]"
13286,1,1,2,0.14641345899801705,"[1, 1, 0, 1, 0, 0, 0, 1, 1, 1]"
13287,1,1,2,0.016351375079345698,"[0, 0, 0, 1, 1, 1, 0, 0, 0, 0]"
13288,1,1,2,0.009997042249286214,"[0, 1, 1, 1, 1, 0, 0, 1, 1, 0]"
13289,1,1,2,0.28643866092381043,"[1, 0, 1, 1, 0, 1, 0, 0, 1, 0]"
13290,1,1,2,0.18493552469532037,"[0, 1, 1, 1, 1, 1, 1, 1, 1, 0]"
13291,1,1,2,0.8229612485583842,"[1, 1, 1, 1, 1, 1, 0, 0, 1, 0]"
13292,1,1,2,0.07750867494426128,"[1, 1, 0, 1, 0, 0, 1, 0, 1, 1]"
13293,1,1,2,0.2961577088697369,"[1, 1, 0, 0, 0, 1, 1, 0, 1, 1]"
13294,3,3,6,0.7526435740363128,"[1, 1, 1, 0, 0, 1, 0, 1, 1, 1]"
13295,1,1,2,0.47056290570064485,"[0, 1, 0, 1, 0, 1, 0, 1, 0, 1]"
13296,1,1,2,0.995273348846186,"[0, 0, 0, 1, 0, 1, 0, 0, 1, 1]"
13297,4,4,8,0.18484228170643402,"[0, 1, 1, 1, 1, 0, 1, 1, 1, 1]"
13298,1,1,2,0.3618211968119719,"[0, 1, 0, 1, 0, 0, 0, 0, 0, 1]"
13299,1,1,2,0.08773747861035397,"[0, 1, 1, 1, 0, 1, 0, 1, 1, 1]"
13300,1,1,2,0.8589689091236687,"[0, 0, 1, 1, 0, 1, 0, 1, 0, 1]"
13301,1,1,2,0.6372197555399218,"[1, 0, 0, 1, 1, 0, 0, 0, 0, 0]"
13302,1,1,2,0.352781171946309,"[1, 1, 1, 0, 1, 1, 1, 1, 0, 0]"
13303,1,1,2,0.9935818082905868,"[0, 1, 1, 0, 1, 0, 1, 0, 0, 0]"
13304,1,1,2,0.3027863729849253,"[1, 0, 1, 0, 1, 0, 1, 0, 0, 0]"
13305,1,1,2,0.6814639391567324,"[0, 1, 0, 0, 1, 1, 1, 1, 1, 1]"
13306,1,1,2,0.2830840842272587,"[1, 0, 0, 1, 0, 1, 0, 0, 1, 0]"
13307,1,1,2,0.4709261656448672,"[1, 1, 1, 1, 1, 1, 0, 0, 0, 0]"
13308,1,1,2,0.627173385799383,"[0, 1, 0, 1, 0, 0, 1, 0, 1, 1]"
13309,1,1,2,0.710263781340994,"[1, 0, 1, 1, 0, 1, 0, 0, 1, 0]"
13310,1,1,2,0.32518813104364297,"[0, 1, 1, 1, 0, 0, 1, 0, 1, 0]"
13311,1,1,2,0.18841526883506343,"[0, 0, 1, 0, 1, 0, 0, 1, 0, 1]"
13312,1,1,2,0.8094764506680547,"[0, 1, 1, 1, 1, 0, 1, 1, 1, 1]"
13313,1,1,2,0.8466844116946634,"[1, 0, 1, 1, 0, 1, 1, 0, 1, 0]"
13314,1,1,2,0.41906527938004634,"[1, 1, 0, 0, 0, 0, 0, 0, 1, 0]"
13315,2,2,4,0.4489161783744501,"[1, 0, 1, 1, 1, 1, 1, 1, 1, 0]"
13316,3,3,6,0.08248879912376883,"[1, 1, 0, 1, 1, 0, 1, 0, 1, 0]"
13317,1,1,2,0.33166672542695497,"[1, 0, 1, 0, 0, 1, 1, 1, 0, 1]"
13318,1,1,2,0.28401694894153107,"[1, 0, 0, 1, 0, 0, 0, 1, 1, 1]"
13319,1,1,2,0.4296788153280371,"[1, 0, 0, 0, 0, 0, 0, 1, 1, 1]"
13320,1,1,2,0.9397472889196997,"[0, 0, 1, 1, 0, 1, 1, 0, 1, 1]"
13321,1,1,2,0.6906052056681954,"[1, 0, 0, 0, 0, 1, 1, 1, 0, 1]"
13322,1,1,2,0.9174073051727895,"[0, 0, 0, 1, 0, 1, 0, 0, 1, 0]"
13323,2,2,4,0.9437255771723934,"[1, 1, 1, 0, 1, 1, 1, 0, 0, 0]"
13324,1,1,2,0.686687730149897,"[0, 1, 1, 1, 0, 1, 0, 0, 0, 0]"
13325,1,1,2,0.4265786977990569,"[1, 1, 1, 1, 0, 0, 0, 1, 1, 0]"
13326,1,1,2,0.5552455506920547,"[0, 1, 0, 1, 0, 1, 1, 0, 1, 1]"
13327,1,1,2,0.5409302900346438,"[0, 1, 1, 0, 1, 0, 0, 0, 0, 0]"
13328,2,2,4,0.6141904808441683,"[1, 1, 1, 1, 0, 0, 1, 0, 1, 0]"
13329,1,1,2,0.28831974922740644,"[0, 0, 1, 0, 1, 0, 1, 1, 1, 0]"
13330,1,1,2,0.35197612164642356,"[0, 0, 0, 1, 0, 1, 1, 0, 0, 1]"
13331,1,1,2,0.021102769336008298,"[0, 1, 1, 0, 0, 0, 0, 1, 0, 0]"
13332,1,1,2,0.48907072606419744,"[0, 0, 1, 0, 0, 0, 1, 1, 1, 0]"
13333,1,1,2,0.761348673336547,"[1, 1, 0, 1, 0, 0, 1, 0, 1, 1]"
13334,1,1,2,0.1463852028865571,"[0, 1, 0, 1, 1, 0, 1, 0, 0, 1]"
13335,1,1,2,0.9156715128251549,"[0, 0, 1, 1, 0, 0, 0, 0, 0, 0]"
13336,1,1,2,0.7121768769406129,"[0, 1, 0, 1, 1, 1, 1, 0, 0, 1]"
13337,1,1,2,0.882666199043536,"[1, 1, 0, 0, 1, 0, 1, 1, 1, 1]"
13338,1,1,2,0.5856716207404389,"[0, 0, 0, 1, 0, 1, 1, 1, 0, 0]"
13339,2,2,4,0.033741220771579594,"[0, 1, 0, 0, 1, 1, 0, 1, 0, 0]"
13340,1,1,2,0.3995533957822469,"[1, 0, 1, 1, 0, 1, 1, 0, 1, 1]"
13341,1,1,2,0.863457564591842,"[1, 0, 0, 1, 1, 0, 1, 1, 0, 1]"
13342,1,1,2,0.9037988424198814,"[0, 1, 1, 0, 0, 1, 0, 0, 1, 0]"
13343,1,1,2,0.4289636417916848,"[1, 0, 1, 0, 1, 1, 1, 0, 0, 0]"
13344,1,1,2,0.5342654279794641,"[1, 1, 1, 1, 0, 1, 1, 0, 1, 1]"
13345,1,1,2,0.9014302407774889,"[1, 1, 1, 0, 1, 1, 1, 1, 0, 0]"
13346,1,1,2,0.8504709995939168,"[0, 0, 1, 1, 1, 0, 1, 1, 0, 1]"
13347,1,1,2,0.19662432714135125,"[0, 1, 0, 0, 0, 0, 1, 0, 0, 0]"
13348,1,1,2,0.9353148279494631,"[0, 0, 1, 0, 1, 0, 1, 0, 0, 1]"
13349,1,1,2,0.38727995337456667,"[1, 1, 1, 1, 0, 1, 0, 1, 0, 0]"
13350,1,1,2,0.943133229251895,"[0, 1, 1, 1, 1, 1, 0, 0, 0, 0]"
13351,1,1,2,0.5582380233918394,"[0, 1, 0, 1, 1, 1, 0, 0, 1, 1]"
13352,1,1,2,0.8604381326488993,"[1, 0, 1, 1, 0, 0, 0, 0, 1, 0]"
13353,2,2,4,0.2533669625054715,"[1, 1, 0, 0, 1, 1, 0, 1, 0, 0]"
13354,1,1,2,0.45966929370961473,"[1, 1, 0, 1, 1, 0, 1, 0, 1, 0]"
13355,1,1,2,0.21336395480526105,"[0, 0, 0, 0, 1, 1, 0, 1, 0, 0]"
13356,1,1,2,0.5236235577659137,"[1, 0, 1, 0, 0, 0, 1, 0, 1, 1]"
13357,1,1,2,0.6541444752496518,"[0, 1, 0, 1, 0, 0, 1, 0, 1, 1]"
13358,1,1,2,0.05729979626426862,"[1, 0, 1, 1, 1, 1, 0, 1, 1, 1]"
13359,1,1,2,0.42409991749340004,"[0, 0, 0, 1, 0, 0, 1, 1, 1, 0]"
13360,1,1,2,0.42200834217397476,"[1, 0, 1, 0, 0, 0, 0, 0, 1, 0]"
13361,1,1,2,0.5335681311004137,"[0, 0, 0, 1, 1, 1, 1, 0, 0, 0]"
13362,1,1,2,0.6415955280353095,"[1, 1, 1, 0, 1, 1, 1, 0, 1, 0]"
13363,1,1,2,0.6331478266641835,"[0, 0, 0, 0, 1, 1, 0, 0, 0, 0]"
13364,2,2,4,0.4513369972122765,"[0, 1, 1, 0, 1, 0, 1, 0, 0, 0]"
13365,1,1,2,0.2468703722824408,"[1, 0, 0, 0, 1, 0, 0, 0, 1, 1]"
13366,1,1,2,0.1461554031669674,"[0, 1, 0, 0, 1, 0, 1, 0, 1, 1]"
13367,1,1,2,0.6656969664007742,"[1, 1, 1, 0, 0, 0, 0, 1, 1, 0]"
13368,1,1,2,0.3208286397559269,"[0, 1, 0, 1, 0, 0, 0, 0, 1, 1]"
13369,1,1,2,0.0183644876055431,"[0, 1, 0, 0, 0, 0, 1, 1, 1, 1]"
13370,1,1,2,0.9622778902519651,"[1, 0, 1, 1, 0, 1, 1, 0, 1, 1]"
13371,2,2,4,0.7822368862309841,"[0, 0, 0, 1, 0, 0, 1, 1, 0, 1]"
13372,1,1,2,0.04153776103818574,"[0, 0, 0, 0, 0, 1, 0, 0, 0, 1]"
13373,1,1,2,0.7647992081501477,"[1, 0, 0, 0, 0, 1, 1, 1, 0, 1]"
13374,1,1,2,0.4017570231262978,"[1, 0, 0, 0, 1, 0, 0, 1, 1, 0]"
13375,1,1,2,0.963766852540272,"[0, 1, 0, 1, 1, 0, 0, 0, 0, 1]"
13376,1,1,2,0.6949191624953649,"[0, 0, 1, 1, 0, 0, 0, 1, 1, 1]"
13377,1,1,2,0.3040727826670855,"[1, 0, 1, 0, 0, 0, 1, 0, 1, 0]"
13378,1,1,2,0.3160348268962414,"[1, 1, 1, 1, 1, 0, 1, 0, 1, 1]"
13379,2,2,4,0.8098025064689929,"[1, 1, 1, 1, 1, 0, 0, 0, 1, 1]"
13380,1,1,2,0.23820173581828863,"[1, 1, 0, 0, 1, 1, 0, 1, 0, 0]"
13381,1,1,2,0.18917906256487027,"[1, 1, 0, 0, 1, 1, 0, 0, 1, 1]"
13382,1,1,2,0.391875398356366,"[1, 0, 0, 1, 0, 1, 0, 0, 0, 1]"
13383,1,1,2,0.27802876037144264,"[0, 1, 1, 1, 0, 1, 0, 0, 1, 1]"
13384,1,1,2,0.42224853278102614,"[1, 0, 1, 1, 1, 1, 0, 1, 0, 1]"
13385,1,1,2,0.9624972635029816,"[0, 0, 0, 0, 1, 0, 0, 1, 1, 1]"
13386,1,1,2,0.7986090700987957,"[0, 1, 0, 1, 1, 0, 0, 0, 0, 1]"
13387,1,1,2,0.7378023659974492,"[0, 1, 1, 1, 1, 0, 0, 0, 0, 1]"
13388,1,1,2,0.05733786532726415,"[0, 0, 0, 0, 0, 1, 0, 1, 0, 0]"
13389,1,1,2,0.0058097499735692,"[1, 1, 1, 0, 1, 0, 0, 1, 1, 1]"
13390,1,1,2,0.33426276145908906,"[1, 1, 1, 1, 1, 0, 0, 0, 1, 1]"
13391,1,1,2,0.7916032998168266,"[0, 1, 0, 0, 1, 1, 1, 1, 1, 0]"
13392,2,2,4,0.20016254044524318,"[1, 0, 1, 1, 0, 0, 0, 1, 1, 0]"
13393,1,1,2,0.303656458025516,"[0, 0, 0, 1, 1, 1, 0, 1, 0, 1]"
13394,1,1,2,0.06090849178872504,"[0, 1, 0, 0, 1, 0, 1, 0, 1, 1]"
13395,3,3,6,0.806976542167023,"[1, 0, 1, 0, 0, 1, 1, 1, 0, 0]"
13396,1,1,2,0.45147777013555335,"[0, 1, 1, 0, 1, 0, 1, 0, 0, 1]"
13397,2,2,4,0.14124436732258838,"[1, 1, 0, 1, 0, 0, 1, 1, 0, 1]"
13398,1,1,2,0.939289857196877,"[1, 1, 0, 1, 1, 0, 1, 1, 1, 0]"
13399,4,4,8,0.36970019232429163,"[0, 1, 1, 1, 0, 1, 1, 1, 0, 1]"
13400,1,1,2,0.5997424146628985,"[1, 1, 1, 0, 0, 1, 0, 0, 0, 0]"
13401,1,1,2,0.3683439510091633,"[1, 1, 0, 1, 0, 1, 0, 0, 1, 0]"
13402,1,1,2,0.5372023340816059,"[1, 0, 0, 0, 0, 0, 0, 0, 1, 0]"
13403,1,1,2,0.862282567698176,"[1, 1, 0, 0, 1, 1, 1, 1, 0, 0]"
13404,1,1,2,0.49570473526959535,"[1, 1, 1, 0, 0, 1, 0, 1, 1, 0]"
13405,2,2,4,0.9215028026515877,"[0, 0, 1, 0, 1, 1, 1, 1, 1, 1]"
13406,1,1,2,0.4212495416897508,"[1, 0, 0, 1, 1, 0, 1, 1, 0, 1]"
13407,1,1,2,0.34046887639249124,"[1, 1, 0, 0, 1, 1, 1, 0, 0, 0]"
13408,1,1,2,0.20105861445441253,"[1, 1, 0, 1, 1, 0, 0, 1, 0, 0]"
13409,1,1,2,0.7968206476339229,"[1, 1, 1, 0, 0, 1, 1, 1, 0, 1]"
13410,1,1,2,0.12643051033356967,"[0, 0, 0, 0, 1, 0, 0, 1, 1, 0]"
13411,1,1,2,0.7603560556789891,"[1, 0, 0, 0, 0, 1, 0, 1, 0, 1]"
13412,1,1,2,0.6955604051007976,"[1, 1, 1, 1, 1, 1, 0, 1, 1, 1]"
13413,1,1,2,0.6980843604973717,"[0, 0, 0, 0, 1, 0, 1, 1, 0, 1]"
13414,1,1,2,0.29210730047757594,"[1, 0, 1, 0, 0, 0, 0, 1, 1, 0]"
13415,3,3,6,0.38443595154770827,"[1, 1, 1, 1, 1, 0, 0, 1, 1, 0]"
13416,1,1,2,0.4423895586194473,"[1, 0, 1, 1, 0, 0, 0, 1, 0, 1]"
13417,1,1,2,0.8514563297569779,"[1, 1, 1, 1, 1, 1, 0, 1, 1, 1]"
13418,1,1,2,0.9312614845110033,"[0, 0, 0, 1, 1, 0, 1, 1, 0, 0]"
13419,1,1,2,0.8368995151292299,"[1, 1, 0, 1, 1, 1, 0, 1, 0, 1]"
13420,1,1,2,0.7317135119215651,"[1, 1, 1, 1, 0, 0, 0, 1, 0, 0]"
13421,1,1,2,0.9211379501105498,"[0, 0, 1, 1, 1, 0, 1, 0, 1, 0]"
13422,1,1,2,0.5910234851593096,"[0, 0, 0, 0, 0, 0, 0, 1, 0, 1]"
13423,1,1,2,0.2675308912269504,"[0, 0, 0, 1, 1, 1, 1, 0, 0, 1]"
13424,1,1,2,0.27290271142887157,"[1, 0, 1, 0, 0, 0, 1, 0, 0, 0]"
13425,2,2,4,0.5001798050936175,"[0, 1, 1, 0, 1, 0, 0, 1, 1, 0]"
13426,1,1,2,0.11070730688773289,"[0, 1, 0, 1, 1, 0, 0, 0, 1, 1]"
13427,1,1,2,0.8565778084668549,"[0, 0, 0, 0, 1, 1, 0, 1, 1, 1]"
13428,1,1,2,0.2918731265295036,"[1, 0, 0, 0, 1, 0, 0, 0, 0, 0]"
13429,1,1,2,0.558675537066678,"[1, 0, 0, 0, 0, 0, 0, 1, 0, 1]"
13430,1,1,2,0.3875571495383976,"[0, 1, 1, 0, 0, 0, 1, 0, 1, 0]"
13431,1,1,2,0.2500217316194303,"[0, 0, 1, 1, 1, 0, 0, 1, 0, 0]"
13432,1,1,2,0.4823314899910419,"[0, 1, 1, 0, 0, 1, 0, 1, 1, 0]"
13433,1,1,2,0.869884465797692,"[1, 1, 0, 1, 0, 1, 0, 0, 1, 0]"
13434,1,1,2,0.3260876817889392,"[1, 0, 1, 0, 1, 0, 0, 1, 1, 1]"
13435,3,3,6,0.27436630574784693,"[1, 1, 1, 1, 0, 0, 1, 0, 1, 0]"
13436,1,1,2,0.6938020259504861,"[0, 1, 0, 1, 1, 1, 1, 0, 0, 1]"
13437,1,1,2,0.7187855716345107,"[0, 0, 0, 1, 1, 0, 1, 1, 0, 0]"
13438,1,1,2,0.8508004919933719,"[0, 1, 0, 0, 0, 1, 0, 1, 0, 0]"
13439,1,1,2,0.13811927743869268,"[1, 1, 1, 1, 0, 1, 0, 0, 1, 1]"
13440,2,2,4,0.3233549169955866,"[1, 0, 0, 1, 1, 1, 0, 1, 1, 1]"
13441,2,2,4,0.8186276408156193,"[1, 1, 1, 0, 1, 0, 0, 0, 1, 1]"
13442,1,1,2,0.17163149132614863,"[0, 0, 0, 0, 0, 1, 0, 0, 1, 0]"
13443,1,1,2,0.802680201590543,"[0, 1, 1, 0, 1, 0, 0, 0, 0, 1]"
13444,1,1,2,0.5363041068074099,"[0, 0, 0, 1, 0, 1, 1, 1, 1, 1]"
13445,1,1,2,0.7119354841451213,"[0, 1, 1, 1, 1, 1, 0, 1, 1, 1]"
13446,1,1,2,0.17637119192649497,"[0, 0, 0, 0, 1, 1, 0, 0, 0, 1]"
13447,1,1,2,0.5920572291006123,"[0, 1, 1, 0, 0, 0, 1, 0, 0, 0]"
13448,1,1,2,0.5552267364404927,"[1, 1, 0, 1, 0, 0, 1, 0, 1, 0]"
13449,1,1,2,0.263383753775578,"[1, 1, 1, 0, 1, 1, 1, 0, 0, 0]"
13450,1,1,2,0.18507669593608833,"[1, 0, 1, 1, 0, 1, 0, 1, 0, 0]"
13451,1,1,2,0.0761340776857592,"[1, 1, 0, 0, 1, 1, 1, 1, 1, 0]"
13452,1,1,2,0.17973910411788196,"[1, 1, 0, 1, 1, 1, 1, 0, 0, 1]"
13453,1,1,2,0.46379048857859406,"[1, 0, 0, 1, 1, 1, 0, 0, 1, 0]"
13454,2,2,4,0.4886457971600837,"[1, 0, 1, 1, 1, 0, 0, 0, 0, 1]"
13455,3,3,6,0.7800692155655445,"[0, 0, 1, 0, 1, 1, 0, 0, 1, 0]"
13456,2,2,4,0.12637997278335278,"[0, 0, 0, 0, 1, 0, 1, 0, 1, 0]"
13457,1,1,2,0.5406883387187746,"[1, 0, 0, 1, 1, 0, 0, 0, 1, 1]"
13458,1,1,2,0.48416545699974267,"[0, 1, 1, 1, 0, 1, 1, 0, 1, 1]"
13459,1,1,2,0.5067628957045514,"[1, 1, 0, 0, 1, 0, 1, 0, 0, 0]"
13460,2,2,4,0.3560078267908061,"[1, 1, 1, 1, 1, 0, 0, 0, 1, 1]"
13461,1,1,2,0.04158736664578999,"[0, 1, 1, 0, 1, 0, 1, 1, 0, 0]"
13462,1,1,2,0.5298038591413575,"[1, 0, 1, 0, 0, 0, 0, 0, 0, 1]"
13463,1,1,2,0.3027394253850212,"[0, 0, 0, 1, 1, 1, 1, 0, 1, 1]"
13464,1,1,2,0.67865451998618,"[0, 1, 1, 0, 0, 1, 0, 0, 1, 1]"
13465,2,2,4,0.19018089831167506,"[1, 1, 0, 1, 1, 0, 1, 1, 1, 0]"
13466,1,1,2,0.9930526246474864,"[0, 0, 1, 0, 0, 0, 0, 1, 1, 0]"
13467,1,1,2,0.7352743366778863,"[0, 0, 0, 0, 1, 1, 0, 1, 0, 1]"
13468,3,3,6,0.7472505244575905,"[0, 0, 1, 1, 1, 1, 0, 0, 0, 0]"
13469,1,1,2,0.8547751155838805,"[0, 1, 0, 0, 1, 1, 0, 0, 1, 0]"
13470,1,1,2,0.7410462090446951,"[1, 0, 1, 0, 0, 0, 1, 0, 0, 1]"
13471,1,1,2,0.630160194867973,"[0, 1, 1, 1, 0, 1, 0, 1, 0, 1]"
13472,2,2,4,0.6477908098448183,"[1, 1, 1, 1, 0, 1, 1, 0, 0, 1]"
13473,1,1,2,0.6529237708877647,"[0, 1, 1, 1, 1, 1, 0, 1, 0, 0]"
13474,1,1,2,0.6499015309103247,"[1, 1, 1, 1, 0, 1, 1, 0, 1, 1]"
13475,1,1,2,0.5712196242737572,"[0, 0, 0, 1, 1, 0, 0, 1, 1, 0]"
13476,1,1,2,0.5893691027216472,"[0, 0, 0, 1, 1, 1, 0, 0, 1, 0]"
13477,1,1,2,0.9666628266225274,"[0, 0, 1, 0, 1, 1, 0, 1, 0, 0]"
13478,1,1,2,0.17537348166143896,"[1, 0, 0, 1, 0, 0, 0, 0, 0, 0]"
13479,1,1,2,0.9129925898309227,"[1, 0, 0, 1, 0, 0, 0, 1, 1, 0]"
13480,1,1,2,0.31057269473769855,"[0, 0, 1, 0, 1, 1, 1, 0, 0, 0]"
13481,1,1,2,0.30138001726211305,"[0, 0, 1, 1, 1, 0, 1, 1, 0, 1]"
13482,1,1,2,0.3998828415729312,"[1, 0, 0, 0, 1, 0, 1, 0, 0, 1]"
13483,1,1,2,0.48088487949699954,"[0, 1, 1, 1, 1, 1, 0, 1, 0, 0]"
13484,1,1,2,0.03773710185360413,"[0, 1, 0, 0, 0, 1, 0, 0, 1, 1]"
13485,1,1,2,0.7091860149754955,"[0, 0, 0, 0, 0, 0, 0, 0, 1, 0]"
13486,3,3,6,0.61202284394528,"[0, 0, 1, 1, 1, 1, 1, 1, 1, 0]"
13487,1,1,2,0.24788905278833495,"[0, 0, 1, 0, 1, 1, 1, 0, 0, 0]"
13488,1,1,2,0.5362949978940378,"[0, 1, 1, 0, 1, 0, 1, 1, 0, 0]"
13489,1,1,2,0.8081416665179068,"[1, 1, 1, 0, 0, 0, 1, 0, 0, 0]"
13490,1,1,2,0.5657541567961845,"[0, 0, 0, 0, 0, 0, 1, 0, 1, 1]"
13491,1,1,2,0.16519617881912352,"[0, 0, 1, 0, 0, 0, 1, 1, 1, 1]"
13492,1,1,2,0.06754373936038949,"[1, 0, 0, 0, 1, 0, 1, 1, 1, 0]"
13493,2,2,4,0.8807867329803643,"[0, 0, 0, 0, 0, 1, 1, 1, 0, 0]"
13494,1,1,2,0.9180601371774668,"[1, 0, 0, 1, 1, 1, 1, 0, 1, 1]"
13495,3,3,6,0.10236172285287404,"[1, 1, 0, 1, 1, 1, 0, 1, 1, 0]"
13496,1,1,2,0.27916320919541415,"[0, 0, 0, 0, 0, 0, 1, 1, 0, 1]"
13497,1,1,2,0.5681758078139723,"[1, 0, 0, 1, 1, 1, 1, 0, 0, 0]"
13498,1,1,2,0.11690091013036186,"[1, 0, 0, 1, 1, 1, 0, 0, 1, 1]"
13499,1,1,2,0.3648045368081658,"[1, 0, 1, 0, 0, 0, 1, 0, 0, 1]"
13500,1,1,2,0.09721578123064134,"[1, 1, 1, 0, 1, 1, 1, 0, 1, 1]"
13501,1,1,2,0.9924894110502868,"[0, 1, 0, 1, 0, 0, 0, 0, 1, 0]"
13502,1,1,2,0.5949784564812014,"[1, 1, 0, 0, 0, 1, 0, 1, 0, 1]"
13503,1,1,2,0.9992161632482583,"[1, 0, 0, 1, 0, 0, 1, 1, 1, 1]"
13504,1,1,2,0.34811301507988734,"[1, 0, 1, 1, 1, 0, 1, 1, 1, 0]"
13505,1,1,2,0.18598451805962934,"[1, 1, 1, 0, 0, 0, 1, 1, 1, 0]"
13506,3,3,6,0.5949641083041459,"[0, 1, 1, 1, 1, 1, 1, 0, 0, 1]"
13507,2,2,4,0.5545910243546978,"[1, 1, 0, 1, 1, 0, 1, 0, 0, 0]"
13508,1,1,2,0.9495769890967435,"[1, 0, 1, 0, 1, 0, 1, 0, 1, 0]"
13509,1,1,2,0.8652827320966795,"[1, 1, 1, 1, 1, 0, 1, 0, 0, 1]"
13510,1,1,2,0.29072347063226744,"[1, 0, 0, 0, 0, 1, 0, 1, 1, 1]"
13511,1,1,2,0.7661510104678189,"[1, 0, 1, 0, 1, 0, 1, 0, 0, 1]"
13512,1,1,2,0.01007831535233017,"[1, 0, 1, 1, 1, 1, 0, 0, 0, 1]"
13513,1,1,2,0.6526990076025619,"[1, 1, 1, 0, 0, 1, 0, 0, 0, 1]"
13514,1,1,2,0.5438233902418078,"[1, 0, 1, 0, 1, 1, 1, 0, 1, 0]"
13515,1,1,2,0.5384342116585763,"[1, 0, 0, 1, 0, 1, 0, 0, 0, 0]"
13516,1,1,2,0.830483706679986,"[1, 1, 1, 0, 1, 0, 0, 0, 1, 1]"
13517,1,1,2,0.8416787797448873,"[0, 0, 0, 1, 0, 1, 0, 0, 1, 0]"
13518,1,1,2,0.34519008731566747,"[0, 0, 0, 0, 1, 1, 0, 0, 1, 1]"
13519,1,1,2,0.8674487718482549,"[0, 1, 1, 1, 0, 1, 0, 1, 0, 0]"
13520,2,2,4,0.27620449867709906,"[1, 1, 1, 0, 1, 0, 1, 1, 1, 1]"
13521,2,2,4,0.28818550217984706,"[1, 0, 1, 1, 0, 1, 1, 0, 1, 1]"
13522,1,1,2,0.6510308552610817,"[0, 0, 0, 1, 1, 1, 1, 0, 1, 0]"
13523,1,1,2,0.3794825945771131,"[0, 1, 0, 0, 0, 1, 1, 0, 0, 0]"
13524,1,1,2,0.5070203281259734,"[1, 1, 0, 0, 0, 0, 1, 1, 1, 0]"
13525,1,1,2,0.2983892049508772,"[0, 0, 0, 0, 1, 1, 0, 1, 0, 1]"
13526,1,1,2,0.8761901616804517,"[1, 0, 1, 1, 0, 1, 1, 0, 0, 0]"
13527,1,1,2,0.10234234088145855,"[0, 1, 1, 0, 1, 1, 1, 0, 1, 0]"
13528,1,1,2,0.21272179804273783,"[0, 0, 0, 1, 0, 1, 1, 0, 0, 0]"
13529,2,2,4,0.7138696339827622,"[0, 0, 1, 1, 1, 0, 0, 1, 0, 0]"
13530,1,1,2,0.5674540156097163,"[0, 1, 1, 0, 1, 0, 1, 1, 0, 1]"
13531,1,1,2,0.7114234552931115,"[1, 0, 0, 1, 1, 0, 1, 1, 0, 1]"
13532,2,2,4,0.18569911983162202,"[0, 1, 0, 1, 1, 1, 0, 0, 0, 1]"
13533,1,1,2,0.7411719473249709,"[1, 0, 1, 1, 1, 0, 0, 1, 0, 0]"
13534,1,1,2,0.9903470764568243,"[1, 1, 1, 0, 0, 1, 0, 1, 0, 0]"
13535,1,1,2,0.6293165563130715,"[0, 0, 1, 0, 0, 1, 0, 0, 0, 0]"
13536,2,2,4,0.5020610013338671,"[0, 1, 1, 1, 1, 0, 1, 1, 1, 0]"
13537,1,1,2,0.05845875908710041,"[0, 0, 0, 0, 0, 0, 0, 0, 1, 0]"
13538,1,1,2,0.7947907315922672,"[1, 1, 1, 0, 1, 1, 0, 0, 0, 0]"
13539,1,1,2,0.8722633364331456,"[1, 1, 0, 0, 1, 1, 0, 1, 0, 1]"
13540,1,1,2,0.749962913734393,"[1, 1, 1, 0, 1, 0, 0, 0, 0, 0]"
13541,1,1,2,0.3289799288145768,"[1, 1, 1, 1, 1, 0, 1, 1, 1, 1]"
13542,1,1,2,0.7611842374650832,"[1, 1, 1, 1, 0, 0, 0, 1, 1, 1]"
13543,2,2,4,0.4200797131733589,"[0, 1, 0, 0, 1, 0, 0, 0, 0, 1]"
13544,1,1,2,0.5365725978800925,"[0, 1, 1, 1, 0, 1, 0, 0, 0, 0]"
13545,1,1,2,0.9978498206927451,"[1, 1, 1, 0, 1, 0, 0, 0, 1, 0]"
13546,1,1,2,0.5759143144098865,"[1, 0, 1, 0, 1, 0, 1, 0, 0, 1]"
13547,1,1,2,0.7880143139324068,"[1, 0, 0, 0, 0, 0, 0, 0, 1, 1]"
13548,1,1,2,0.1858113546952025,"[0, 1, 0, 1, 0, 1, 0, 1, 0, 1]"
13549,1,1,2,0.38240360334035517,"[1, 0, 1, 1, 0, 0, 1, 1, 1, 0]"
13550,2,2,4,0.408632819364362,"[0, 1, 1, 0, 0, 1, 0, 0, 1, 0]"
13551,1,1,2,0.1671632863036614,"[0, 0, 1, 1, 1, 1, 0, 0, 0, 0]"
13552,1,1,2,0.9191177700333587,"[0, 0, 1, 1, 1, 0, 1, 0, 1, 0]"
13553,1,1,2,0.8518746086270425,"[0, 0, 0, 1, 1, 1, 1, 1, 0, 0]"
13554,1,1,2,0.530798982388324,"[0, 0, 1, 1, 1, 0, 1, 0, 0, 1]"
13555,1,1,2,0.7710960736659758,"[0, 1, 0, 1, 0, 0, 0, 0, 0, 0]"
13556,1,1,2,0.9198480443063084,"[0, 0, 0, 1, 1, 1, 1, 1, 1, 1]"
13557,1,1,2,0.8215390694484861,"[0, 1, 0, 1, 0, 1, 0, 1, 0, 0]"
13558,1,1,2,0.45152748296644896,"[1, 0, 1, 0, 1, 1, 0, 1, 1, 1]"
13559,1,1,2,0.049655062210455236,"[0, 1, 1, 0, 0, 1, 0, 1, 0, 1]"
13560,1,1,2,0.5126601923463884,"[0, 0, 0, 1, 0, 0, 1, 0, 0, 1]"
13561,1,1,2,0.9009231593369813,"[1, 1, 1, 0, 1, 0, 1, 0, 1, 1]"
13562,1,1,2,0.014324457132833035,"[1, 1, 1, 1, 0, 1, 1, 0, 1, 0]"
13563,1,1,2,0.6110382373806165,"[0, 0, 0, 1, 1, 1, 1, 0, 1, 1]"
13564,1,1,2,0.3073037272003334,"[0, 1, 0, 1, 0, 0, 1, 1, 0, 1]"
13565,1,1,2,0.5129520504409787,"[0, 1, 0, 0, 0, 0, 0, 1, 1, 1]"
13566,1,1,2,0.4597835073975046,"[1, 1, 0, 0, 0, 1, 0, 0, 1, 0]"
13567,3,3,6,0.12935560318473005,"[1, 1, 0, 0, 1, 1, 1, 0, 0, 1]"
13568,1,1,2,0.9241227471615734,"[0, 0, 0, 0, 0, 1, 1, 0, 1, 1]"
13569,2,2,4,0.9198885195618248,"[1, 0, 1, 0, 1, 1, 1, 1, 1, 1]"
13570,1,1,2,0.15927656468140472,"[1, 1, 0, 0, 1, 0, 0, 0, 0, 1]"
13571,1,1,2,0.4640183567221471,"[0, 1, 1, 0, 1, 1, 1, 1, 0, 1]"
13572,1,1,2,0.3294558286565463,"[1, 1, 1, 1, 0, 1, 1, 1, 1, 1]"
13573,2,2,4,0.2587668777633523,"[0, 0, 0, 0, 1, 1, 0, 1, 1, 0]"
13574,1,1,2,0.6057673826116995,"[0, 1, 0, 1, 1, 1, 0, 0, 1, 1]"
13575,1,1,2,0.32641470668208794,"[1, 1, 0, 0, 1, 0, 0, 0, 0, 1]"
13576,1,1,2,0.14002356516720638,"[0, 0, 0, 1, 1, 1, 1, 1, 1, 0]"
13577,1,1,2,0.02075620687786517,"[1, 0, 1, 1, 0, 0, 1, 0, 0, 0]"
13578,2,2,4,0.47299411196979924,"[1, 0, 1, 1, 1, 0, 1, 1, 1, 1]"
13579,1,1,2,0.8809659218051995,"[0, 1, 0, 1, 0, 0, 1, 1, 1, 0]"
13580,3,3,6,0.15298250242513023,"[0, 1, 1, 0, 1, 0, 0, 0, 1, 1]"
13581,1,1,2,0.2318839414502326,"[0, 1, 1, 0, 0, 0, 0, 0, 1, 1]"
13582,1,1,2,0.7380689905316414,"[0, 1, 0, 0, 0, 1, 1, 1, 1, 1]"
13583,1,1,2,0.9213543408463036,"[1, 0, 0, 0, 1, 1, 1, 0, 1, 1]"
13584,1,1,2,0.8412346011521022,"[1, 1, 0, 0, 0, 1, 0, 0, 1, 1]"
13585,1,1,2,0.16413289642055406,"[0, 0, 1, 0, 0, 0, 1, 0, 1, 1]"
13586,2,2,4,0.06762069092068879,"[1, 1, 1, 0, 0, 1, 1, 0, 0, 0]"
13587,1,1,2,0.41119433432228447,"[0, 0, 1, 0, 1, 1, 1, 1, 1, 1]"
13588,1,1,2,0.08934843204207765,"[1, 1, 1, 0, 0, 1, 0, 1, 0, 0]"
13589,1,1,2,0.2584762450740439,"[0, 1, 0, 1, 1, 1, 1, 1, 0, 0]"
13590,2,2,4,0.44717544437625645,"[0, 0, 1, 1, 1, 1, 0, 0, 0, 0]"
13591,1,1,2,0.6397857986065608,"[0, 1, 0, 0, 1, 1, 1, 1, 1, 1]"
13592,1,1,2,0.39148590331106226,"[1, 0, 0, 1, 1, 0, 1, 0, 1, 1]"
13593,1,1,2,0.41926991869756736,"[1, 1, 1, 1, 1, 0, 0, 1, 1, 1]"
13594,3,3,6,0.3713219499602455,"[0, 0, 1, 1, 0, 1, 1, 0, 1, 1]"
13595,2,2,4,0.5897186479249436,"[1, 1, 1, 0, 0, 1, 1, 1, 1, 0]"
13596,2,2,4,0.5573584661121455,"[0, 0, 1, 0, 1, 1, 0, 0, 0, 0]"
13597,1,1,2,0.18986210380210677,"[1, 1, 0, 0, 1, 0, 0, 1, 0, 0]"
13598,1,1,2,0.8246010947999842,"[0, 0, 0, 0, 0, 0, 0, 1, 1, 0]"
13599,2,2,4,0.4761073094349385,"[1, 1, 1, 1, 0, 0, 0, 0, 1, 0]"
13600,1,1,2,0.10726523692736467,"[0, 1, 1, 1, 1, 1, 1, 1, 0, 1]"
13601,1,1,2,0.7468114088202499,"[0, 1, 1, 1, 1, 0, 0, 1, 0, 1]"
13602,1,1,2,0.5013041703328805,"[0, 0, 0, 0, 0, 0, 0, 0, 0, 0]"
13603,1,1,2,0.7136427129179718,"[0, 1, 1, 1, 1, 0, 1, 0, 1, 0]"
13604,1,1,2,0.8218657186389887,"[0, 1, 0, 1, 1, 0, 1, 0, 0, 0]"
13605,1,1,2,0.056865515312582104,"[1, 1, 0, 0, 1, 0, 1, 0, 0, 1]"
13606,2,2,4,0.8820444313710969,"[0, 0, 0, 0, 1, 1, 0, 0, 1, 1]"
13607,1,1,2,0.6316126693060672,"[1, 1, 1, 1, 1, 1, 0, 1, 0, 0]"
13608,1,1,2,0.8136980419582371,"[0, 1, 1, 0, 0, 1, 1, 1, 0, 1]"
13609,1,1,2,0.14510559163065417,"[1, 0, 0, 1, 1, 1, 1, 1, 1, 1]"
13610,1,1,2,0.22002625729048397,"[1, 0, 1, 1, 1, 0, 1, 1, 0, 1]"
13611,1,1,2,0.13388641980054405,"[1, 0, 0, 0, 1, 0, 1, 1, 0, 1]"
13612,1,1,2,0.5383597814791615,"[0, 1, 0, 0, 0, 1, 0, 1, 1, 0]"
13613,1,1,2,0.6053274322357562,"[1, 0, 0, 1, 0, 0, 0, 0, 0, 1]"
13614,1,1,2,0.8318504869899807,"[0, 1, 1, 1, 0, 0, 1, 1, 1, 1]"
13615,1,1,2,0.2964803498806019,"[1, 1, 1, 0, 1, 0, 0, 1, 1, 1]"
13616,1,1,2,0.34489155728993215,"[1, 1, 0, 0, 1, 0, 1, 1, 1, 1]"
13617,1,1,2,0.9606353437857464,"[1, 0, 0, 0, 1, 1, 0, 1, 1, 1]"
13618,1,1,2,0.24423989419236858,"[0, 0, 1, 0, 1, 0, 1, 0, 0, 1]"
13619,1,1,2,0.2435434534221511,"[0, 0, 1, 0, 1, 0, 1, 1, 1, 1]"
13620,1,1,2,0.06795679364305007,"[1, 1, 0, 1, 0, 0, 0, 1, 1, 1]"
13621,1,1,2,0.19816904734710006,"[1, 0, 0, 1, 1, 0, 0, 0, 1, 0]"
13622,2,2,4,0.8400565740170283,"[0, 1, 1, 0, 1, 0, 1, 0, 0, 0]"
13623,1,1,2,0.5921439012609864,"[0, 1, 0, 0, 1, 1, 1, 0, 1, 1]"
13624,2,2,4,0.15061405055737254,"[0, 1, 1, 0, 0, 1, 0, 1, 1, 1]"
13625,1,1,2,0.7272320396402844,"[1, 1, 0, 1, 0, 1, 1, 0, 0, 0]"
13626,1,1,2,0.12358238668066457,"[0, 0, 0, 1, 0, 0, 1, 1, 0, 0]"
13627,1,1,2,0.327290404194596,"[0, 0, 1, 0, 0, 1, 0, 1, 0, 0]"
13628,1,1,2,0.768349355999209,"[1, 0, 0, 1, 0, 1, 1, 1, 1, 0]"
13629,1,1,2,0.8136420358276122,"[1, 1, 0, 1, 1, 0, 1, 0, 1, 0]"
13630,2,2,4,0.8229439533564845,"[1, 1, 1, 1, 1, 1, 1, 1, 0, 0]"
13631,1,1,2,0.784615919946873,"[0, 1, 0, 1, 1, 1, 0, 1, 1, 0]"
13632,1,1,2,0.16113527845982845,"[0, 1, 0, 1, 1, 0, 1, 0, 0, 0]"
13633,2,2,4,0.23867622630085206,"[1, 0, 0, 0, 1, 1, 1, 0, 1, 1]"
13634,1,1,2,0.08370274795606958,"[1, 0, 1, 0, 1, 1, 0, 0, 1, 0]"
13635,1,1,2,0.4011667931672205,"[1, 1, 0, 1, 0, 0, 1, 1, 1, 1]"
13636,1,1,2,0.27250792549224867,"[0, 1, 1, 0, 0, 0, 0, 0, 0, 1]"
13637,2,2,4,0.15856147783821617,"[1, 0, 1, 1, 0, 1, 1, 1, 0, 0]"
13638,1,1,2,0.2489777324181629,"[1, 1, 1, 0, 0, 0, 0, 0, 1, 0]"
13639,1,1,2,0.9738125283616981,"[0, 0, 1, 0, 1, 0, 1, 0, 0, 0]"
13640,1,1,2,0.40232093300630334,"[0, 1, 0, 1, 1, 1, 1, 0, 1, 1]"
13641,1,1,2,0.31103363795459726,"[0, 0, 0, 0, 1, 0, 0, 1, 0, 1]"
13642,1,1,2,0.09131851371227728,"[0, 0, 0, 0, 0, 1, 0, 1, 0, 0]"
13643,2,2,4,0.5089576029281903,"[0, 0, 1, 1, 0, 0, 1, 1, 0, 0]"
13644,1,1,2,0.7901477562421637,"[0, 0, 1, 0, 0, 1, 1, 0, 1, 0]"
13645,1,1,2,0.015605691511545006,"[0, 1, 1, 1, 1, 0, 1, 1, 1, 1]"
13646,1,1,2,0.755254258015209,"[0, 1, 1, 1, 1, 1, 1, 0, 0, 0]"
13647,1,1,2,0.21324102542203616,"[0, 0, 1, 1, 0, 1, 1, 0, 0, 0]"
13648,1,1,2,0.9731484636196852,"[0, 1, 0, 0, 1, 0, 0, 0, 0, 0]"
13649,1,1,2,0.3004719799684237,"[0, 0, 1, 1, 1, 1, 1, 1, 1, 1]"
13650,1,1,2,0.4963404627759801,"[1, 0, 1, 1, 0, 1, 0, 1, 1, 1]"
13651,1,1,2,0.7901728365804128,"[1, 0, 1, 0, 1, 0, 1, 1, 0, 0]"
13652,1,1,2,0.3533270726180009,"[0, 0, 1, 0, 0, 1, 1, 1, 0, 1]"
13653,4,4,8,0.4757501482715121,"[0, 1, 0, 1, 1, 1, 1, 1, 0, 0]"
13654,1,1,2,0.6049002013351875,"[0, 1, 0, 1, 1, 0, 1, 0, 1, 1]"
13655,1,1,2,0.09423824577992568,"[0, 0, 0, 1, 1, 1, 1, 0, 1, 0]"
13656,1,1,2,0.0035965569133900033,"[1, 0, 0, 0, 1, 1, 1, 0, 1, 1]"
13657,1,1,2,0.2711635703802113,"[0, 0, 1, 1, 0, 1, 0, 1, 1, 1]"
13658,2,2,4,0.10216436930311346,"[1, 1, 1, 0, 1, 0, 1, 1, 1, 1]"
13659,1,1,2,0.644352053113275,"[1, 1, 1, 0, 0, 0, 0, 0, 1, 1]"
13660,1,1,2,0.5892564691232114,"[1, 1, 1, 0, 0, 1, 1, 1, 1, 0]"
13661,1,1,2,0.12457945849338392,"[0, 0, 1, 1, 1, 1, 0, 1, 1, 1]"
13662,2,2,4,0.6482424562947048,"[1, 1, 1, 1, 1, 1, 1, 1, 0, 0]"
13663,1,1,2,0.15536028791623402,"[1, 1, 0, 0, 1, 0, 0, 0, 0, 1]"
13664,1,1,2,0.2754349997504413,"[1, 1, 1, 0, 1, 0, 0, 0, 0, 1]"
13665,1,1,2,0.4889032389815595,"[1, 1, 1, 0, 0, 0, 1, 0, 1, 1]"
13666,1,1,2,0.7682465084796614,"[0, 1, 0, 1, 0, 0, 1, 0, 1, 0]"
13667,1,1,2,0.1821014105489258,"[1, 1, 0, 0, 0, 1, 1, 1, 0, 1]"
13668,2,2,4,0.8272514734774707,"[0, 1, 1, 1, 1, 1, 1, 0, 0, 0]"
13669,1,1,2,0.45196973746315394,"[1, 1, 1, 1, 0, 0, 1, 1, 0, 1]"
13670,2,2,4,0.8552351908629297,"[0, 0, 0, 1, 1, 1, 1, 0, 1, 0]"
13671,1,1,2,0.30085771067415934,"[0, 1, 0, 0, 1, 0, 0, 0, 1, 1]"
13672,1,1,2,0.16621478054618755,"[0, 0, 1, 0, 0, 0, 1, 0, 0, 1]"
13673,1,1,2,0.532258075071143,"[0, 1, 0, 1, 1, 0, 1, 0, 1, 1]"
13674,1,1,2,0.7166885824234771,"[1, 1, 0, 0, 1, 1, 0, 0, 1, 1]"
13675,1,1,2,0.705816528203253,"[0, 0, 1, 0, 0, 1, 1, 1, 1, 1]"
13676,3,3,6,0.4516050461632458,"[0, 1, 1, 0, 1, 0, 1, 1, 1, 1]"
13677,1,1,2,0.9261282373506503,"[0, 1, 0, 0, 0, 0, 0, 0, 0, 0]"
13678,1,1,2,0.8456587170621045,"[1, 0, 0, 0, 1, 1, 0, 1, 0, 0]"
13679,1,1,2,0.7230685170883647,"[0, 1, 0, 0, 1, 0, 0, 1, 1, 0]"
13680,1,1,2,0.7035873829208876,"[1, 1, 1, 1, 1, 1, 0, 1, 1, 0]"
13681,1,1,2,0.687460832534799,"[1, 1, 0, 0, 1, 0, 0, 1, 0, 0]"
13682,2,2,4,0.09002016159299087,"[1, 0, 1, 1, 0, 1, 1, 1, 1, 0]"
13683,1,1,2,0.45393783576583346,"[1, 1, 0, 0, 1, 0, 0, 0, 1, 1]"
13684,1,1,2,0.9998734668768969,"[1, 1, 1, 1, 1, 0, 0, 0, 1, 1]"
13685,1,1,2,0.749690372226267,"[1, 0, 0, 1, 1, 0, 1, 1, 0, 1]"
13686,1,1,2,0.21250324535519283,"[0, 1, 0, 1, 0, 0, 1, 0, 1, 1]"
13687,1,1,2,0.8521688119028019,"[1, 0, 0, 0, 0, 1, 0, 0, 1, 0]"
13688,1,1,2,0.9821767141534921,"[1, 0, 0, 1, 0, 0, 1, 0, 0, 1]"
13689,1,1,2,0.5868554770726365,"[1, 0, 1, 1, 1, 0, 0, 1, 0, 0]"
13690,1,1,2,0.9280731874992362,"[0, 1, 1, 1, 0, 1, 1, 1, 0, 1]"
13691,1,1,2,0.1188917404140869,"[1, 0, 0, 1, 1, 1, 0, 0, 0, 0]"
13692,2,2,4,0.10114449387465518,"[0, 1, 1, 0, 0, 1, 0, 1, 0, 0]"
13693,1,1,2,0.3105545188682174,"[0, 0, 1, 0, 1, 0, 1, 0, 1, 0]"
13694,1,1,2,0.9530303157145196,"[1, 0, 1, 0, 1, 0, 1, 0, 1, 0]"
13695,1,1,2,0.13489935395949915,"[0, 1, 1, 1, 1, 0, 0, 1, 0, 1]"
13696,2,2,4,0.014659415584425517,"[0, 1, 0, 1, 1, 1, 1, 0, 0, 1]"
13697,2,2,4,0.8910324194265705,"[1, 0, 0, 1, 1, 1, 1, 1, 1, 0]"
13698,1,1,2,0.1399438689247442,"[1, 1, 0, 1, 1, 0, 1, 1, 0, 1]"
13699,1,1,2,0.4605189226138603,"[1, 0, 1, 0, 0, 0, 0, 1, 1, 0]"
13700,2,2,4,0.41821363286034086,"[1, 0, 0, 0, 1, 1, 0, 0, 1, 0]"
13701,1,1,2,0.2342198933434927,"[1, 0, 1, 0, 1, 1, 0, 0, 1, 0]"
13702,1,1,2,0.3472761265328994,"[1, 1, 0, 0, 1, 1, 0, 1, 0, 1]"
13703,1,1,2,0.423906934539818,"[0, 1, 0, 0, 0, 1, 1, 1, 1, 0]"
13704,1,1,2,0.09898677428613811,"[0, 1, 0, 0, 0, 1, 0, 1, 0, 1]"
13705,1,1,2,0.5546497962844278,"[0, 0, 0, 1, 1, 0, 1, 0, 0, 1]"
13706,1,1,2,0.8063923748470582,"[0, 1, 0, 1, 0, 1, 0, 1, 1, 0]"
13707,1,1,2,0.2711173490749539,"[0, 0, 1, 1, 0, 0, 0, 1, 0, 1]"
13708,1,1,2,0.7584042723354417,"[0, 1, 0, 1, 1, 1, 1, 1, 0, 0]"
13709,1,1,2,0.7446202578046207,"[1, 0, 1, 1, 1, 0, 0, 1, 0, 0]"
13710,1,1,2,0.34453571760869606,"[0, 0, 0, 1, 0, 0, 0, 1, 1, 1]"
13711,1,1,2,0.5423888425567378,"[1, 0, 0, 1, 1, 0, 0, 1, 0, 0]"
13712,1,1,2,0.5851604778908049,"[1, 0, 0, 1, 1, 0, 0, 0, 1, 1]"
13713,1,1,2,0.012227668481529452,"[1, 0, 0, 1, 0, 1, 0, 0, 0, 0]"
13714,2,2,4,0.5637533231791025,"[1, 0, 0, 0, 0, 0, 0, 1, 0, 1]"
13715,1,1,2,0.730242608480257,"[0, 1, 0, 1, 0, 0, 0, 1, 1, 1]"
13716,1,1,2,0.8577904674550714,"[1, 0, 1, 0, 0, 0, 1, 1, 0, 1]"
13717,1,1,2,0.879719116319019,"[0, 1, 0, 1, 1, 0, 1, 1, 1, 0]"
13718,1,1,2,0.021428507950556952,"[1, 1, 0, 1, 1, 1, 1, 0, 0, 1]"
13719,2,2,4,0.7383732927815116,"[0, 1, 1, 1, 0, 0, 1, 0, 1, 0]"
13720,1,1,2,0.6996764953861947,"[0, 1, 1, 0, 1, 0, 1, 0, 1, 0]"
13721,2,2,4,0.7860595293246405,"[1, 0, 1, 1, 1, 0, 1, 0, 0, 1]"
13722,1,1,2,0.6194720258815511,"[0, 1, 0, 1, 1, 1, 1, 1, 0, 1]"
13723,1,1,2,0.13507014586750588,"[0, 1, 0, 0, 1, 0, 1, 0, 1, 0]"
13724,2,2,4,0.48830377068128794,"[1, 1, 0, 0, 0, 1, 0, 0, 0, 0]"
13725,1,1,2,0.1767026049461381,"[1, 0, 0, 1, 1, 0, 0, 1, 0, 0]"
13726,1,1,2,0.7829760129023531,"[0, 1, 0, 0, 0, 0, 1, 0, 1, 1]"
13727,2,2,4,0.2501172033571619,"[0, 0, 0, 0, 1, 1, 1, 0, 1, 0]"
13728,1,1,2,0.037513725453168445,"[1, 1, 0, 0, 1, 1, 1, 1, 0, 0]"
13729,1,1,2,0.6185352072441245,"[0, 0, 1, 0, 1, 1, 1, 1, 1, 0]"
13730,1,1,2,0.45593701677715526,"[1, 0, 1, 0, 1, 0, 1, 1, 1, 0]"
13731,1,1,2,0.5964602410659414,"[1, 1, 1, 1, 0, 1, 0, 1, 0, 1]"
13732,1,1,2,0.6049954840674289,"[0, 0, 0, 1, 1, 0, 0, 1, 0, 0]"
13733,1,1,2,0.5250063556806118,"[1, 1, 1, 0, 1, 0, 0, 1, 0, 1]"
13734,1,1,2,0.12037746710022423,"[0, 1, 1, 1, 1, 0, 1, 1, 0, 1]"
13735,1,1,2,0.98289561610844,"[0, 1, 1, 0, 1, 0, 1, 1, 0, 1]"
13736,2,2,4,0.9864719226905476,"[0, 1, 1, 0, 1, 1, 1, 1, 1, 1]"
13737,2,2,4,0.6380739286214968,"[0, 0, 1, 1, 1, 0, 1, 1, 0, 0]"
13738,1,1,2,0.7687702712077265,"[0, 1, 0, 0, 0, 1, 0, 0, 1, 0]"
13739,1,1,2,0.7362528725529227,"[1, 1, 0, 0, 0, 1, 1, 0, 0, 0]"
13740,1,1,2,0.050438697473976335,"[0, 1, 1, 0, 1, 0, 0, 0, 0, 1]"
13741,1,1,2,0.6592462931875624,"[0, 1, 1, 0, 1, 0, 0, 1, 0, 1]"
13742,1,1,2,0.2605917448333701,"[0, 1, 0, 0, 1, 1, 0, 0, 0, 0]"
13743,1,1,2,0.5250927109346757,"[1, 0, 0, 0, 1, 1, 0, 0, 1, 1]"
13744,1,1,2,0.6430013922745469,"[0, 0, 0, 0, 0, 1, 1, 0, 1, 1]"
13745,1,1,2,0.83273283316056,"[1, 0, 0, 1, 0, 0, 1, 0, 0, 1]"
13746,1,1,2,0.7792972326523605,"[1, 1, 1, 1, 1, 0, 1, 0, 1, 1]"
13747,1,1,2,0.4526919191588873,"[0, 1, 0, 1, 0, 0, 1, 1, 1, 0]"
13748,2,2,4,0.6301827314314852,"[1, 0, 1, 1, 0, 0, 0, 1, 1, 0]"
13749,1,1,2,0.9943529358829838,"[1, 0, 1, 0, 1, 0, 1, 0, 0, 0]"
13750,2,2,4,0.3184066975582319,"[1, 1, 1, 0, 0, 0, 0, 0, 1, 1]"
13751,1,1,2,0.029092829622876404,"[0, 0, 1, 0, 0, 1, 1, 0, 0, 0]"
13752,1,1,2,0.7195912739193584,"[1, 1, 0, 0, 0, 1, 1, 1, 0, 1]"
13753,1,1,2,0.6889169232427904,"[1, 1, 0, 0, 0, 1, 0, 1, 1, 1]"
13754,1,1,2,0.007782238395631413,"[0, 0, 1, 0, 0, 0, 0, 0, 1, 1]"
13755,1,1,2,0.39174723091732944,"[1, 1, 1, 0, 0, 0, 1, 1, 0, 1]"
13756,1,1,2,0.8558239764228831,"[1, 0, 0, 1, 0, 1, 0, 0, 0, 1]"
13757,1,1,2,0.09587358783436051,"[1, 1, 1, 1, 0, 0, 1, 1, 0, 1]"
13758,1,1,2,0.8566292487624867,"[0, 1, 1, 1, 0, 1, 0, 0, 0, 0]"
13759,1,1,2,0.6851953008982845,"[1, 0, 1, 1, 0, 0, 1, 1, 1, 0]"
13760,1,1,2,0.4434342752981506,"[1, 0, 1, 1, 0, 0, 0, 0, 0, 0]"
13761,1,1,2,0.22649650289703482,"[0, 0, 1, 0, 0, 0, 0, 0, 0, 0]"
13762,1,1,2,0.979722990188868,"[0, 1, 1, 0, 1, 0, 0, 0, 0, 1]"
13763,1,1,2,0.004469834285800611,"[1, 0, 0, 0, 0, 1, 1, 1, 0, 1]"
13764,2,2,4,0.5475708593478102,"[0, 0, 0, 1, 0, 1, 0, 0, 1, 1]"
13765,1,1,2,0.6950652941568989,"[1, 0, 1, 1, 1, 1, 1, 0, 1, 0]"
13766,1,1,2,0.47221379788214835,"[0, 0, 1, 0, 1, 0, 0, 0, 0, 1]"
13767,1,1,2,0.39510854274927143,"[0, 0, 1, 1, 1, 1, 0, 1, 0, 1]"
13768,2,2,4,0.3400301563687681,"[1, 1, 0, 1, 0, 0, 0, 1, 1, 0]"
13769,1,1,2,0.5685312020218194,"[1, 0, 1, 0, 1, 1, 0, 1, 1, 0]"
13770,1,1,2,0.8581318757623039,"[0, 0, 1, 1, 0, 0, 1, 1, 1, 0]"
13771,1,1,2,0.3208576620478132,"[0, 1, 1, 0, 0, 0, 0, 0, 1, 0]"
13772,1,1,2,0.4509177456326555,"[0, 0, 1, 1, 1, 1, 1, 0, 0, 0]"
13773,1,1,2,0.966235226144264,"[0, 1, 0, 1, 1, 1, 1, 1, 0, 1]"
13774,2,2,4,0.5157443176490233,"[1, 1, 1, 0, 1, 1, 1, 0, 1, 0]"
13775,1,1,2,0.5465880281144049,"[0, 0, 0, 1, 1, 1, 1, 0, 1, 1]"
13776,1,1,2,0.16455901627018155,"[1, 1, 1, 1, 0, 0, 0, 0, 1, 1]"
13777,1,1,2,0.5750841627201273,"[1, 0, 1, 1, 0, 1, 1, 1, 1, 0]"
13778,1,1,2,0.6090507644018568,"[0, 0, 1, 1, 0, 0, 0, 0, 1, 0]"
13779,1,1,2,0.7377412439749214,"[0, 1, 1, 0, 1, 0, 0, 0, 1, 1]"
13780,2,2,4,0.18646795827016638,"[0, 1, 1, 0, 1, 0, 0, 1, 0, 1]"
13781,1,1,2,0.8564091413339813,"[1, 0, 0, 0, 1, 1, 0, 0, 0, 0]"
13782,1,1,2,0.6399252262936301,"[1, 0, 1, 0, 0, 0, 1, 1, 0, 0]"
13783,1,1,2,0.6609162333844345,"[1, 0, 0, 0, 1, 1, 1, 1, 1, 0]"
13784,1,1,2,0.7365748257035053,"[1, 0, 0, 0, 0, 1, 1, 1, 0, 1]"
13785,1,1,2,0.8232772346625563,"[0, 1, 1, 1, 1, 0, 0, 1, 0, 1]"
13786,1,1,2,0.28830074013727347,"[0, 0, 1, 1, 0, 1, 0, 1, 0, 0]"
13787,1,1,2,0.1459566748819633,"[0, 1, 1, 1, 1, 0, 0, 0, 0, 0]"
13788,1,1,2,0.09876552546068174,"[1, 1, 0, 0, 1, 1, 0, 0, 0, 1]"
13789,1,1,2,0.7689194911164464,"[0, 1, 1, 1, 0, 0, 0, 0, 0, 1]"
13790,1,1,2,0.8274624538140167,"[0, 0, 1, 0, 1, 1, 1, 0, 0, 0]"
13791,2,2,4,0.36332349344381554,"[1, 0, 0, 0, 1, 0, 0, 0, 0, 0]"
13792,1,1,2,0.34053799287760766,"[1, 0, 1, 1, 1, 0, 0, 1, 0, 0]"
13793,1,1,2,0.43718928836615356,"[0, 1, 1, 0, 0, 0, 1, 1, 1, 1]"
13794,1,1,2,0.0766197073100664,"[0, 1, 1, 1, 0, 0, 0, 0, 1, 0]"
13795,1,1,2,0.7050249285257095,"[1, 0, 0, 0, 0, 0, 1, 0, 0, 0]"
13796,1,1,2,0.3223496104012027,"[1, 0, 0, 1, 0, 1, 1, 0, 0, 1]"
13797,2,2,4,0.2053030118808773,"[0, 1, 1, 1, 0, 0, 0, 0, 1, 0]"
13798,2,2,4,0.8126464188011343,"[0, 1, 1, 0, 0, 0, 0, 1, 0, 1]"
13799,1,1,2,0.8756731904295116,"[0, 1, 1, 0, 1, 1, 1, 1, 1, 0]"
13800,1,1,2,0.17396921283215483,"[0, 1, 0, 1, 0, 1, 0, 1, 0, 1]"
13801,1,1,2,0.06428274991631344,"[1, 0, 0, 0, 1, 0, 0, 0, 0, 0]"
13802,2,2,4,0.29453052558013637,"[0, 1, 0, 1, 0, 1, 1, 1, 1, 1]"
13803,1,1,2,0.6576520833757681,"[1, 0, 1, 0, 1, 1, 0, 0, 1, 0]"
13804,2,2,4,0.10546633687529927,"[1, 1, 1, 0, 0, 1, 1, 1, 0, 1]"
13805,1,1,2,0.06778732416759892,"[1, 1, 1, 1, 0, 1, 1, 0, 0, 0]"
13806,1,1,2,0.4764698245199993,"[1, 0, 0, 1, 1, 0, 0, 1, 1, 0]"
13807,1,1,2,0.17077050657688952,"[1, 1, 0, 1, 0, 1, 0, 0, 0, 1]"
13808,1,1,2,0.35164886311874843,"[0, 0, 1, 1, 0, 1, 1, 1, 1, 0]"
13809,1,1,2,0.5757635428200807,"[0, 0, 0, 0, 0, 1, 0, 0, 0, 0]"
13810,1,1,2,0.28942405931783843,"[1, 1, 0, 0, 0, 0, 1, 1, 1, 0]"
13811,1,1,2,0.7454334159489995,"[0, 1, 0, 1, 0, 1, 1, 1, 1, 1]"
13812,1,1,2,0.8004066934381537,"[0, 0, 1, 0, 0, 0, 0, 1, 1, 0]"
13813,1,1,2,0.734693804845131,"[1, 1, 0, 1, 1, 0, 1, 0, 0, 1]"
13814,1,1,2,0.6166171815312265,"[0, 1, 0, 1, 0, 1, 0, 0, 0, 0]"
13815,1,1,2,0.2350611026989049,"[1, 0, 0, 0, 1, 0, 1, 1, 1, 0]"
13816,1,1,2,0.9812420671663052,"[1, 1, 1, 1, 0, 0, 0, 1, 0, 1]"
13817,1,1,2,0.1611480396782008,"[0, 0, 1, 1, 0, 1, 1, 1, 0, 1]"
13818,1,1,2,0.43509210721456637,"[0, 1, 0, 1, 0, 1, 0, 1, 1, 1]"
13819,1,1,2,0.9587273663018241,"[1, 1, 0, 0, 1, 1, 0, 0, 1, 1]"
13820,1,1,2,0.6619255135331411,"[0, 0, 0, 0, 0, 1, 0, 0, 1, 0]"
13821,1,1,2,0.2663319850188578,"[0, 0, 1, 1, 0, 1, 0, 0, 0, 0]"
13822,1,1,2,0.9150501107499891,"[0, 1, 1, 1, 0, 1, 0, 1, 1, 0]"
13823,1,1,2,0.5666206364083578,"[0, 0, 0, 1, 0, 1, 0, 1, 0, 1]"
13824,1,1,2,0.38296435533304596,"[0, 1, 1, 1, 0, 0, 1, 0, 1, 0]"
13825,1,1,2,0.7135951088791245,"[1, 1, 1, 0, 0, 0, 0, 1, 1, 1]"
13826,2,2,4,0.2807433031694698,"[1, 1, 1, 1, 1, 0, 1, 1, 0, 0]"
13827,3,3,6,0.9120761552927977,"[0, 0, 0, 0, 0, 0, 1, 1, 1, 0]"
13828,1,1,2,0.7322532824731356,"[0, 0, 1, 0, 0, 0, 0, 0, 0, 1]"
13829,1,1,2,0.807287928410586,"[1, 0, 0, 0, 1, 0, 1, 1, 0, 1]"
13830,1,1,2,0.6183447256576826,"[1, 0, 0, 1, 1, 0, 1, 1, 0, 1]"
13831,1,1,2,0.2601228442321337,"[0, 1, 0, 1, 1, 1, 0, 1, 0, 0]"
13832,1,1,2,0.3222003866598263,"[0, 1, 1, 1, 1, 1, 1, 0, 0, 0]"
13833,1,1,2,0.8259389246206503,"[1, 1, 0, 1, 1, 0, 0, 0, 0, 0]"
13834,1,1,2,0.6635863658127733,"[0, 1, 0, 0, 0, 1, 1, 0, 1, 0]"
13835,1,1,2,0.3148146462050293,"[1, 1, 0, 1, 1, 1, 0, 0, 0, 1]"
13836,1,1,2,0.5545517689340792,"[0, 0, 0, 1, 1, 0, 0, 1, 1, 1]"
13837,2,2,4,0.9450640549370423,"[0, 0, 0, 1, 1, 0, 1, 1, 1, 1]"
13838,2,2,4,0.2423093139562118,"[1, 1, 0, 0, 1, 0, 1, 1, 0, 0]"
13839,2,2,4,0.4828565584132519,"[1, 0, 1, 0, 0, 0, 0, 1, 1, 0]"
13840,2,2,4,0.2762473658286384,"[0, 0, 1, 0, 1, 0, 0, 1, 1, 1]"
13841,1,1,2,0.13273119806947842,"[1, 1, 0, 1, 1, 0, 1, 1, 1, 0]"
13842,1,1,2,0.20412781136306757,"[1, 0, 1, 0, 1, 1, 1, 0, 1, 0]"
13843,1,1,2,0.1889263907212967,"[0, 0, 0, 1, 0, 0, 1, 0, 1, 1]"
13844,1,1,2,0.5479051560860005,"[1, 0, 0, 0, 1, 1, 1, 0, 0, 0]"
13845,4,4,8,0.9320734006240474,"[0, 0, 1, 0, 1, 1, 1, 1, 1, 1]"
13846,1,1,2,0.9800969681164119,"[1, 0, 0, 1, 1, 0, 1, 1, 0, 0]"
13847,1,1,2,0.3209725581173214,"[1, 1, 1, 0, 1, 1, 0, 1, 0, 0]"
13848,1,1,2,0.019663473318887625,"[0, 1, 1, 0, 0, 0, 1, 1, 1, 0]"
13849,1,1,2,0.7517591066947542,"[1, 0, 1, 0, 0, 1, 1, 0, 0, 1]"
13850,1,1,2,0.8122015954272355,"[0, 1, 1, 1, 1, 0, 1, 0, 1, 1]"
13851,1,1,2,0.5002851374111276,"[0, 1, 0, 0, 1, 1, 0, 1, 0, 1]"
13852,1,1,2,0.5455825393411879,"[0, 1, 1, 1, 0, 1, 0, 1, 1, 0]"
13853,2,2,4,0.42318865571787034,"[0, 1, 0, 0, 1, 1, 0, 1, 0, 1]"
13854,1,1,2,0.7160081350906874,"[1, 1, 1, 1, 1, 0, 0, 0, 0, 1]"
13855,1,1,2,0.31149375779597976,"[1, 0, 0, 0, 0, 1, 0, 1, 1, 1]"
13856,1,1,2,0.3666962172568685,"[1, 1, 0, 0, 1, 0, 1, 0, 1, 1]"
13857,1,1,2,0.9338084664255146,"[0, 1, 1, 0, 1, 1, 0, 1, 1, 0]"
13858,1,1,2,0.8491975609909823,"[1, 1, 1, 0, 1, 0, 0, 1, 1, 1]"
13859,1,1,2,0.3924037365381299,"[0, 0, 1, 1, 0, 1, 0, 1, 1, 1]"
13860,1,1,2,0.39686683608840334,"[1, 1, 0, 0, 1, 0, 1, 0, 1, 1]"
13861,1,1,2,0.6476798573894146,"[1, 1, 1, 0, 1, 1, 1, 1, 1, 0]"
13862,1,1,2,0.3564824976476165,"[1, 0, 1, 1, 1, 1, 1, 0, 1, 1]"
13863,1,1,2,0.04699161835431931,"[1, 0, 0, 1, 1, 0, 0, 1, 1, 0]"
13864,1,1,2,0.2132113569122721,"[0, 1, 0, 0, 0, 0, 0, 1, 1, 0]"
13865,1,1,2,0.8153933764061913,"[0, 0, 0, 0, 0, 0, 0, 1, 1, 0]"
13866,1,1,2,0.5074601601528066,"[0, 1, 1, 1, 0, 0, 1, 0, 1, 1]"
13867,1,1,2,0.20201375539859523,"[0, 0, 1, 0, 0, 1, 0, 0, 1, 0]"
13868,1,1,2,0.1611157873676734,"[0, 1, 1, 1, 1, 0, 0, 0, 0, 1]"
13869,1,1,2,0.1634034356628481,"[1, 0, 0, 0, 0, 1, 1, 1, 0, 0]"
13870,1,1,2,0.5277216796447376,"[0, 1, 1, 1, 0, 0, 1, 1, 1, 1]"
13871,1,1,2,0.18661491339442504,"[1, 1, 1, 1, 1, 0, 0, 0, 0, 0]"
13872,1,1,2,0.9979639044795404,"[0, 0, 0, 0, 0, 0, 1, 0, 0, 0]"
13873,2,2,4,0.9722970986724075,"[0, 1, 1, 1, 1, 1, 1, 0, 1, 1]"
13874,1,1,2,0.6156835676945045,"[0, 1, 1, 1, 1, 1, 1, 0, 0, 0]"
13875,1,1,2,0.4655137471226951,"[0, 0, 0, 1, 1, 1, 0, 1, 1, 1]"
13876,1,1,2,0.08742506725369947,"[0, 1, 1, 1, 0, 0, 1, 1, 0, 1]"
13877,1,1,2,0.8295261311053028,"[0, 1, 1, 1, 0, 1, 0, 0, 1, 1]"
13878,1,1,2,0.2959992942430153,"[0, 0, 0, 0, 0, 1, 0, 1, 1, 1]"
13879,1,1,2,0.5166416682868709,"[0, 0, 0, 0, 1, 1, 1, 0, 0, 0]"
13880,1,1,2,0.5579136150596157,"[0, 1, 1, 0, 1, 1, 0, 0, 1, 0]"
13881,1,1,2,0.5488410682100757,"[1, 0, 1, 0, 1, 0, 1, 1, 0, 1]"
13882,1,1,2,0.8058030459445743,"[1, 0, 0, 0, 0, 1, 1, 0, 0, 1]"
13883,1,1,2,0.6044613877668941,"[1, 1, 1, 0, 0, 0, 0, 1, 0, 1]"
13884,1,1,2,0.048478358707233715,"[1, 0, 1, 0, 1, 1, 1, 1, 1, 0]"
13885,1,1,2,0.2995150058739042,"[0, 1, 1, 0, 0, 0, 0, 0, 0, 1]"
13886,1,1,2,0.06829286837810056,"[0, 1, 0, 1, 0, 1, 0, 0, 1, 0]"
13887,1,1,2,0.5421163187042454,"[1, 1, 1, 1, 0, 1, 1, 0, 0, 1]"
13888,1,1,2,0.8590189866623837,"[1, 0, 0, 0, 1, 1, 1, 0, 1, 0]"
13889,1,1,2,0.6659028115362564,"[0, 0, 0, 1, 0, 1, 1, 0, 1, 1]"
13890,1,1,2,0.35126337804091823,"[0, 0, 0, 1, 1, 0, 1, 1, 0, 0]"
13891,2,2,4,0.8467164900791804,"[0, 1, 0, 1, 1, 1, 1, 1, 1, 1]"
13892,1,1,2,0.2888946803044614,"[1, 1, 0, 0, 0, 1, 0, 0, 0, 1]"
13893,1,1,2,0.13779532756766233,"[1, 0, 1, 1, 0, 0, 1, 0, 1, 0]"
13894,1,1,2,0.470403052077939,"[0, 1, 1, 0, 0, 1, 1, 0, 0, 0]"
13895,2,2,4,0.2380336751500367,"[0, 1, 1, 1, 1, 1, 1, 1, 0, 0]"
13896,1,1,2,0.29962494043305576,"[0, 1, 0, 1, 1, 1, 0, 1, 0, 0]"
13897,1,1,2,0.6789899583640092,"[0, 1, 0, 0, 0, 0, 0, 0, 1, 1]"
13898,1,1,2,0.8347832740258239,"[0, 0, 1, 1, 0, 0, 1, 0, 0, 1]"
13899,1,1,2,0.10544548749278482,"[1, 0, 0, 0, 0, 0, 0, 1, 0, 0]"
13900,2,2,4,0.32078969142192837,"[0, 0, 0, 0, 0, 0, 1, 1, 0, 0]"
13901,1,1,2,0.7046113413504558,"[0, 1, 0, 1, 0, 0, 1, 0, 0, 0]"
13902,1,1,2,0.40765907476933083,"[0, 0, 1, 1, 0, 0, 1, 1, 0, 1]"
13903,1,1,2,0.02055441685479098,"[1, 0, 1, 1, 0, 1, 1, 1, 1, 1]"
13904,1,1,2,0.5536598031883733,"[0, 1, 1, 1, 0, 1, 1, 0, 1, 0]"
13905,1,1,2,0.9430747397009834,"[1, 1, 0, 0, 1, 1, 1, 1, 1, 0]"
13906,1,1,2,0.027289891777981024,"[1, 0, 0, 1, 0, 1, 0, 1, 0, 1]"
13907,2,2,4,0.16206167631633162,"[0, 1, 1, 1, 0, 0, 1, 0, 1, 1]"
13908,1,1,2,0.8998890224597106,"[1, 1, 0, 1, 1, 0, 1, 0, 1, 1]"
13909,1,1,2,0.16683591095936767,"[0, 1, 0, 0, 0, 1, 1, 1, 1, 0]"
13910,1,1,2,0.05183456325966418,"[1, 0, 1, 1, 0, 1, 0, 0, 0, 0]"
13911,1,1,2,0.40108498366933654,"[0, 0, 1, 0, 0, 0, 1, 1, 1, 1]"
13912,1,1,2,0.349394936656676,"[0, 0, 0, 0, 0, 1, 0, 1, 0, 0]"
13913,1,1,2,0.6948529591186373,"[1, 1, 0, 1, 0, 0, 1, 0, 1, 0]"
13914,2,2,4,0.008898430105185762,"[1, 1, 1, 1, 0, 0, 1, 0, 1, 1]"
13915,1,1,2,0.05192862019262179,"[1, 1, 0, 0, 1, 1, 1, 0, 0, 1]"
13916,1,1,2,0.8017331402817844,"[1, 0, 1, 1, 1, 0, 0, 0, 1, 1]"
13917,3,3,6,0.48022676248520146,"[1, 1, 1, 1, 1, 1, 0, 1, 0, 1]"
13918,1,1,2,0.775241173758679,"[0, 0, 0, 1, 1, 1, 0, 0, 1, 1]"
13919,1,1,2,0.5280381014038296,"[0, 0, 1, 0, 0, 0, 1, 1, 0, 0]"
13920,1,1,2,0.4205926774747418,"[0, 1, 1, 0, 0, 0, 1, 0, 1, 1]"
13921,2,2,4,0.6003709011140156,"[0, 0, 1, 0, 0, 1, 0, 0, 0, 1]"
13922,1,1,2,0.09374056770256689,"[0, 0, 0, 0, 1, 0, 0, 1, 0, 0]"
13923,3,3,6,0.6157794000871193,"[0, 0, 1, 1, 1, 0, 1, 0, 1, 0]"
13924,2,2,4,0.3593718098104325,"[1, 1, 1, 1, 1, 1, 0, 0, 1, 1]"
13925,1,1,2,0.510784679097749,"[1, 1, 1, 1, 0, 1, 1, 0, 0, 0]"
13926,1,1,2,0.09608031240445147,"[1, 1, 0, 1, 1, 0, 1, 0, 1, 1]"
13927,1,1,2,0.3754721652760501,"[1, 1, 1, 1, 0, 0, 0, 1, 1, 0]"
13928,1,1,2,0.43436634985613853,"[0, 0, 1, 1, 0, 1, 0, 0, 0, 1]"
13929,1,1,2,0.40618320774972994,"[0, 0, 1, 1, 0, 1, 1, 0, 0, 0]"
13930,1,1,2,0.6216810970642048,"[0, 0, 1, 1, 0, 0, 1, 0, 0, 1]"
13931,1,1,2,0.9161791525069113,"[0, 1, 1, 0, 0, 0, 0, 0, 1, 0]"
13932,1,1,2,0.95326485180498,"[1, 0, 0, 1, 1, 0, 0, 0, 1, 0]"
13933,1,1,2,0.6350850662940155,"[0, 1, 1, 0, 0, 1, 1, 0, 1, 0]"
13934,1,1,2,0.4274289107250111,"[0, 1, 0, 1, 0, 1, 0, 0, 1, 0]"
13935,1,1,2,0.3790003456164751,"[0, 0, 1, 0, 1, 1, 0, 0, 1, 1]"
13936,1,1,2,0.742489867993943,"[0, 1, 1, 1, 0, 0, 1, 1, 0, 0]"
13937,1,1,2,0.02614557660555128,"[1, 1, 1, 0, 1, 0, 1, 1, 1, 0]"
13938,1,1,2,0.6098717089543861,"[0, 1, 0, 1, 0, 0, 0, 0, 0, 0]"
13939,1,1,2,0.9645571969933263,"[0, 0, 1, 1, 0, 0, 1, 1, 0, 1]"
13940,1,1,2,0.1734029688462413,"[0, 0, 0, 0, 0, 1, 1, 0, 0, 0]"
13941,1,1,2,0.11443268289805286,"[0, 0, 0, 1, 0, 1, 1, 0, 1, 1]"
13942,1,1,2,0.7983072268271498,"[0, 1, 0, 0, 1, 0, 0, 1, 0, 0]"
13943,1,1,2,0.4785997303737106,"[1, 1, 0, 1, 1, 0, 1, 1, 0, 0]"
13944,1,1,2,0.5175103550448589,"[0, 0, 1, 0, 0, 0, 1, 1, 0, 0]"
13945,1,1,2,0.7333126890128338,"[1, 1, 1, 1, 1, 1, 0, 1, 0, 0]"
13946,1,1,2,0.1150908395611625,"[0, 1, 0, 0, 1, 0, 0, 0, 1, 0]"
13947,1,1,2,0.5584601807535521,"[0, 1, 1, 0, 1, 0, 1, 1, 1, 0]"
13948,2,2,4,0.8153097496395789,"[1, 1, 0, 1, 1, 0, 1, 0, 1, 1]"
13949,2,2,4,0.553052001915117,"[0, 0, 0, 1, 1, 1, 0, 1, 1, 1]"
13950,1,1,2,0.19688767916758443,"[0, 1, 1, 1, 0, 0, 0, 1, 1, 0]"
13951,1,1,2,0.41601229348454294,"[1, 1, 1, 1, 1, 0, 0, 0, 1, 1]"
13952,1,1,2,0.5929605700367768,"[0, 1, 0, 1, 1, 1, 1, 0, 0, 1]"
13953,1,1,2,0.16677100883687357,"[1, 0, 0, 1, 1, 0, 1, 0, 0, 0]"
13954,2,2,4,0.8613756069810102,"[0, 1, 1, 0, 1, 1, 0, 0, 1, 1]"
13955,1,1,2,0.829194719535818,"[1, 0, 0, 1, 0, 1, 0, 0, 0, 1]"
13956,1,1,2,0.6518065887426839,"[1, 0, 0, 0, 1, 0, 0, 0, 1, 1]"
13957,1,1,2,0.5700572947747484,"[1, 0, 1, 0, 1, 0, 0, 1, 0, 1]"
13958,2,2,4,0.6892373193252016,"[0, 0, 1, 0, 1, 1, 1, 1, 1, 1]"
13959,1,1,2,0.4228901836916428,"[1, 1, 0, 0, 1, 0, 1, 1, 1, 0]"
13960,1,1,2,0.3825039160391782,"[1, 0, 1, 0, 1, 0, 1, 0, 1, 0]"
13961,1,1,2,0.3021111597303986,"[0, 1, 1, 1, 0, 1, 0, 1, 1, 0]"
13962,1,1,2,0.7823322371622476,"[0, 0, 1, 0, 0, 0, 0, 0, 0, 0]"
13963,1,1,2,0.5469471293631761,"[1, 1, 0, 1, 1, 1, 0, 1, 0, 0]"
13964,1,1,2,0.4112997482645018,"[0, 0, 0, 1, 1, 0, 1, 0, 0, 1]"
13965,1,1,2,0.69643460735033,"[1, 1, 1, 0, 1, 0, 0, 0, 0, 1]"
13966,1,1,2,0.8723821166017818,"[1, 1, 1, 1, 0, 0, 1, 0, 1, 1]"
13967,2,2,4,0.5610414658255599,"[0, 1, 1, 1, 1, 1, 1, 1, 0, 1]"
13968,1,1,2,0.25179274817367914,"[1, 0, 0, 0, 0, 0, 0, 0, 1, 0]"
13969,1,1,2,0.7272978466843081,"[1, 1, 1, 0, 0, 0, 1, 1, 0, 0]"
13970,2,2,4,0.07314977859030669,"[1, 0, 1, 1, 1, 1, 1, 1, 0, 1]"
13971,2,2,4,0.6171904929634231,"[1, 1, 0, 0, 1, 1, 1, 0, 0, 1]"
13972,1,1,2,0.15161119492996933,"[1, 0, 0, 1, 0, 1, 0, 1, 0, 1]"
13973,1,1,2,0.29970683047859625,"[1, 0, 1, 1, 1, 1, 1, 0, 0, 0]"
13974,1,1,2,0.544674286395029,"[1, 0, 0, 0, 1, 0, 0, 1, 0, 1]"
13975,1,1,2,0.3440756118510414,"[1, 1, 0, 0, 1, 0, 1, 0, 1, 0]"
13976,1,1,2,0.8770987480536299,"[1, 0, 1, 1, 0, 0, 1, 1, 0, 1]"
13977,1,1,2,0.2406335460958422,"[0, 1, 0, 0, 1, 1, 0, 1, 0, 1]"
13978,1,1,2,0.4392137559571494,"[0, 0, 1, 0, 1, 0, 0, 0, 0, 0]"
13979,1,1,2,0.8151247732024226,"[1, 0, 0, 1, 1, 1, 1, 1, 0, 1]"
13980,1,1,2,0.17323951010012117,"[0, 0, 0, 1, 0, 1, 1, 0, 1, 1]"
13981,2,2,4,0.9911116583234179,"[1, 0, 1, 1, 0, 0, 1, 1, 0, 1]"
13982,1,1,2,0.9558201841095281,"[1, 1, 0, 1, 1, 0, 1, 1, 1, 1]"
13983,1,1,2,0.09119541316750213,"[1, 1, 0, 1, 0, 0, 1, 1, 0, 1]"
13984,1,1,2,0.38699208227007487,"[0, 0, 0, 1, 0, 1, 1, 0, 0, 0]"
13985,1,1,2,0.00159867996607288,"[1, 0, 0, 0, 1, 0, 1, 1, 1, 1]"
13986,1,1,2,0.4491159355452876,"[0, 0, 1, 1, 0, 1, 1, 0, 0, 0]"
13987,1,1,2,0.027265603232302316,"[0, 1, 0, 1, 1, 0, 1, 0, 0, 1]"
13988,1,1,2,0.9595446869957887,"[1, 0, 1, 1, 0, 1, 1, 1, 0, 1]"
13989,2,2,4,0.5701354454101489,"[1, 1, 1, 1, 0, 1, 0, 1, 1, 0]"
13990,1,1,2,0.9752114761630601,"[1, 1, 1, 1, 1, 1, 0, 1, 0, 1]"
13991,1,1,2,0.79599800129164,"[1, 1, 0, 1, 0, 1, 0, 1, 1, 0]"
13992,2,2,4,0.1668462175615959,"[1, 0, 1, 0, 1, 1, 0, 0, 1, 0]"
13993,1,1,2,0.37586060436421487,"[1, 1, 1, 0, 0, 1, 0, 0, 0, 1]"
13994,1,1,2,0.2778745477684751,"[0, 0, 0, 1, 0, 0, 1, 1, 0, 0]"
13995,1,1,2,0.03700076244216233,"[1, 1, 1, 1, 1, 1, 0, 1, 1, 0]"
13996,1,1,2,0.7727652368398673,"[0, 1, 1, 0, 0, 1, 1, 1, 0, 0]"
13997,1,1,2,0.7302325267046444,"[1, 0, 0, 1, 1, 1, 0, 0, 1, 0]"
13998,1,1,2,0.9950815223937666,"[1, 0, 0, 1, 0, 1, 1, 1, 0, 0]"
13999,1,1,2,0.5300599956483213,"[0, 0, 0, 1, 1, 0, 1, 1, 0, 1]"
14000,1,1,2,0.4074627439475129,"[0, 0, 1, 0, 0, 1, 1, 0, 0, 1]"
14001,1,1,2,0.4151066080232739,"[0, 0, 0, 1, 0, 0, 1, 0, 1, 1]"
14002,1,1,2,0.33331040578016435,"[1, 0, 1, 1, 1, 1, 0, 1, 0, 1]"
14003,1,1,2,0.23784093741051227,"[1, 1, 0, 1, 1, 1, 0, 1, 1, 1]"
14004,1,1,2,0.002860963832353125,"[1, 1, 0, 0, 0, 1, 0, 1, 1, 0]"
14005,1,1,2,0.27304916802262336,"[0, 0, 0, 0, 1, 1, 0, 0, 1, 1]"
14006,1,1,2,0.9378461945329581,"[0, 0, 1, 0, 0, 0, 1, 0, 0, 0]"
14007,1,1,2,0.407900353589303,"[1, 1, 1, 0, 1, 0, 0, 1, 0, 1]"
14008,1,1,2,0.8574782317761006,"[1, 0, 0, 1, 1, 0, 1, 1, 0, 0]"
14009,1,1,2,0.7765185324476225,"[0, 0, 1, 0, 0, 0, 1, 1, 0, 0]"
14010,1,1,2,0.8647034717047153,"[1, 1, 1, 0, 0, 0, 0, 0, 1, 0]"
14011,1,1,2,0.5693949646108748,"[1, 1, 1, 0, 1, 1, 1, 0, 1, 0]"
14012,1,1,2,0.04004016131697463,"[0, 1, 1, 1, 1, 1, 0, 0, 0, 0]"
14013,1,1,2,0.127950948772653,"[1, 1, 1, 0, 0, 1, 0, 1, 1, 1]"
14014,1,1,2,0.3252957133817781,"[1, 0, 1, 0, 1, 0, 1, 0, 0, 1]"
14015,1,1,2,0.12116433307586494,"[1, 0, 0, 1, 0, 1, 1, 1, 0, 0]"
14016,1,1,2,0.9277528469028862,"[1, 1, 0, 1, 0, 0, 1, 1, 1, 1]"
14017,1,1,2,0.5182503966896033,"[0, 0, 0, 0, 0, 0, 1, 1, 0, 1]"
14018,1,1,2,0.0986453397778464,"[0, 0, 1, 0, 0, 1, 1, 1, 0, 0]"
14019,1,1,2,0.684420164717367,"[1, 0, 1, 0, 0, 1, 0, 0, 1, 1]"
14020,1,1,2,0.6300060621951775,"[1, 1, 0, 1, 0, 1, 1, 1, 1, 0]"
14021,1,1,2,0.8756499590995723,"[0, 0, 0, 1, 1, 0, 1, 1, 0, 1]"
14022,1,1,2,0.8673382443692936,"[0, 0, 1, 1, 1, 0, 1, 0, 0, 0]"
14023,1,1,2,0.8000605750631288,"[0, 1, 1, 1, 1, 1, 1, 1, 0, 0]"
14024,1,1,2,0.9575659967828846,"[0, 0, 1, 0, 1, 1, 1, 1, 1, 1]"
14025,2,2,4,0.8987150244557985,"[0, 0, 0, 1, 0, 1, 1, 1, 1, 0]"
14026,1,1,2,0.7311641287427775,"[1, 1, 1, 0, 0, 0, 1, 0, 0, 1]"
14027,1,1,2,0.7929051921788802,"[1, 1, 0, 0, 0, 0, 0, 0, 1, 1]"
14028,1,1,2,0.431022746764092,"[1, 1, 0, 1, 1, 0, 0, 1, 0, 0]"
14029,1,1,2,0.3221616269172778,"[1, 1, 0, 1, 0, 1, 0, 1, 0, 1]"
14030,1,1,2,0.4152047429465541,"[0, 0, 1, 1, 1, 0, 1, 0, 1, 0]"
14031,1,1,2,0.22786876056114358,"[1, 1, 0, 0, 0, 0, 1, 1, 1, 0]"
14032,1,1,2,0.2851314400469339,"[1, 0, 0, 0, 0, 1, 1, 1, 0, 0]"
14033,1,1,2,0.7601239916576057,"[1, 1, 0, 1, 1, 1, 1, 0, 0, 0]"
14034,1,1,2,0.15618330960897786,"[0, 1, 1, 1, 1, 1, 0, 0, 0, 0]"
14035,1,1,2,0.5545074347496727,"[1, 0, 1, 0, 1, 0, 0, 1, 1, 0]"
14036,1,1,2,0.2408319123504179,"[1, 1, 1, 1, 0, 0, 1, 1, 1, 0]"
14037,2,2,4,0.8905093432765273,"[1, 0, 0, 1, 0, 1, 0, 1, 0, 1]"
14038,1,1,2,0.1908791708300439,"[1, 0, 0, 0, 0, 1, 1, 1, 0, 1]"
14039,2,2,4,0.6180634669341916,"[1, 1, 1, 0, 0, 1, 1, 1, 1, 1]"
14040,1,1,2,0.9353344476696924,"[0, 0, 0, 0, 1, 1, 1, 1, 0, 1]"
14041,1,1,2,0.3765332785803961,"[0, 0, 0, 1, 0, 1, 1, 1, 0, 0]"
14042,1,1,2,0.45696334191264876,"[1, 0, 1, 1, 0, 0, 1, 0, 0, 1]"
14043,1,1,2,0.6135923599970203,"[1, 1, 0, 0, 0, 1, 0, 0, 0, 1]"
14044,1,1,2,0.9981834849899294,"[1, 1, 0, 0, 1, 1, 0, 1, 1, 0]"
14045,1,1,2,0.5172166934626806,"[1, 1, 1, 0, 1, 0, 0, 1, 1, 0]"
14046,1,1,2,0.8746014836548126,"[0, 1, 1, 0, 1, 1, 1, 0, 1, 1]"
14047,1,1,2,0.6783665672651833,"[0, 0, 0, 1, 1, 1, 0, 0, 1, 0]"
14048,1,1,2,0.21121465857654642,"[1, 0, 0, 0, 0, 1, 1, 1, 0, 1]"
14049,1,1,2,0.8553082497460457,"[1, 0, 1, 0, 1, 0, 0, 1, 0, 0]"
14050,1,1,2,0.2795121045283533,"[1, 0, 1, 0, 0, 0, 1, 0, 0, 1]"
14051,2,2,4,0.44102604835387826,"[1, 1, 1, 0, 1, 0, 1, 0, 0, 0]"
14052,2,2,4,0.7397030505721046,"[0, 1, 1, 1, 1, 1, 0, 0, 0, 0]"
14053,1,1,2,0.13620423357287081,"[0, 0, 1, 1, 0, 1, 1, 1, 0, 0]"
14054,1,1,2,0.3257934206077646,"[0, 0, 1, 1, 0, 0, 0, 1, 1, 0]"
14055,1,1,2,0.9702187846363989,"[1, 1, 0, 1, 1, 0, 0, 1, 0, 0]"
14056,2,2,4,0.9278801603641742,"[1, 1, 0, 0, 0, 1, 1, 0, 1, 1]"
14057,1,1,2,0.5131408379462956,"[1, 0, 0, 0, 0, 0, 1, 1, 0, 1]"
14058,1,1,2,0.5608658102130678,"[0, 0, 0, 1, 0, 1, 1, 1, 1, 1]"
14059,1,1,2,0.9174079902869497,"[0, 1, 0, 1, 0, 1, 1, 0, 0, 0]"
14060,1,1,2,0.8544436454883781,"[0, 1, 1, 0, 0, 1, 1, 0, 0, 1]"
14061,1,1,2,0.8224136612238506,"[0, 0, 1, 1, 1, 1, 0, 1, 1, 0]"
14062,1,1,2,0.6544915826793459,"[1, 1, 0, 1, 0, 0, 0, 0, 0, 0]"
14063,1,1,2,0.6725616402011535,"[0, 1, 0, 0, 1, 1, 0, 0, 1, 0]"
14064,1,1,2,0.2935846568677529,"[1, 1, 0, 0, 0, 1, 0, 0, 1, 1]"
14065,1,1,2,0.14674138061000297,"[0, 0, 1, 0, 1, 0, 1, 0, 0, 1]"
14066,1,1,2,0.7736312182610758,"[1, 1, 1, 0, 1, 0, 0, 0, 1, 0]"
14067,1,1,2,0.9447578110246324,"[1, 0, 1, 1, 1, 1, 0, 0, 1, 1]"
14068,1,1,2,0.11939452068344758,"[1, 0, 0, 0, 1, 0, 1, 1, 1, 1]"
14069,1,1,2,0.9569734604884452,"[0, 0, 1, 0, 1, 1, 1, 0, 0, 1]"
14070,1,1,2,0.9760386457706834,"[0, 1, 0, 0, 1, 1, 1, 0, 1, 1]"
14071,1,1,2,0.8253911127004101,"[0, 1, 0, 0, 1, 0, 1, 1, 1, 0]"
14072,1,1,2,0.17699247363870396,"[1, 0, 0, 1, 0, 0, 0, 0, 0, 1]"
14073,1,1,2,0.9652423366316776,"[1, 1, 1, 1, 1, 1, 1, 1, 0, 0]"
14074,3,3,6,0.4118509607177874,"[0, 0, 0, 1, 1, 0, 1, 0, 0, 1]"
14075,2,2,4,0.7448341690044035,"[0, 1, 1, 1, 0, 1, 1, 0, 1, 1]"
14076,1,1,2,0.707937573319949,"[1, 1, 0, 1, 0, 1, 0, 0, 1, 1]"
14077,1,1,2,0.11792234372430299,"[1, 0, 1, 1, 1, 1, 1, 0, 0, 1]"
14078,1,1,2,0.4183242264521715,"[0, 0, 0, 1, 1, 0, 0, 0, 1, 1]"
14079,2,2,4,0.6667501850577713,"[1, 0, 0, 0, 0, 1, 1, 1, 1, 0]"
14080,1,1,2,0.07793871555075615,"[0, 0, 1, 0, 0, 0, 1, 0, 0, 1]"
14081,1,1,2,0.9979077885327504,"[0, 1, 0, 0, 1, 0, 0, 0, 1, 0]"
14082,1,1,2,0.704185525789204,"[0, 1, 1, 0, 1, 0, 0, 1, 1, 0]"
14083,2,2,4,0.204624326364247,"[0, 1, 0, 1, 0, 0, 0, 0, 1, 1]"
14084,1,1,2,0.5751892634392335,"[1, 0, 0, 1, 0, 1, 1, 1, 0, 1]"
14085,1,1,2,0.7610098030213486,"[0, 1, 0, 0, 1, 1, 0, 1, 1, 0]"
14086,1,1,2,0.5630806129519221,"[1, 0, 0, 1, 0, 1, 1, 1, 1, 0]"
14087,1,1,2,0.653733816920739,"[1, 1, 1, 0, 1, 0, 0, 1, 1, 0]"
14088,2,2,4,0.6739657606120003,"[1, 1, 1, 1, 1, 1, 0, 0, 1, 0]"
14089,1,1,2,0.891617371133531,"[1, 1, 0, 1, 0, 0, 0, 0, 0, 1]"
14090,2,2,4,0.36356550275512556,"[1, 0, 0, 0, 1, 1, 1, 1, 1, 1]"
14091,1,1,2,0.5499542953478535,"[0, 0, 1, 1, 1, 1, 0, 1, 0, 0]"
14092,1,1,2,0.9107711143750672,"[1, 0, 0, 0, 0, 1, 1, 1, 0, 1]"
14093,3,3,6,0.978852495458482,"[1, 1, 1, 1, 1, 0, 0, 1, 1, 1]"
14094,1,1,2,0.7699142469905947,"[1, 0, 0, 1, 0, 1, 1, 1, 0, 0]"
14095,2,2,4,0.3171718491614569,"[0, 0, 1, 1, 1, 1, 0, 1, 1, 1]"
14096,1,1,2,0.051083180294018926,"[1, 1, 1, 1, 1, 0, 0, 0, 0, 0]"
14097,1,1,2,0.09161556617713584,"[0, 1, 0, 1, 0, 1, 0, 1, 1, 0]"
14098,1,1,2,0.3136405870497866,"[0, 1, 1, 0, 1, 0, 1, 1, 1, 0]"
14099,1,1,2,0.7662527012943849,"[0, 0, 0, 0, 1, 1, 0, 1, 0, 0]"
14100,1,1,2,0.22902258474890536,"[0, 0, 0, 0, 1, 1, 1, 0, 1, 0]"
14101,1,1,2,0.13184202744287843,"[0, 1, 0, 0, 0, 0, 0, 1, 1, 0]"
14102,1,1,2,0.636896619633466,"[1, 0, 0, 1, 0, 1, 0, 0, 0, 0]"
14103,1,1,2,0.4035931780018811,"[1, 1, 0, 0, 0, 1, 0, 1, 1, 1]"
14104,1,1,2,0.23820737966255479,"[0, 1, 1, 1, 0, 1, 1, 1, 0, 1]"
14105,1,1,2,0.9115534322871044,"[1, 1, 1, 0, 1, 0, 1, 0, 1, 0]"
14106,1,1,2,0.6089252739355892,"[0, 0, 1, 1, 1, 0, 0, 1, 0, 0]"
14107,1,1,2,0.8317054060770945,"[0, 1, 1, 1, 1, 1, 0, 0, 0, 1]"
14108,1,1,2,0.5756807254260288,"[0, 0, 1, 0, 1, 0, 1, 1, 0, 1]"
14109,1,1,2,0.6853056778256129,"[0, 0, 0, 0, 1, 1, 0, 1, 1, 0]"
14110,1,1,2,0.41327293448911195,"[1, 1, 1, 0, 0, 1, 1, 1, 1, 1]"
14111,1,1,2,0.23071507394908086,"[0, 1, 1, 1, 0, 1, 0, 0, 0, 1]"
14112,1,1,2,0.650576492008713,"[0, 0, 1, 0, 1, 1, 0, 0, 0, 0]"
14113,1,1,2,0.5489095801440782,"[0, 1, 0, 1, 0, 1, 0, 1, 1, 1]"
14114,1,1,2,0.3947785627796163,"[1, 0, 1, 0, 1, 0, 1, 1, 0, 0]"
14115,1,1,2,0.3226154867819069,"[1, 1, 0, 0, 0, 1, 0, 0, 1, 0]"
14116,2,2,4,0.5864402980381236,"[0, 1, 0, 0, 1, 1, 0, 1, 1, 0]"
14117,1,1,2,0.8776295057255931,"[0, 1, 0, 1, 0, 0, 1, 0, 0, 1]"
14118,1,1,2,0.5631439833650055,"[1, 1, 1, 0, 1, 1, 1, 1, 0, 1]"
14119,1,1,2,0.8888160318889818,"[0, 1, 1, 1, 0, 0, 0, 1, 0, 1]"
14120,1,1,2,0.5608065281091815,"[1, 1, 0, 0, 0, 1, 1, 1, 0, 0]"
14121,1,1,2,0.18196882631711897,"[1, 0, 0, 1, 0, 1, 0, 1, 0, 0]"
14122,1,1,2,0.8083634200627402,"[1, 0, 0, 1, 0, 1, 0, 1, 0, 0]"
14123,1,1,2,0.7745279667822109,"[0, 0, 1, 0, 0, 0, 0, 0, 1, 1]"
14124,1,1,2,0.14514201232497703,"[1, 0, 0, 0, 0, 0, 1, 1, 0, 0]"
14125,1,1,2,0.5911071362193303,"[0, 0, 1, 0, 1, 1, 1, 0, 0, 1]"
14126,1,1,2,0.7246034340464145,"[1, 0, 0, 0, 1, 1, 1, 1, 1, 0]"
14127,1,1,2,0.49271875472790105,"[0, 1, 1, 0, 0, 1, 1, 1, 1, 0]"
14128,1,1,2,0.044299759941648365,"[0, 0, 0, 1, 1, 1, 1, 0, 1, 1]"
14129,1,1,2,0.17817468017001925,"[0, 1, 1, 0, 0, 1, 0, 0, 1, 0]"
14130,1,1,2,0.8609283263777039,"[0, 1, 1, 0, 1, 1, 0, 0, 1, 0]"
14131,1,1,2,0.29706357285831386,"[1, 0, 1, 0, 1, 0, 0, 0, 1, 1]"
14132,1,1,2,0.049834263990521155,"[1, 1, 1, 1, 1, 1, 1, 0, 1, 1]"
14133,2,2,4,0.7396366607776848,"[1, 1, 0, 1, 0, 1, 1, 1, 1, 1]"
14134,2,2,4,0.6425363855510963,"[0, 0, 0, 0, 0, 0, 1, 1, 1, 0]"
14135,1,1,2,0.5873016364915874,"[1, 0, 0, 1, 0, 1, 0, 1, 0, 0]"
14136,1,1,2,0.0008029006010068507,"[0, 1, 0, 1, 0, 0, 0, 1, 0, 0]"
14137,1,1,2,0.25164536148225747,"[1, 0, 1, 0, 1, 1, 0, 1, 0, 1]"
14138,1,1,2,0.2162122116962144,"[0, 1, 1, 0, 0, 1, 0, 1, 0, 1]"
14139,1,1,2,0.653862478157443,"[1, 0, 0, 1, 0, 0, 0, 1, 1, 1]"
14140,1,1,2,0.27255347387275586,"[1, 1, 1, 0, 1, 0, 1, 1, 0, 0]"
14141,1,1,2,0.44602616465487055,"[1, 0, 1, 1, 1, 1, 1, 1, 1, 1]"
14142,1,1,2,0.033201898104441296,"[0, 0, 0, 1, 0, 0, 0, 0, 0, 1]"
14143,1,1,2,0.6111154649100556,"[1, 1, 0, 1, 1, 0, 0, 0, 1, 0]"
14144,1,1,2,0.2879512408148176,"[1, 0, 1, 1, 1, 0, 1, 0, 0, 0]"
14145,1,1,2,0.8993129850301065,"[0, 0, 1, 1, 0, 0, 1, 0, 0, 0]"
14146,1,1,2,0.4834829097116653,"[1, 1, 0, 0, 0, 0, 0, 1, 1, 0]"
14147,1,1,2,0.9020892754125933,"[1, 1, 1, 1, 1, 0, 0, 0, 0, 1]"
14148,1,1,2,0.8653456028517055,"[0, 0, 1, 1, 0, 0, 0, 1, 1, 1]"
14149,1,1,2,0.1540283538183832,"[1, 1, 0, 0, 1, 1, 0, 1, 0, 0]"
14150,1,1,2,0.04396843680715379,"[1, 1, 0, 0, 1, 1, 0, 1, 0, 1]"
14151,2,2,4,0.42656790313303206,"[1, 1, 0, 1, 1, 1, 1, 0, 1, 1]"
14152,1,1,2,0.8559174174350807,"[1, 1, 0, 1, 0, 1, 0, 0, 1, 1]"
14153,1,1,2,0.7625894187877507,"[1, 1, 0, 0, 1, 1, 1, 0, 0, 1]"
14154,1,1,2,0.8196209461607098,"[1, 1, 1, 1, 1, 0, 0, 0, 1, 0]"
14155,2,2,4,0.23338662070427874,"[1, 0, 0, 0, 0, 1, 1, 0, 0, 0]"
14156,1,1,2,0.8156309177053088,"[0, 0, 1, 1, 0, 0, 0, 0, 1, 1]"
14157,1,1,2,0.23911105744439776,"[1, 1, 0, 0, 1, 0, 1, 1, 0, 1]"
14158,2,2,4,0.20281185262374335,"[1, 1, 0, 0, 1, 0, 1, 1, 1, 0]"
14159,2,2,4,0.8902069780204298,"[0, 1, 1, 1, 0, 0, 1, 0, 0, 1]"
14160,1,1,2,0.12930337478179144,"[0, 1, 0, 1, 1, 0, 1, 0, 1, 0]"
14161,2,2,4,0.6744751688635643,"[0, 1, 0, 0, 1, 1, 0, 1, 0, 1]"
14162,1,1,2,0.8345517739015403,"[1, 1, 0, 0, 1, 0, 0, 1, 1, 1]"
14163,1,1,2,0.02641407069126145,"[1, 1, 0, 1, 0, 1, 0, 1, 1, 0]"
14164,1,1,2,0.1813826994806419,"[0, 1, 1, 1, 0, 1, 1, 0, 0, 1]"
14165,1,1,2,0.026658429089617686,"[0, 0, 0, 0, 1, 0, 1, 0, 0, 0]"
14166,1,1,2,0.718052129285224,"[1, 1, 1, 1, 0, 0, 0, 0, 1, 1]"
14167,1,1,2,0.13047126467539982,"[0, 1, 1, 1, 0, 1, 0, 1, 0, 0]"
14168,1,1,2,0.41520631564951094,"[0, 0, 1, 0, 0, 0, 1, 1, 0, 1]"
14169,1,1,2,0.34729603671002096,"[0, 0, 0, 0, 1, 1, 1, 1, 0, 1]"
14170,1,1,2,0.3926687517649935,"[1, 0, 0, 1, 0, 1, 1, 1, 0, 0]"
14171,1,1,2,0.035241853042595195,"[1, 0, 1, 0, 1, 0, 1, 0, 0, 1]"
14172,2,2,4,0.4833648416769384,"[0, 0, 0, 1, 1, 1, 0, 1, 0, 0]"
14173,1,1,2,0.596989488852029,"[1, 1, 1, 0, 1, 1, 1, 0, 0, 1]"
14174,1,1,2,0.3682425245436707,"[1, 0, 0, 1, 0, 1, 1, 1, 1, 1]"
14175,1,1,2,0.8246684626029711,"[0, 1, 1, 1, 1, 1, 0, 0, 0, 0]"
14176,1,1,2,0.8071225531285519,"[0, 1, 0, 0, 0, 1, 1, 1, 1, 1]"
14177,1,1,2,0.37419072184119073,"[0, 0, 0, 1, 0, 0, 1, 1, 0, 0]"
14178,1,1,2,0.9634061795658753,"[1, 1, 0, 1, 0, 0, 1, 1, 0, 1]"
14179,1,1,2,0.5450041636090442,"[0, 0, 0, 0, 1, 0, 0, 0, 1, 0]"
14180,2,2,4,0.3008915732026005,"[0, 1, 1, 1, 1, 1, 0, 1, 0, 1]"
14181,1,1,2,0.020846874580668473,"[0, 1, 1, 1, 1, 1, 1, 0, 0, 1]"
14182,1,1,2,0.6011352412914771,"[1, 0, 1, 0, 0, 1, 0, 0, 0, 0]"
14183,1,1,2,0.2478391031849202,"[0, 1, 0, 1, 0, 0, 1, 0, 0, 1]"
14184,1,1,2,0.845246230439761,"[0, 0, 1, 0, 1, 1, 0, 0, 0, 0]"
14185,1,1,2,0.446499466343258,"[0, 0, 0, 0, 0, 0, 1, 0, 1, 0]"
14186,1,1,2,0.8580943522922977,"[1, 1, 0, 0, 1, 1, 1, 0, 1, 1]"
14187,2,2,4,0.7426675531272758,"[0, 0, 1, 0, 1, 0, 0, 1, 1, 0]"
14188,1,1,2,0.4914161179224341,"[1, 0, 0, 0, 1, 0, 0, 1, 1, 0]"
14189,1,1,2,0.5846581346886459,"[1, 0, 1, 1, 1, 0, 0, 1, 0, 1]"
14190,1,1,2,0.7679706081770247,"[0, 1, 1, 1, 0, 0, 1, 1, 0, 0]"
14191,1,1,2,0.059946514883289836,"[0, 0, 1, 0, 1, 1, 1, 1, 0, 0]"
14192,2,2,4,0.8740594049627172,"[1, 0, 0, 0, 1, 1, 1, 0, 0, 0]"
14193,1,1,2,0.78692045150954,"[0, 1, 0, 0, 0, 0, 1, 0, 0, 1]"
14194,3,3,6,0.44355012744953004,"[1, 1, 1, 0, 0, 1, 1, 0, 1, 1]"
14195,1,1,2,0.06119454798875967,"[0, 0, 0, 0, 1, 1, 1, 1, 1, 1]"
14196,1,1,2,0.13760489595496184,"[1, 0, 1, 0, 0, 0, 1, 1, 0, 0]"
14197,1,1,2,0.8955652198657853,"[0, 1, 1, 1, 1, 0, 1, 0, 1, 1]"
14198,1,1,2,0.601843189043234,"[1, 0, 0, 0, 1, 0, 0, 0, 1, 1]"
14199,1,1,2,0.19801686099396643,"[0, 1, 1, 0, 1, 0, 0, 0, 1, 1]"
14200,1,1,2,0.42966138608704085,"[0, 0, 1, 0, 0, 0, 1, 1, 1, 0]"
14201,1,1,2,0.9549223500534328,"[0, 0, 1, 0, 0, 1, 1, 1, 0, 0]"
14202,1,1,2,0.027135781651517532,"[1, 1, 1, 0, 0, 0, 1, 0, 1, 1]"
14203,1,1,2,0.5740213718560351,"[1, 0, 0, 1, 0, 0, 1, 0, 0, 1]"
14204,1,1,2,0.2939205238784709,"[0, 1, 1, 0, 1, 0, 0, 1, 1, 1]"
14205,1,1,2,0.3808645721494477,"[1, 0, 1, 0, 0, 1, 1, 1, 0, 0]"
14206,1,1,2,0.15304768667897195,"[1, 0, 0, 1, 0, 0, 1, 0, 1, 1]"
14207,1,1,2,0.34139541817464303,"[1, 0, 0, 1, 0, 0, 1, 1, 1, 0]"
14208,1,1,2,0.7447210694009003,"[1, 1, 0, 0, 0, 1, 1, 0, 0, 0]"
14209,1,1,2,0.47434551564612115,"[0, 0, 0, 0, 1, 0, 0, 1, 1, 0]"
14210,1,1,2,0.34529940706669293,"[1, 1, 0, 0, 0, 0, 1, 1, 0, 1]"
14211,1,1,2,0.06880189556151939,"[0, 0, 0, 1, 1, 0, 0, 1, 1, 0]"
14212,2,2,4,0.6122784622830243,"[1, 1, 0, 1, 1, 0, 0, 0, 0, 1]"
14213,1,1,2,0.16982875475806525,"[0, 0, 0, 1, 1, 1, 0, 0, 0, 0]"
14214,1,1,2,0.8325801622098591,"[0, 1, 0, 0, 1, 0, 1, 0, 1, 0]"
14215,1,1,2,0.23065084571855676,"[0, 1, 1, 0, 1, 0, 1, 0, 0, 0]"
14216,1,1,2,0.8582996703211776,"[0, 1, 0, 0, 0, 0, 1, 1, 1, 1]"
14217,2,2,4,0.4566389098661564,"[1, 0, 1, 0, 0, 1, 1, 1, 0, 0]"
14218,1,1,2,0.19014307850789036,"[0, 0, 0, 1, 0, 0, 1, 0, 1, 0]"
14219,1,1,2,0.7737032460770935,"[1, 1, 0, 0, 0, 1, 0, 1, 0, 1]"
14220,1,1,2,0.7378699580649634,"[1, 1, 0, 0, 1, 1, 0, 0, 1, 0]"
14221,1,1,2,0.798948236337741,"[0, 0, 1, 0, 1, 1, 0, 0, 1, 0]"
14222,2,2,4,0.2540150264830794,"[1, 0, 0, 0, 0, 1, 1, 1, 1, 1]"
14223,1,1,2,0.2673837684130176,"[0, 1, 1, 0, 1, 1, 1, 1, 0, 0]"
14224,1,1,2,0.032663914594232124,"[0, 1, 1, 1, 1, 1, 1, 1, 0, 1]"
14225,1,1,2,0.31821342316389467,"[1, 1, 1, 1, 0, 1, 1, 1, 0, 0]"
14226,1,1,2,0.1032447041634742,"[1, 1, 0, 0, 0, 0, 0, 1, 1, 0]"
14227,1,1,2,0.10538911400952067,"[0, 0, 1, 1, 0, 1, 0, 1, 1, 0]"
14228,1,1,2,0.7836977371433635,"[1, 0, 0, 1, 0, 0, 1, 1, 0, 1]"
14229,1,1,2,0.5551336693808251,"[0, 0, 1, 1, 0, 1, 1, 1, 0, 0]"
14230,1,1,2,0.6346595075621617,"[1, 0, 1, 1, 1, 1, 0, 0, 1, 1]"
14231,1,1,2,0.13624147398661046,"[1, 0, 1, 1, 0, 0, 0, 1, 0, 0]"
14232,3,3,6,0.3006893865118505,"[0, 1, 0, 0, 0, 0, 1, 1, 1, 1]"
14233,1,1,2,0.5534816347245526,"[1, 1, 0, 1, 0, 1, 0, 0, 1, 0]"
14234,1,1,2,0.5961764316533312,"[0, 0, 0, 0, 0, 1, 1, 0, 0, 1]"
14235,1,1,2,0.41916982345655174,"[0, 0, 1, 0, 1, 0, 1, 1, 1, 0]"
14236,1,1,2,0.6172984322553938,"[1, 0, 0, 0, 1, 1, 0, 1, 1, 0]"
14237,1,1,2,0.8102832743107306,"[0, 1, 1, 0, 0, 1, 1, 0, 1, 0]"
14238,2,2,4,0.010135845975905777,"[1, 0, 1, 1, 1, 0, 1, 1, 1, 0]"
14239,1,1,2,0.19528423726233546,"[1, 1, 1, 1, 0, 1, 1, 0, 0, 1]"
14240,1,1,2,0.37704145306982007,"[1, 0, 1, 0, 0, 0, 1, 0, 0, 0]"
14241,1,1,2,0.019175624835825245,"[1, 1, 0, 1, 0, 1, 1, 0, 0, 1]"
14242,1,1,2,0.6107958836202322,"[1, 1, 1, 1, 0, 1, 0, 1, 1, 1]"
14243,1,1,2,0.17754468422363823,"[0, 0, 1, 0, 0, 1, 0, 0, 1, 0]"
14244,1,1,2,0.9449540600456304,"[0, 0, 1, 1, 0, 1, 0, 1, 0, 1]"
14245,1,1,2,0.5973524127370982,"[1, 0, 1, 1, 0, 1, 0, 0, 1, 0]"
14246,1,1,2,0.5812446032056212,"[0, 1, 0, 0, 1, 1, 1, 0, 1, 0]"
14247,1,1,2,0.2196046481692573,"[1, 0, 1, 0, 1, 1, 0, 1, 1, 1]"
14248,1,1,2,0.4807288313937953,"[1, 1, 1, 1, 1, 0, 1, 1, 0, 1]"
14249,1,1,2,0.7350548150217521,"[1, 1, 1, 0, 0, 0, 0, 1, 1, 0]"
14250,1,1,2,0.03073638755209762,"[1, 0, 1, 1, 1, 0, 0, 1, 0, 1]"
14251,1,1,2,0.3100320920137716,"[0, 0, 1, 1, 0, 0, 1, 1, 0, 0]"
14252,1,1,2,0.5504335360933498,"[1, 0, 0, 1, 0, 0, 1, 0, 1, 1]"
14253,2,2,4,0.14604835028320906,"[0, 1, 1, 1, 0, 0, 0, 1, 0, 0]"
14254,2,2,4,0.39885505827093426,"[0, 1, 0, 1, 1, 0, 0, 1, 0, 0]"
14255,1,1,2,0.9902767489994948,"[0, 0, 1, 1, 1, 0, 1, 0, 1, 1]"
14256,1,1,2,0.7178228320937049,"[0, 1, 0, 0, 1, 0, 0, 1, 0, 1]"
14257,1,1,2,0.8702633229747246,"[0, 1, 1, 0, 0, 1, 1, 0, 0, 0]"
14258,1,1,2,0.903166917773679,"[1, 0, 0, 0, 1, 1, 1, 0, 0, 0]"
14259,2,2,4,0.16975930533302463,"[0, 1, 0, 0, 1, 1, 1, 1, 1, 1]"
14260,2,2,4,0.2715669570259156,"[0, 0, 0, 0, 1, 1, 0, 1, 0, 0]"
14261,2,2,4,0.6014753896707121,"[0, 1, 0, 1, 0, 1, 1, 0, 0, 0]"
14262,1,1,2,0.39803197300504667,"[0, 1, 0, 0, 0, 0, 0, 1, 0, 1]"
14263,1,1,2,0.8198387903792402,"[1, 0, 1, 1, 0, 0, 1, 0, 0, 1]"
14264,1,1,2,0.5079488697131439,"[1, 0, 0, 1, 1, 1, 1, 1, 1, 0]"
14265,2,2,4,0.5976871640169842,"[1, 1, 1, 1, 1, 0, 0, 0, 1, 1]"
14266,1,1,2,0.4367852324765432,"[0, 0, 0, 1, 1, 0, 0, 0, 0, 0]"
14267,2,2,4,0.00044597495852405356,"[0, 0, 0, 1, 0, 1, 0, 1, 1, 0]"
14268,1,1,2,0.4729165633383099,"[1, 1, 1, 1, 0, 0, 1, 1, 0, 0]"
14269,1,1,2,0.5629137121057022,"[1, 1, 0, 1, 0, 1, 0, 1, 0, 0]"
14270,1,1,2,0.7902988866232026,"[1, 0, 0, 0, 0, 1, 0, 0, 0, 1]"
14271,1,1,2,0.5951618632460228,"[1, 1, 1, 1, 0, 1, 0, 1, 1, 1]"
14272,1,1,2,0.7390936972490079,"[0, 0, 1, 0, 0, 0, 1, 0, 1, 0]"
14273,1,1,2,0.022589014969949806,"[1, 0, 0, 0, 1, 0, 1, 0, 0, 0]"
14274,1,1,2,0.7761404121807366,"[1, 1, 1, 1, 0, 1, 0, 1, 1, 1]"
14275,1,1,2,0.9263344683875863,"[1, 0, 1, 1, 1, 0, 1, 0, 0, 1]"
14276,1,1,2,0.6386854607553368,"[1, 0, 1, 1, 0, 1, 0, 1, 1, 0]"
14277,1,1,2,0.7354168039223103,"[1, 1, 0, 1, 1, 1, 1, 1, 1, 0]"
14278,1,1,2,0.317882037518062,"[0, 0, 1, 0, 0, 0, 1, 0, 1, 0]"
14279,1,1,2,0.3009548006352921,"[1, 1, 1, 1, 1, 1, 0, 1, 0, 1]"
14280,2,2,4,0.7511438824465841,"[0, 1, 1, 0, 0, 0, 1, 0, 1, 0]"
14281,1,1,2,0.736005259143549,"[1, 1, 0, 0, 1, 1, 0, 0, 0, 0]"
14282,1,1,2,0.538902271416554,"[1, 1, 1, 0, 1, 1, 1, 1, 0, 1]"
14283,2,2,4,0.4600527124724554,"[1, 1, 1, 1, 0, 0, 0, 0, 1, 1]"
14284,1,1,2,0.42903316639865696,"[1, 0, 1, 1, 0, 0, 1, 1, 0, 1]"
14285,1,1,2,0.2890558717774441,"[1, 1, 0, 1, 1, 1, 0, 0, 1, 1]"
14286,1,1,2,0.9087013793063952,"[1, 1, 1, 0, 1, 0, 1, 1, 1, 1]"
14287,1,1,2,0.38181734417684976,"[1, 1, 0, 1, 1, 0, 1, 0, 0, 0]"
14288,1,1,2,0.11595361928478332,"[1, 0, 0, 0, 1, 0, 1, 1, 0, 1]"
14289,1,1,2,0.1226247812573723,"[1, 0, 0, 0, 0, 1, 0, 0, 1, 1]"
14290,1,1,2,0.7455220857357235,"[0, 1, 1, 0, 0, 0, 0, 1, 0, 1]"
14291,2,2,4,0.655237528794106,"[1, 1, 0, 1, 0, 1, 0, 1, 1, 1]"
14292,1,1,2,0.4853117044457854,"[0, 1, 0, 1, 0, 1, 1, 0, 1, 0]"
14293,1,1,2,0.1662259599432493,"[1, 1, 0, 1, 0, 1, 1, 0, 0, 1]"
14294,1,1,2,0.016524539218712664,"[1, 1, 1, 1, 1, 1, 0, 0, 0, 0]"
14295,1,1,2,0.9774376320624695,"[0, 0, 1, 0, 1, 0, 1, 1, 1, 1]"
14296,1,1,2,0.016465249094527623,"[1, 0, 0, 0, 1, 0, 0, 0, 1, 0]"
14297,1,1,2,0.7257654298348346,"[1, 0, 0, 0, 1, 1, 0, 1, 1, 0]"
14298,1,1,2,0.19239734569924005,"[1, 1, 1, 1, 1, 1, 0, 1, 1, 1]"
14299,2,2,4,0.9614649891162215,"[0, 0, 1, 0, 0, 1, 0, 0, 0, 1]"
14300,2,2,4,0.3521265366312748,"[0, 1, 0, 1, 0, 0, 1, 1, 1, 0]"
14301,1,1,2,0.08193687964996399,"[1, 1, 1, 0, 0, 0, 0, 0, 0, 1]"
14302,1,1,2,0.4464161860575683,"[0, 1, 1, 0, 0, 1, 0, 0, 0, 0]"
14303,1,1,2,0.9050438223062168,"[0, 1, 1, 0, 0, 1, 1, 1, 0, 1]"
14304,1,1,2,0.28782041253563195,"[1, 1, 1, 1, 0, 0, 1, 0, 0, 1]"
14305,1,1,2,0.33721956649014173,"[0, 0, 0, 1, 0, 0, 1, 0, 1, 0]"
14306,1,1,2,0.13564516557371298,"[1, 1, 1, 1, 1, 0, 0, 1, 1, 0]"
14307,1,1,2,0.5090972125906223,"[1, 0, 0, 0, 0, 1, 1, 0, 1, 0]"
14308,1,1,2,0.07681914854805849,"[1, 0, 1, 0, 1, 1, 0, 1, 1, 0]"
14309,1,1,2,0.24245472864590556,"[1, 0, 1, 1, 1, 0, 1, 0, 1, 0]"
14310,1,1,2,0.5970193724188066,"[1, 1, 1, 1, 0, 1, 1, 1, 0, 1]"
14311,2,2,4,0.818738640216741,"[0, 0, 1, 0, 0, 0, 0, 0, 1, 0]"
14312,1,1,2,0.036685951639310876,"[0, 1, 0, 0, 0, 0, 1, 1, 0, 0]"
14313,1,1,2,0.4769050962148953,"[0, 0, 1, 0, 0, 0, 0, 1, 1, 0]"
14314,1,1,2,0.3099612661666977,"[1, 0, 1, 1, 0, 1, 1, 1, 1, 0]"
14315,1,1,2,0.41379383407049286,"[0, 0, 1, 1, 1, 1, 1, 0, 1, 1]"
14316,1,1,2,0.22076427728687542,"[0, 1, 1, 1, 0, 0, 0, 0, 1, 1]"
14317,1,1,2,0.370955339893588,"[0, 1, 0, 1, 1, 1, 0, 0, 1, 1]"
14318,1,1,2,0.014978684005931053,"[1, 1, 1, 0, 1, 1, 0, 0, 1, 0]"
14319,1,1,2,0.8982032747894683,"[0, 1, 1, 0, 0, 0, 0, 1, 0, 0]"
14320,2,2,4,0.7304513369737969,"[0, 1, 0, 0, 1, 1, 1, 0, 1, 1]"
14321,1,1,2,0.46851775216290015,"[1, 0, 1, 0, 1, 0, 0, 1, 0, 1]"
14322,1,1,2,0.9133335554553289,"[1, 0, 0, 1, 1, 1, 0, 1, 0, 1]"
14323,1,1,2,0.024144665127151077,"[0, 0, 0, 1, 1, 1, 0, 0, 0, 1]"
14324,1,1,2,0.7134072759601985,"[0, 1, 0, 1, 1, 0, 0, 0, 1, 1]"
14325,1,1,2,0.03348007156545163,"[1, 1, 0, 1, 0, 1, 1, 1, 0, 0]"
14326,1,1,2,0.42889599587084914,"[0, 1, 1, 0, 0, 1, 0, 0, 1, 0]"
14327,1,1,2,0.6497262781447378,"[0, 0, 0, 1, 0, 1, 0, 0, 1, 0]"
14328,1,1,2,0.4957256205972954,"[0, 0, 1, 0, 0, 0, 0, 1, 1, 1]"
14329,1,1,2,0.424909096702769,"[0, 1, 0, 0, 1, 0, 0, 0, 1, 1]"
14330,2,2,4,0.1500264032751052,"[0, 1, 0, 1, 1, 1, 1, 1, 1, 0]"
14331,1,1,2,0.2422187112615758,"[1, 0, 1, 0, 0, 0, 1, 0, 1, 1]"
14332,1,1,2,0.3690635684024661,"[1, 1, 0, 1, 0, 0, 1, 1, 1, 0]"
14333,1,1,2,0.8620659834050763,"[1, 0, 0, 1, 0, 0, 0, 1, 0, 0]"
14334,1,1,2,0.12438460688283692,"[0, 1, 0, 0, 1, 1, 1, 0, 1, 1]"
14335,2,2,4,0.7846774359260822,"[1, 0, 1, 1, 0, 0, 1, 0, 1, 1]"
14336,1,1,2,0.9884997932911858,"[1, 1, 0, 0, 1, 0, 0, 0, 1, 1]"
14337,1,1,2,0.035688150228069926,"[1, 0, 0, 0, 1, 0, 1, 1, 1, 0]"
14338,1,1,2,0.3804829326191378,"[1, 0, 0, 1, 0, 1, 0, 0, 0, 1]"
14339,1,1,2,0.8877498189965064,"[0, 1, 0, 1, 1, 0, 0, 1, 0, 1]"
14340,2,2,4,0.22657823272271105,"[0, 0, 0, 0, 1, 0, 0, 1, 1, 0]"
14341,1,1,2,0.5615001265019058,"[1, 0, 1, 0, 1, 0, 0, 0, 1, 1]"
14342,1,1,2,0.4556965384266408,"[1, 0, 1, 0, 0, 0, 0, 1, 1, 1]"
14343,2,2,4,0.32664591174718116,"[0, 0, 0, 0, 1, 1, 1, 1, 0, 1]"
14344,1,1,2,0.007300208041386869,"[1, 1, 0, 0, 0, 1, 1, 0, 1, 1]"
14345,1,1,2,0.4755532160696697,"[1, 0, 0, 1, 1, 0, 1, 1, 0, 1]"
14346,1,1,2,0.38824348015885235,"[0, 1, 0, 0, 1, 0, 0, 1, 0, 1]"
14347,1,1,2,0.3978700652331497,"[1, 1, 0, 1, 1, 0, 1, 0, 0, 1]"
14348,1,1,2,0.04737737820747101,"[0, 0, 0, 1, 1, 1, 0, 1, 0, 1]"
14349,1,1,2,0.9551901992905029,"[0, 1, 1, 1, 1, 0, 0, 0, 1, 0]"
14350,1,1,2,0.8589673662847164,"[0, 1, 0, 0, 0, 0, 1, 0, 1, 1]"
14351,1,1,2,0.5961552079430892,"[0, 1, 0, 0, 1, 1, 0, 0, 1, 0]"
14352,1,1,2,0.06609145742840494,"[0, 0, 0, 0, 1, 0, 0, 0, 0, 0]"
14353,1,1,2,0.2886468683480613,"[1, 0, 1, 0, 0, 1, 0, 1, 0, 0]"
14354,1,1,2,0.07292741845408823,"[0, 1, 0, 0, 0, 0, 0, 0, 1, 0]"
14355,2,2,4,0.4373128994232457,"[1, 0, 1, 1, 0, 1, 0, 1, 1, 0]"
14356,2,2,4,0.11070435660121258,"[0, 1, 1, 1, 1, 1, 1, 1, 0, 1]"
14357,2,2,4,0.7943503115092567,"[0, 0, 0, 1, 0, 1, 1, 1, 1, 1]"
14358,1,1,2,0.48450007732431644,"[1, 1, 0, 1, 1, 0, 1, 1, 0, 0]"
14359,1,1,2,0.4383053611777873,"[0, 1, 1, 0, 1, 0, 0, 1, 1, 0]"
14360,1,1,2,0.5941827981360401,"[0, 1, 0, 0, 1, 0, 0, 1, 0, 1]"
14361,1,1,2,0.4214262336026481,"[0, 1, 1, 0, 0, 1, 1, 1, 1, 0]"
14362,1,1,2,0.8157404176270782,"[1, 1, 0, 1, 0, 0, 0, 1, 1, 0]"
14363,1,1,2,0.20598614301161056,"[0, 1, 1, 0, 0, 0, 0, 0, 0, 1]"
14364,1,1,2,0.1540563911386692,"[0, 0, 1, 1, 0, 1, 0, 0, 1, 1]"
14365,1,1,2,0.560922248658446,"[1, 1, 0, 1, 0, 0, 0, 0, 1, 1]"
14366,2,2,4,0.6343465082879255,"[0, 0, 1, 0, 1, 0, 1, 0, 0, 0]"
14367,1,1,2,0.9844134955169849,"[0, 1, 0, 1, 1, 0, 0, 1, 1, 1]"
14368,1,1,2,0.8822049551973548,"[0, 1, 0, 0, 1, 1, 0, 1, 0, 0]"
14369,1,1,2,0.5449300508861261,"[0, 1, 0, 1, 1, 0, 1, 1, 0, 1]"
14370,1,1,2,0.7623036760894593,"[1, 1, 1, 0, 1, 1, 0, 0, 1, 1]"
14371,1,1,2,0.5448075538028685,"[0, 1, 0, 1, 0, 0, 1, 0, 0, 1]"
14372,1,1,2,0.685206506682476,"[1, 0, 0, 1, 0, 0, 1, 1, 1, 0]"
14373,1,1,2,0.6633071427886698,"[1, 1, 0, 0, 0, 1, 1, 0, 1, 1]"
14374,1,1,2,0.22814968415702663,"[0, 0, 1, 1, 0, 1, 0, 1, 0, 1]"
14375,1,1,2,0.4968305110575475,"[1, 1, 1, 0, 0, 1, 1, 1, 0, 1]"
14376,1,1,2,0.17589910498648387,"[1, 0, 1, 0, 1, 0, 0, 1, 0, 1]"
14377,1,1,2,0.12750797495576227,"[1, 1, 1, 1, 0, 1, 1, 1, 0, 1]"
14378,1,1,2,0.222450115751065,"[0, 1, 1, 1, 0, 0, 1, 1, 1, 1]"
14379,1,1,2,0.9240598023867378,"[1, 1, 1, 0, 0, 1, 0, 1, 0, 0]"
14380,1,1,2,0.3656532309541718,"[1, 0, 0, 1, 0, 1, 0, 0, 1, 1]"
14381,1,1,2,0.2823178749629185,"[0, 0, 1, 0, 0, 0, 0, 0, 0, 1]"
14382,1,1,2,0.7604510001107723,"[0, 0, 0, 1, 1, 0, 1, 1, 1, 0]"
14383,1,1,2,0.4164105549812054,"[1, 0, 0, 0, 0, 1, 0, 0, 0, 1]"
14384,1,1,2,0.910660802243354,"[0, 1, 0, 0, 1, 0, 0, 0, 1, 1]"
14385,1,1,2,0.9172538067828918,"[0, 1, 1, 0, 1, 0, 1, 1, 0, 0]"
14386,1,1,2,0.47107390531466775,"[0, 0, 1, 0, 1, 1, 1, 0, 1, 0]"
14387,1,1,2,0.39181474363557156,"[0, 1, 1, 0, 1, 1, 0, 0, 0, 1]"
14388,1,1,2,0.6475716694144946,"[1, 0, 0, 0, 1, 1, 0, 1, 1, 0]"
14389,2,2,4,0.5924746513546327,"[1, 1, 1, 0, 1, 1, 0, 0, 1, 1]"
14390,1,1,2,0.4826572067410736,"[0, 0, 1, 1, 1, 1, 1, 1, 0, 0]"
14391,1,1,2,0.8537820868487974,"[0, 1, 0, 0, 0, 0, 0, 0, 1, 1]"
14392,1,1,2,0.3793704540131627,"[0, 1, 1, 0, 1, 0, 1, 0, 0, 1]"
14393,2,2,4,0.7880241852271801,"[0, 0, 0, 0, 1, 1, 0, 1, 1, 0]"
14394,4,4,8,0.17318799738937862,"[0, 0, 0, 1, 1, 1, 1, 1, 1, 0]"
14395,1,1,2,0.6336575452298968,"[0, 1, 0, 0, 0, 0, 1, 1, 1, 1]"
14396,1,1,2,0.7638573358109083,"[0, 1, 0, 1, 1, 0, 0, 1, 1, 0]"
14397,2,2,4,0.9347218083053789,"[0, 0, 0, 1, 1, 1, 0, 1, 1, 0]"
14398,2,2,4,0.4477729356234833,"[0, 1, 0, 1, 1, 1, 1, 0, 1, 0]"
14399,1,1,2,0.4164752847418909,"[0, 0, 1, 1, 0, 1, 0, 0, 0, 1]"
14400,1,1,2,0.8509392173618808,"[1, 0, 1, 0, 0, 1, 0, 1, 0, 1]"
14401,1,1,2,0.26463237966718156,"[1, 0, 0, 1, 0, 1, 1, 0, 1, 1]"
14402,1,1,2,0.8972781880551896,"[0, 1, 0, 1, 1, 1, 0, 0, 1, 0]"
14403,1,1,2,0.5887214072386373,"[1, 1, 0, 0, 1, 1, 1, 0, 1, 0]"
14404,1,1,2,0.5671901177080422,"[0, 0, 1, 0, 0, 0, 1, 0, 0, 0]"
14405,1,1,2,0.31704874077387957,"[1, 1, 0, 0, 1, 0, 0, 1, 0, 0]"
14406,1,1,2,0.9081535125412755,"[0, 0, 0, 1, 0, 0, 0, 1, 1, 1]"
14407,1,1,2,0.242860717937195,"[1, 0, 0, 1, 0, 1, 0, 0, 1, 1]"
14408,1,1,2,0.43776091152566343,"[1, 0, 1, 1, 0, 1, 1, 1, 1, 0]"
14409,1,1,2,0.9753959085650052,"[0, 1, 1, 0, 1, 1, 1, 1, 0, 0]"
14410,1,1,2,0.7312166925832053,"[1, 1, 1, 1, 0, 0, 0, 1, 1, 0]"
14411,1,1,2,0.3405883604904443,"[0, 0, 1, 0, 1, 0, 1, 1, 1, 0]"
14412,1,1,2,0.26220591856641173,"[1, 0, 1, 0, 0, 0, 0, 0, 1, 1]"
14413,1,1,2,0.3532023385680666,"[1, 1, 1, 1, 1, 0, 0, 0, 1, 0]"
14414,1,1,2,0.9001368002601251,"[0, 1, 0, 1, 1, 0, 0, 0, 0, 1]"
14415,1,1,2,0.681064447674257,"[0, 0, 0, 0, 0, 1, 1, 1, 0, 1]"
14416,1,1,2,0.1288866742690663,"[1, 1, 0, 0, 1, 1, 1, 0, 1, 1]"
14417,2,2,4,0.130839272352271,"[1, 1, 0, 1, 0, 1, 0, 0, 1, 0]"
14418,2,2,4,0.2535279175277918,"[0, 0, 0, 0, 0, 0, 1, 0, 0, 0]"
14419,1,1,2,0.7184180320458929,"[0, 0, 1, 1, 1, 1, 1, 0, 0, 0]"
14420,2,2,4,0.31496145010843823,"[1, 1, 0, 1, 1, 0, 1, 1, 1, 1]"
14421,1,1,2,0.4122646316039523,"[0, 1, 0, 1, 1, 1, 0, 0, 0, 1]"
14422,2,2,4,0.8835217538367369,"[1, 1, 1, 0, 0, 1, 1, 1, 1, 0]"
14423,1,1,2,0.6963875459440325,"[0, 1, 0, 0, 1, 0, 1, 1, 0, 1]"
14424,1,1,2,0.8076959518669464,"[0, 1, 1, 1, 0, 1, 0, 0, 0, 1]"
14425,1,1,2,0.3696053569943283,"[1, 0, 0, 1, 0, 1, 0, 0, 1, 0]"
14426,1,1,2,0.6976669894099021,"[0, 0, 0, 1, 1, 1, 0, 1, 0, 0]"
14427,1,1,2,0.5375027988089385,"[1, 1, 0, 0, 0, 0, 1, 0, 1, 1]"
14428,1,1,2,0.24825915890173555,"[1, 1, 1, 0, 1, 1, 1, 1, 0, 1]"
14429,1,1,2,0.8617862210461201,"[1, 1, 0, 1, 0, 0, 1, 1, 1, 0]"
14430,1,1,2,0.7550132880818061,"[0, 1, 0, 1, 0, 1, 1, 1, 0, 0]"
14431,1,1,2,0.4835188166064257,"[1, 1, 0, 0, 0, 1, 1, 0, 1, 0]"
14432,1,1,2,0.3144289648712908,"[1, 0, 0, 1, 1, 0, 1, 0, 1, 1]"
14433,2,2,4,0.8617806634461226,"[0, 1, 1, 1, 0, 0, 1, 1, 1, 1]"
14434,1,1,2,0.40693134582390555,"[1, 1, 1, 1, 1, 1, 0, 1, 0, 0]"
14435,1,1,2,0.9636187667524697,"[0, 0, 0, 0, 1, 1, 0, 1, 0, 1]"
14436,1,1,2,0.9244550951701366,"[1, 0, 0, 1, 0, 0, 1, 0, 1, 1]"
14437,1,1,2,0.5981390376626374,"[0, 0, 0, 1, 1, 0, 0, 1, 1, 1]"
14438,1,1,2,0.09822433415247467,"[0, 0, 1, 0, 0, 1, 1, 0, 0, 1]"
14439,2,2,4,0.4153588903528649,"[1, 0, 1, 0, 1, 0, 1, 1, 1, 0]"
14440,1,1,2,0.6883028970686336,"[0, 1, 0, 1, 1, 0, 1, 0, 0, 0]"
14441,2,2,4,0.06945339584175936,"[0, 0, 0, 1, 1, 1, 0, 1, 1, 0]"
14442,1,1,2,0.13001312014560407,"[1, 0, 1, 1, 0, 1, 1, 0, 1, 0]"
14443,1,1,2,0.7622771810280656,"[1, 0, 1, 1, 1, 0, 1, 1, 1, 1]"
14444,1,1,2,0.6370136825766198,"[1, 0, 0, 0, 0, 0, 1, 1, 0, 1]"
14445,1,1,2,0.11876014814591929,"[1, 1, 1, 1, 1, 0, 1, 1, 1, 1]"
14446,1,1,2,0.8674202217054966,"[1, 0, 0, 1, 0, 1, 1, 0, 1, 0]"
14447,2,2,4,0.023183200129519577,"[0, 1, 0, 0, 1, 0, 1, 0, 1, 1]"
14448,1,1,2,0.028362279407355362,"[0, 0, 1, 1, 0, 1, 1, 1, 1, 1]"
14449,1,1,2,0.13290181529626421,"[0, 0, 0, 0, 0, 0, 1, 0, 1, 1]"
14450,2,2,4,0.5709387065526733,"[1, 0, 1, 1, 1, 0, 0, 1, 1, 1]"
14451,1,1,2,0.2527935722461745,"[1, 0, 1, 0, 1, 0, 1, 0, 0, 1]"
14452,1,1,2,0.2591410338082998,"[1, 0, 1, 1, 1, 1, 0, 1, 1, 1]"
14453,1,1,2,0.8336149257455896,"[0, 1, 0, 1, 0, 1, 0, 0, 0, 1]"
14454,1,1,2,0.6259300988085188,"[1, 0, 0, 0, 0, 0, 0, 0, 1, 0]"
14455,1,1,2,0.04588448801431533,"[1, 1, 1, 1, 1, 0, 0, 1, 1, 1]"
14456,1,1,2,0.8336943358584127,"[0, 0, 1, 0, 1, 0, 1, 0, 0, 1]"
14457,1,1,2,0.034086204278149346,"[0, 1, 0, 0, 1, 0, 0, 1, 1, 1]"
14458,1,1,2,0.7292082226393144,"[1, 0, 1, 1, 0, 0, 0, 1, 0, 0]"
14459,1,1,2,0.3365254440243771,"[1, 1, 0, 0, 1, 1, 1, 1, 0, 1]"
14460,1,1,2,0.31529018664832775,"[0, 0, 0, 1, 1, 0, 0, 1, 1, 1]"
14461,2,2,4,0.34981742153864626,"[1, 0, 0, 0, 0, 1, 0, 1, 1, 0]"
14462,1,1,2,0.08592368564503217,"[0, 1, 1, 0, 0, 0, 0, 0, 1, 1]"
14463,1,1,2,0.19488020346147805,"[1, 0, 0, 1, 0, 1, 1, 1, 0, 1]"
14464,1,1,2,0.7871783518838047,"[1, 1, 0, 0, 0, 1, 1, 0, 0, 1]"
14465,1,1,2,0.48694265015181026,"[0, 0, 0, 0, 1, 1, 1, 1, 1, 0]"
14466,1,1,2,0.5282980602171711,"[0, 0, 1, 0, 0, 1, 0, 1, 1, 0]"
14467,1,1,2,0.17081286009644592,"[1, 0, 1, 0, 0, 1, 1, 0, 0, 1]"
14468,1,1,2,0.934873915555958,"[0, 0, 0, 1, 0, 1, 0, 0, 1, 0]"
14469,1,1,2,0.9595674107042347,"[1, 1, 1, 0, 1, 1, 1, 0, 0, 1]"
14470,1,1,2,0.49750054286570666,"[1, 0, 0, 0, 0, 1, 0, 1, 0, 1]"
14471,1,1,2,0.3947599702625185,"[0, 0, 0, 0, 1, 0, 1, 0, 0, 0]"
14472,1,1,2,0.9954757058508394,"[0, 0, 0, 0, 0, 0, 0, 1, 1, 0]"
14473,1,1,2,0.3315667561931662,"[0, 1, 1, 1, 0, 1, 1, 0, 1, 0]"
14474,1,1,2,0.5858426410111569,"[0, 0, 1, 0, 0, 0, 0, 0, 1, 1]"
14475,1,1,2,0.8891079767101288,"[0, 0, 1, 1, 0, 1, 1, 0, 0, 0]"
14476,1,1,2,0.7362051588965244,"[0, 0, 0, 0, 0, 0, 0, 1, 0, 1]"
14477,1,1,2,0.2787175440987165,"[0, 1, 1, 0, 1, 1, 0, 0, 1, 0]"
14478,1,1,2,0.9976990593365231,"[0, 0, 1, 1, 1, 1, 0, 0, 1, 0]"
14479,1,1,2,0.8712046421662304,"[1, 1, 1, 1, 0, 0, 0, 0, 0, 1]"
14480,1,1,2,0.24336175152268014,"[1, 0, 0, 0, 1, 1, 0, 0, 0, 0]"
14481,1,1,2,0.6603152377388942,"[1, 0, 1, 0, 0, 1, 1, 1, 0, 0]"
14482,1,1,2,0.265795759046098,"[0, 1, 1, 0, 1, 0, 0, 0, 1, 0]"
14483,1,1,2,0.2536534543320632,"[1, 1, 0, 0, 1, 1, 1, 0, 1, 0]"
14484,2,2,4,0.9190838088880309,"[1, 0, 0, 1, 1, 1, 1, 1, 1, 0]"
14485,1,1,2,0.16467127473439103,"[0, 0, 1, 1, 0, 0, 0, 0, 0, 1]"
14486,1,1,2,0.5794313064006971,"[1, 1, 0, 1, 1, 0, 0, 1, 1, 0]"
14487,1,1,2,0.7542452001618545,"[1, 1, 1, 1, 1, 1, 0, 1, 1, 1]"
14488,1,1,2,0.40285936353660456,"[0, 0, 1, 0, 0, 1, 0, 1, 1, 0]"
14489,1,1,2,0.8197749219544509,"[1, 1, 1, 0, 1, 1, 1, 1, 1, 1]"
14490,2,2,4,0.8076053226064108,"[1, 0, 1, 0, 1, 1, 1, 0, 0, 0]"
14491,1,1,2,0.6885827490029033,"[1, 0, 1, 1, 1, 1, 1, 0, 1, 0]"
14492,1,1,2,0.4836689187489981,"[0, 0, 1, 1, 1, 0, 0, 1, 0, 0]"
14493,2,2,4,0.20970910821883992,"[1, 1, 0, 0, 1, 1, 1, 1, 1, 1]"
14494,1,1,2,0.8718079476734704,"[1, 1, 0, 0, 0, 1, 0, 0, 0, 1]"
14495,1,1,2,0.2639775247447975,"[1, 0, 1, 1, 1, 1, 1, 1, 0, 0]"
14496,1,1,2,0.6309910317651606,"[1, 0, 1, 0, 0, 1, 0, 1, 0, 0]"
14497,1,1,2,0.7003837975009181,"[0, 1, 0, 0, 0, 0, 1, 0, 1, 1]"
14498,1,1,2,0.031220261539113614,"[1, 1, 1, 0, 0, 1, 0, 0, 1, 1]"
14499,2,2,4,0.35041087478611677,"[0, 1, 0, 0, 1, 1, 0, 0, 1, 1]"
14500,1,1,2,0.7583102589906181,"[0, 0, 0, 1, 0, 1, 0, 1, 1, 0]"
14501,3,3,6,0.3919938273559044,"[0, 1, 0, 0, 1, 1, 1, 0, 0, 0]"
14502,1,1,2,0.4489746233347126,"[0, 1, 1, 0, 0, 0, 0, 1, 1, 0]"
14503,1,1,2,0.31307451437768186,"[0, 0, 1, 1, 0, 0, 1, 1, 0, 1]"
14504,1,1,2,0.21143806540658117,"[0, 1, 0, 0, 0, 0, 0, 0, 0, 0]"
14505,1,1,2,0.4961776919015157,"[1, 0, 1, 1, 1, 0, 0, 1, 0, 1]"
14506,1,1,2,0.49932487707478757,"[0, 1, 1, 0, 0, 1, 0, 1, 0, 1]"
14507,2,2,4,0.014361021099815852,"[0, 1, 1, 1, 0, 0, 1, 1, 1, 1]"
14508,1,1,2,0.42860439340167533,"[1, 0, 1, 0, 0, 0, 1, 0, 0, 0]"
14509,1,1,2,0.09672676209905251,"[0, 0, 0, 0, 0, 1, 1, 1, 0, 1]"
14510,3,3,6,0.34778377560955165,"[1, 1, 1, 1, 0, 1, 0, 1, 1, 0]"
14511,2,2,4,0.034006667365158116,"[0, 0, 1, 1, 1, 0, 0, 1, 1, 0]"
14512,1,1,2,0.5332025517786562,"[1, 1, 1, 1, 1, 1, 1, 0, 1, 1]"
14513,1,1,2,0.23387665250510414,"[1, 0, 1, 1, 1, 1, 0, 1, 0, 1]"
14514,1,1,2,0.9126843241815796,"[1, 1, 1, 1, 1, 0, 0, 0, 1, 1]"
14515,1,1,2,0.12620624978233952,"[0, 0, 0, 0, 0, 1, 0, 1, 1, 0]"
14516,1,1,2,0.9555239640041303,"[0, 1, 0, 1, 1, 0, 1, 1, 1, 0]"
14517,1,1,2,0.7264959969883917,"[0, 0, 0, 0, 0, 0, 1, 1, 0, 1]"
14518,1,1,2,0.8513980827299875,"[0, 1, 0, 0, 0, 1, 1, 0, 1, 1]"
14519,1,1,2,0.24075339117537708,"[1, 1, 1, 0, 1, 1, 0, 0, 0, 1]"
14520,1,1,2,0.45802897307775514,"[1, 0, 0, 1, 0, 1, 0, 0, 1, 1]"
14521,2,2,4,0.37524894917317486,"[0, 0, 1, 0, 1, 0, 0, 0, 1, 1]"
14522,1,1,2,0.2644837717836326,"[1, 0, 1, 1, 0, 0, 0, 0, 1, 1]"
14523,1,1,2,0.07077515649901778,"[1, 0, 1, 1, 0, 1, 0, 1, 1, 0]"
14524,1,1,2,0.030650763581093532,"[1, 1, 0, 0, 0, 0, 0, 0, 0, 0]"
14525,1,1,2,0.390926727834244,"[0, 0, 0, 1, 1, 1, 1, 0, 1, 0]"
14526,1,1,2,0.947426310123413,"[0, 1, 0, 0, 0, 0, 1, 0, 1, 1]"
14527,1,1,2,0.23386764836754748,"[1, 1, 1, 1, 1, 1, 1, 1, 0, 0]"
14528,1,1,2,0.845676444360901,"[0, 1, 1, 0, 1, 1, 1, 0, 0, 0]"
14529,1,1,2,0.7850191980614512,"[1, 0, 1, 1, 1, 0, 1, 0, 0, 0]"
14530,2,2,4,0.1440857975837334,"[1, 0, 0, 1, 1, 0, 1, 1, 1, 1]"
14531,1,1,2,0.7792234260335955,"[1, 1, 0, 0, 1, 0, 1, 0, 1, 1]"
14532,1,1,2,0.8594679296083032,"[1, 1, 1, 1, 0, 0, 0, 1, 0, 0]"
14533,2,2,4,0.9813532148397567,"[0, 1, 0, 1, 0, 0, 0, 1, 0, 0]"
14534,1,1,2,0.9192751742321154,"[1, 0, 1, 0, 0, 1, 0, 1, 0, 0]"
14535,1,1,2,0.8546979358943707,"[1, 1, 1, 1, 1, 0, 0, 1, 1, 0]"
14536,1,1,2,0.5291182458975249,"[0, 1, 0, 0, 1, 0, 1, 0, 1, 0]"
14537,1,1,2,0.08324021455947916,"[0, 0, 0, 0, 1, 1, 1, 0, 1, 1]"
14538,1,1,2,0.1997201149222183,"[1, 0, 1, 0, 0, 0, 1, 1, 0, 0]"
14539,1,1,2,0.5706887933916289,"[1, 0, 1, 0, 0, 1, 0, 0, 0, 0]"
14540,3,3,6,0.12363166536196069,"[0, 1, 1, 1, 1, 0, 1, 0, 1, 1]"
14541,1,1,2,0.03045841937366245,"[0, 0, 1, 0, 1, 1, 0, 0, 1, 0]"
14542,1,1,2,0.008394322252446518,"[0, 0, 0, 0, 0, 0, 1, 0, 1, 1]"
14543,1,1,2,0.7664074178242252,"[0, 0, 1, 0, 1, 0, 1, 0, 1, 1]"
14544,1,1,2,0.8810082708888455,"[0, 0, 1, 1, 1, 1, 1, 0, 1, 1]"
14545,1,1,2,0.2067879912110019,"[0, 0, 0, 0, 0, 0, 1, 0, 0, 1]"
14546,1,1,2,0.6442589537298087,"[0, 0, 0, 0, 0, 1, 0, 1, 1, 0]"
14547,1,1,2,0.060334729448715985,"[0, 0, 1, 1, 1, 1, 0, 0, 1, 0]"
14548,1,1,2,0.6074199647510152,"[1, 1, 0, 1, 1, 0, 1, 0, 1, 1]"
14549,1,1,2,0.557335939540495,"[1, 1, 1, 1, 1, 1, 1, 0, 0, 0]"
14550,1,1,2,0.7260627211016534,"[0, 0, 0, 0, 0, 1, 1, 1, 1, 1]"
14551,1,1,2,0.6027315193059732,"[1, 1, 0, 0, 0, 0, 0, 0, 1, 1]"
14552,1,1,2,0.7546031071588185,"[1, 0, 0, 0, 1, 1, 0, 0, 0, 1]"
14553,1,1,2,0.01646030711005575,"[1, 0, 0, 0, 1, 0, 0, 0, 1, 1]"
14554,1,1,2,0.1533374388157882,"[0, 1, 0, 1, 1, 0, 1, 0, 0, 1]"
14555,1,1,2,0.37891722043660514,"[1, 1, 1, 0, 1, 0, 1, 1, 0, 0]"
14556,1,1,2,0.02377710772647068,"[0, 1, 0, 0, 0, 1, 0, 0, 1, 1]"
14557,1,1,2,0.25418856159546865,"[0, 0, 1, 1, 0, 0, 0, 0, 0, 0]"
14558,1,1,2,0.7186329942594318,"[1, 0, 0, 0, 1, 1, 1, 0, 1, 1]"
14559,1,1,2,0.8520130819247113,"[0, 0, 0, 0, 1, 1, 1, 1, 0, 0]"
14560,1,1,2,0.4625896717033732,"[1, 1, 0, 0, 0, 0, 1, 1, 0, 1]"
14561,1,1,2,0.9304958557594236,"[1, 0, 1, 1, 0, 0, 0, 1, 1, 0]"
14562,1,1,2,0.7286482609847835,"[1, 0, 1, 0, 0, 0, 0, 1, 1, 1]"
14563,1,1,2,0.7667540323435421,"[1, 1, 1, 1, 0, 0, 1, 1, 1, 0]"
14564,1,1,2,0.5221582295054147,"[1, 0, 1, 1, 1, 0, 0, 0, 1, 1]"
14565,1,1,2,0.9347758232710863,"[1, 1, 1, 0, 1, 0, 1, 0, 1, 1]"
14566,2,2,4,0.5917747188907543,"[1, 1, 1, 1, 1, 0, 0, 0, 0, 0]"
14567,1,1,2,0.9496649635355728,"[0, 0, 1, 0, 0, 1, 0, 1, 0, 0]"
14568,1,1,2,0.3552319489985246,"[0, 1, 0, 1, 0, 1, 0, 1, 1, 0]"
14569,1,1,2,0.512590548261258,"[1, 0, 0, 0, 0, 1, 0, 0, 0, 0]"
14570,1,1,2,0.38488874729455536,"[1, 0, 1, 1, 0, 1, 1, 0, 1, 0]"
14571,1,1,2,0.6784618732532511,"[1, 0, 1, 0, 0, 0, 0, 1, 0, 0]"
14572,1,1,2,0.5637821524943116,"[0, 0, 0, 0, 1, 1, 1, 0, 0, 0]"
14573,4,4,8,0.13797052577892877,"[0, 0, 1, 1, 1, 1, 0, 1, 1, 0]"
14574,1,1,2,0.6641858447114868,"[1, 1, 0, 1, 0, 1, 1, 1, 0, 0]"
14575,1,1,2,0.49007807190584984,"[0, 1, 0, 1, 0, 0, 1, 0, 0, 0]"
14576,1,1,2,0.9623384333105023,"[1, 1, 1, 1, 1, 0, 0, 0, 1, 0]"
14577,1,1,2,0.37288426429498833,"[1, 0, 0, 1, 1, 0, 0, 1, 0, 1]"
14578,1,1,2,0.2901233831642437,"[0, 0, 0, 0, 0, 0, 0, 1, 0, 1]"
14579,1,1,2,0.8076532292089734,"[1, 1, 0, 1, 0, 1, 0, 0, 1, 0]"
14580,1,1,2,0.06006675856854493,"[1, 0, 0, 1, 0, 1, 0, 1, 0, 0]"
14581,1,1,2,0.7388574782219215,"[1, 0, 1, 0, 0, 0, 1, 0, 1, 0]"
14582,1,1,2,0.46728680852530124,"[1, 0, 0, 0, 1, 0, 0, 1, 0, 1]"
14583,2,2,4,0.4393808210382296,"[1, 0, 1, 0, 1, 1, 0, 1, 0, 0]"
14584,1,1,2,0.6367409372885721,"[1, 1, 0, 1, 1, 1, 1, 0, 1, 0]"
14585,1,1,2,0.829701818526921,"[0, 1, 1, 1, 0, 0, 1, 1, 0, 0]"
14586,1,1,2,0.3396088274547553,"[1, 0, 1, 1, 1, 0, 0, 0, 1, 0]"
14587,2,2,4,0.2815090291876201,"[0, 1, 0, 1, 0, 1, 0, 0, 1, 0]"
14588,1,1,2,0.735738634160097,"[0, 0, 0, 0, 1, 0, 1, 0, 0, 0]"
14589,1,1,2,0.4806263040867298,"[0, 0, 0, 0, 0, 0, 0, 0, 0, 1]"
14590,2,2,4,0.4638285903913171,"[0, 1, 0, 0, 1, 0, 0, 0, 1, 0]"
14591,1,1,2,0.9079473427613772,"[1, 1, 1, 0, 1, 1, 1, 1, 1, 1]"
14592,1,1,2,0.09978018296326086,"[1, 1, 1, 0, 0, 1, 0, 0, 1, 1]"
14593,1,1,2,0.8916323184500649,"[0, 0, 1, 1, 1, 1, 0, 0, 0, 0]"
14594,1,1,2,0.02381929546551187,"[0, 1, 1, 0, 1, 0, 0, 1, 0, 1]"
14595,2,2,4,0.24041199879425923,"[0, 1, 0, 1, 1, 1, 0, 1, 1, 0]"
14596,1,1,2,0.23506075121111947,"[1, 1, 1, 1, 1, 0, 0, 1, 1, 0]"
14597,1,1,2,0.8547419162615869,"[0, 1, 1, 1, 0, 1, 1, 0, 1, 0]"
14598,1,1,2,0.46615495920166017,"[0, 1, 1, 0, 0, 1, 0, 0, 1, 1]"
14599,1,1,2,0.03150514302025542,"[0, 0, 1, 1, 0, 1, 0, 0, 0, 1]"
14600,2,2,4,0.9395317197866481,"[0, 1, 1, 1, 0, 0, 1, 1, 1, 1]"
14601,1,1,2,0.44779852220087046,"[0, 0, 1, 1, 1, 0, 0, 1, 0, 1]"
14602,1,1,2,0.8802299885800292,"[0, 1, 0, 0, 0, 1, 1, 0, 1, 1]"
14603,1,1,2,0.8169677306593232,"[1, 1, 1, 0, 1, 1, 0, 0, 1, 0]"
14604,1,1,2,0.1964019760690231,"[0, 1, 1, 1, 0, 0, 1, 0, 1, 1]"
14605,1,1,2,0.34748277358737645,"[0, 1, 1, 0, 0, 0, 1, 1, 1, 0]"
14606,1,1,2,0.33308604574762224,"[1, 1, 0, 1, 1, 0, 0, 0, 0, 1]"
14607,3,3,6,0.7873851451664478,"[0, 1, 1, 0, 1, 0, 1, 1, 1, 1]"
14608,1,1,2,0.9772465580778418,"[0, 0, 0, 1, 0, 0, 0, 1, 0, 1]"
14609,1,1,2,0.3758682483864637,"[1, 0, 1, 1, 0, 1, 0, 1, 1, 0]"
14610,2,2,4,0.10088635262257317,"[1, 0, 1, 1, 0, 1, 1, 1, 1, 1]"
14611,1,1,2,0.31754005577569544,"[1, 1, 0, 0, 0, 0, 0, 0, 0, 1]"
14612,1,1,2,0.7251056570813464,"[0, 1, 0, 1, 1, 0, 0, 1, 1, 1]"
14613,1,1,2,0.12042987560683138,"[1, 1, 1, 1, 0, 1, 0, 1, 1, 1]"
14614,1,1,2,0.9336165267561648,"[0, 1, 0, 1, 0, 1, 1, 1, 0, 0]"
14615,1,1,2,0.579391104238733,"[0, 1, 0, 0, 0, 0, 1, 1, 0, 1]"
14616,2,2,4,0.24507413010077872,"[0, 0, 0, 0, 0, 0, 1, 0, 0, 0]"
14617,1,1,2,0.3154127355118834,"[0, 0, 1, 0, 1, 0, 1, 1, 0, 1]"
14618,1,1,2,0.29807373792544756,"[0, 0, 1, 1, 0, 0, 0, 0, 0, 1]"
14619,1,1,2,0.12994188453614552,"[0, 0, 0, 1, 0, 1, 1, 1, 1, 0]"
14620,1,1,2,0.40391271648722993,"[0, 0, 1, 0, 0, 0, 1, 0, 0, 1]"
14621,1,1,2,0.48720885607134967,"[1, 1, 0, 1, 1, 0, 1, 0, 1, 1]"
14622,1,1,2,0.9024159796115536,"[0, 0, 1, 0, 1, 1, 0, 0, 1, 0]"
14623,1,1,2,0.8538178947969846,"[0, 0, 1, 0, 1, 1, 0, 1, 1, 1]"
14624,1,1,2,0.24782458924709116,"[1, 1, 1, 1, 1, 1, 1, 0, 1, 0]"
14625,1,1,2,0.6225318552099458,"[1, 0, 1, 1, 0, 1, 1, 0, 1, 0]"
14626,1,1,2,0.22804346201760062,"[1, 0, 1, 0, 0, 0, 0, 1, 1, 1]"
14627,1,1,2,0.9727811380431741,"[0, 1, 0, 1, 0, 1, 1, 0, 1, 1]"
14628,1,1,2,0.6114448695952664,"[0, 1, 1, 1, 1, 1, 1, 0, 1, 0]"
14629,1,1,2,0.17969219341935316,"[1, 1, 0, 0, 1, 0, 1, 0, 1, 0]"
14630,1,1,2,0.6287150785641319,"[0, 1, 1, 1, 1, 1, 0, 1, 1, 1]"
14631,1,1,2,0.9454399514564654,"[0, 1, 0, 1, 1, 1, 0, 1, 0, 1]"
14632,1,1,2,0.004844210617766076,"[0, 1, 0, 1, 0, 1, 0, 0, 0, 0]"
14633,1,1,2,0.6969460964411497,"[0, 1, 1, 1, 1, 1, 1, 1, 0, 0]"
14634,2,2,4,0.5687576501570216,"[1, 1, 0, 0, 0, 0, 0, 1, 1, 1]"
14635,2,2,4,0.16398846956187396,"[0, 1, 0, 1, 1, 0, 1, 1, 1, 0]"
14636,1,1,2,0.43545257822370853,"[0, 0, 0, 0, 0, 0, 1, 1, 0, 1]"
14637,1,1,2,0.815843407749726,"[0, 0, 1, 1, 0, 1, 1, 1, 1, 1]"
14638,1,1,2,0.4701533399056831,"[1, 0, 0, 1, 1, 0, 1, 0, 0, 0]"
14639,1,1,2,0.32468839548173367,"[1, 0, 0, 0, 1, 1, 1, 1, 0, 1]"
14640,1,1,2,0.0889906808194103,"[0, 1, 1, 0, 1, 1, 1, 0, 1, 1]"
14641,1,1,2,0.04276990549999782,"[0, 1, 1, 1, 0, 0, 0, 0, 0, 1]"
14642,1,1,2,0.4865104247363434,"[0, 1, 1, 1, 1, 1, 0, 1, 0, 0]"
14643,1,1,2,0.691734938946937,"[1, 1, 0, 1, 1, 1, 0, 1, 1, 0]"
14644,1,1,2,0.4893886740619613,"[0, 1, 0, 1, 1, 1, 1, 0, 1, 0]"
14645,1,1,2,0.023529549983833165,"[0, 1, 0, 0, 0, 1, 0, 1, 0, 1]"
14646,1,1,2,0.6677065780209945,"[0, 0, 1, 1, 1, 0, 1, 1, 0, 0]"
14647,1,1,2,0.6762256169809288,"[0, 0, 1, 0, 0, 1, 0, 1, 1, 1]"
14648,1,1,2,0.2600212613688041,"[0, 1, 0, 1, 0, 1, 0, 1, 0, 0]"
14649,1,1,2,0.7882226753994384,"[0, 1, 0, 0, 1, 0, 1, 1, 0, 1]"
14650,1,1,2,0.779525245470145,"[0, 0, 1, 1, 1, 0, 1, 1, 0, 0]"
14651,1,1,2,0.31934753728304943,"[0, 1, 1, 0, 0, 0, 1, 0, 1, 1]"
14652,1,1,2,0.3377074629526885,"[0, 0, 0, 1, 0, 0, 0, 0, 1, 0]"
14653,1,1,2,0.5022673601513363,"[0, 0, 0, 1, 0, 0, 1, 0, 0, 0]"
14654,1,1,2,0.720184470151977,"[0, 0, 0, 1, 0, 0, 1, 0, 1, 0]"
14655,2,2,4,0.22146666076314825,"[1, 1, 0, 0, 0, 1, 0, 1, 1, 1]"
14656,1,1,2,0.5090296206419923,"[0, 0, 1, 1, 0, 0, 0, 0, 0, 1]"
14657,1,1,2,0.8250279023639044,"[0, 1, 1, 0, 0, 1, 1, 1, 0, 0]"
14658,1,1,2,0.9156064077194549,"[1, 0, 0, 0, 1, 0, 0, 1, 1, 0]"
14659,1,1,2,0.2524812631527681,"[0, 0, 0, 0, 1, 1, 0, 1, 0, 1]"
14660,1,1,2,0.3176035393543548,"[1, 1, 1, 0, 1, 0, 1, 1, 1, 0]"
14661,1,1,2,0.285579787621532,"[0, 0, 0, 1, 0, 1, 0, 1, 0, 0]"
14662,1,1,2,0.6593247123956267,"[0, 0, 0, 1, 0, 1, 1, 1, 1, 0]"
14663,1,1,2,0.8743948334437073,"[1, 1, 1, 1, 0, 0, 0, 1, 1, 0]"
14664,1,1,2,0.24768862911355616,"[0, 0, 1, 1, 0, 1, 1, 1, 0, 1]"
14665,1,1,2,0.8280205166385682,"[1, 0, 0, 0, 1, 1, 1, 0, 1, 0]"
14666,1,1,2,0.8408077840830273,"[1, 0, 1, 0, 0, 0, 0, 0, 0, 1]"
14667,1,1,2,0.8111247277270328,"[0, 1, 1, 1, 0, 0, 0, 0, 0, 1]"
14668,1,1,2,0.9099448560075707,"[0, 0, 1, 1, 1, 1, 0, 0, 1, 1]"
14669,1,1,2,0.5973274800456503,"[1, 0, 1, 0, 1, 0, 0, 1, 1, 0]"
14670,2,2,4,0.6540837152540188,"[1, 1, 1, 1, 1, 1, 0, 1, 0, 1]"
14671,1,1,2,0.35254847738449757,"[0, 1, 0, 1, 1, 1, 0, 1, 1, 0]"
14672,1,1,2,0.7504905439543844,"[1, 0, 1, 0, 0, 1, 1, 0, 0, 1]"
14673,1,1,2,0.14428783135332623,"[1, 0, 1, 0, 1, 1, 1, 1, 1, 0]"
14674,1,1,2,0.46591979287521357,"[1, 0, 0, 0, 0, 0, 0, 0, 0, 0]"
14675,1,1,2,0.6905572275068792,"[0, 0, 1, 1, 0, 0, 1, 1, 1, 1]"
14676,1,1,2,0.2807112334112424,"[0, 1, 0, 1, 1, 0, 1, 0, 0, 1]"
14677,1,1,2,0.21103075899557833,"[1, 0, 1, 0, 0, 0, 1, 1, 1, 1]"
14678,1,1,2,0.15775321061150382,"[0, 1, 0, 1, 0, 0, 0, 0, 0, 0]"
14679,1,1,2,0.6100452752690438,"[0, 1, 1, 0, 1, 1, 1, 0, 0, 1]"
14680,2,2,4,0.5557594549238898,"[1, 1, 1, 0, 1, 1, 0, 1, 1, 0]"
14681,1,1,2,0.3974843878885017,"[0, 1, 0, 0, 1, 0, 1, 0, 0, 0]"
14682,1,1,2,0.637597928084108,"[0, 1, 1, 0, 1, 0, 0, 0, 0, 1]"
14683,1,1,2,0.20823446120570055,"[0, 1, 1, 0, 0, 1, 1, 1, 1, 0]"
14684,1,1,2,0.3521887206784764,"[0, 1, 1, 0, 0, 1, 1, 1, 0, 0]"
14685,1,1,2,0.7354659031259583,"[1, 0, 1, 0, 1, 1, 0, 1, 1, 1]"
14686,1,1,2,0.09966357989882557,"[0, 0, 1, 0, 1, 1, 1, 1, 1, 0]"
14687,1,1,2,0.25537878383401746,"[1, 1, 1, 0, 1, 0, 0, 0, 1, 0]"
14688,1,1,2,0.9517598533779952,"[0, 1, 0, 0, 0, 0, 0, 0, 0, 1]"
14689,1,1,2,0.20783486198034584,"[0, 0, 1, 1, 0, 0, 1, 1, 0, 1]"
14690,2,2,4,0.7066945860840427,"[0, 0, 1, 1, 1, 0, 1, 1, 1, 0]"
14691,1,1,2,0.3089917554794316,"[0, 0, 1, 1, 0, 1, 0, 1, 1, 0]"
14692,1,1,2,0.9354170532174422,"[1, 1, 1, 1, 1, 0, 1, 0, 0, 1]"
14693,1,1,2,0.08589081448207725,"[0, 0, 0, 0, 0, 1, 0, 0, 0, 1]"
14694,2,2,4,0.21407838093846476,"[1, 1, 0, 1, 0, 1, 0, 1, 1, 1]"
14695,1,1,2,0.9464361891433698,"[1, 1, 1, 0, 1, 1, 0, 1, 1, 1]"
14696,1,1,2,0.19815925569441173,"[1, 1, 1, 1, 1, 0, 1, 0, 1, 1]"
14697,1,1,2,0.6005238238484076,"[1, 1, 1, 0, 1, 0, 1, 1, 0, 0]"
14698,1,1,2,0.6413471920765351,"[1, 0, 0, 0, 1, 0, 1, 1, 0, 1]"
14699,1,1,2,0.029980604438667346,"[0, 1, 1, 1, 1, 0, 1, 1, 0, 1]"
14700,1,1,2,0.33220250104504956,"[0, 0, 0, 1, 0, 1, 1, 0, 1, 0]"
14701,1,1,2,0.006286681640084946,"[1, 1, 1, 1, 1, 0, 1, 0, 1, 1]"
14702,1,1,2,0.9737511538683751,"[1, 0, 1, 1, 0, 0, 0, 0, 0, 0]"
14703,1,1,2,0.212947603675393,"[1, 0, 1, 0, 0, 0, 1, 0, 0, 0]"
14704,2,2,4,0.7516478082796231,"[0, 1, 0, 0, 1, 0, 1, 1, 0, 1]"
14705,1,1,2,0.84294288079519,"[1, 1, 0, 1, 1, 0, 1, 0, 1, 0]"
14706,1,1,2,0.5858604754820752,"[0, 0, 1, 0, 1, 0, 0, 1, 1, 1]"
14707,1,1,2,0.7983784907241165,"[0, 0, 1, 0, 1, 0, 1, 1, 1, 1]"
14708,2,2,4,0.6729064859490929,"[1, 0, 0, 0, 1, 1, 1, 0, 0, 1]"
14709,1,1,2,0.32898362917671864,"[1, 0, 0, 1, 1, 0, 0, 1, 1, 1]"
14710,1,1,2,0.28617139844629935,"[1, 0, 1, 0, 0, 0, 1, 0, 0, 0]"
14711,1,1,2,0.8054050074282505,"[0, 1, 1, 1, 1, 1, 1, 1, 1, 1]"
14712,1,1,2,0.13899886564418173,"[0, 1, 0, 1, 1, 1, 1, 1, 1, 0]"
14713,1,1,2,0.010218309065982978,"[0, 0, 0, 1, 1, 1, 1, 1, 0, 1]"
14714,1,1,2,0.8237381401626785,"[1, 0, 0, 1, 0, 1, 1, 0, 1, 0]"
14715,1,1,2,0.17380568859783807,"[0, 1, 1, 0, 1, 1, 0, 1, 0, 0]"
14716,1,1,2,0.1243410187378331,"[1, 1, 1, 0, 0, 1, 1, 0, 0, 0]"
14717,1,1,2,0.10303656706259434,"[1, 1, 0, 1, 1, 0, 0, 1, 0, 1]"
14718,1,1,2,0.7119464165236205,"[0, 1, 1, 0, 0, 0, 0, 0, 1, 1]"
14719,2,2,4,0.7701350108554964,"[0, 0, 1, 0, 0, 1, 0, 1, 1, 1]"
14720,1,1,2,0.9142240911373226,"[0, 1, 1, 0, 1, 0, 1, 1, 0, 0]"
14721,1,1,2,0.5700049440798522,"[1, 0, 0, 1, 0, 1, 1, 1, 1, 0]"
14722,1,1,2,0.11073549699002527,"[0, 1, 1, 1, 1, 1, 1, 0, 0, 0]"
14723,1,1,2,0.1488064342572154,"[0, 1, 0, 0, 1, 0, 1, 0, 1, 1]"
14724,1,1,2,0.0035102066211646354,"[1, 1, 1, 0, 0, 1, 0, 0, 1, 0]"
14725,2,2,4,0.9232763983162717,"[1, 0, 1, 1, 1, 1, 0, 1, 1, 0]"
14726,1,1,2,0.3234932043738341,"[1, 0, 0, 1, 0, 1, 1, 1, 1, 0]"
14727,1,1,2,0.35617021720280173,"[0, 1, 1, 1, 0, 0, 0, 0, 0, 0]"
14728,1,1,2,0.0685575502759348,"[0, 0, 0, 0, 0, 0, 0, 0, 0, 1]"
14729,1,1,2,0.5698551757953486,"[1, 1, 0, 0, 0, 0, 0, 1, 1, 0]"
14730,1,1,2,0.963830407406241,"[1, 1, 0, 0, 1, 0, 1, 0, 0, 1]"
14731,1,1,2,0.6614901591775559,"[0, 1, 0, 0, 1, 0, 1, 0, 1, 1]"
14732,1,1,2,0.745573292542594,"[0, 0, 1, 1, 1, 0, 0, 1, 0, 0]"
14733,1,1,2,0.9130854813436532,"[0, 1, 1, 0, 1, 1, 1, 1, 0, 0]"
14734,1,1,2,0.3585983687760519,"[1, 1, 0, 0, 0, 1, 0, 1, 0, 0]"
14735,1,1,2,0.15535205702174637,"[1, 0, 1, 1, 0, 0, 1, 1, 1, 0]"
14736,1,1,2,0.1963512217762352,"[1, 1, 0, 1, 0, 1, 0, 0, 0, 1]"
14737,1,1,2,0.5934802665665019,"[0, 1, 1, 1, 0, 0, 1, 0, 1, 0]"
14738,1,1,2,0.016385232402353345,"[0, 0, 0, 1, 1, 1, 1, 1, 0, 1]"
14739,1,1,2,0.9921681600669615,"[0, 1, 0, 0, 0, 0, 1, 0, 1, 1]"
14740,1,1,2,0.6054683794351825,"[0, 0, 1, 1, 1, 1, 1, 0, 0, 0]"
14741,1,1,2,0.9204226465577884,"[1, 1, 1, 0, 1, 1, 1, 1, 0, 1]"
14742,1,1,2,0.9811522390861005,"[1, 1, 0, 0, 0, 1, 1, 1, 0, 0]"
14743,1,1,2,0.1247107490372299,"[0, 0, 1, 1, 1, 1, 0, 0, 1, 0]"
14744,1,1,2,0.42098420808871895,"[0, 0, 0, 1, 0, 0, 1, 1, 1, 1]"
14745,1,1,2,0.9776043540351443,"[1, 0, 0, 0, 0, 0, 1, 1, 0, 1]"
14746,2,2,4,0.13557661650851072,"[0, 1, 1, 1, 0, 0, 1, 1, 1, 0]"
14747,1,1,2,0.19997743579448024,"[0, 1, 0, 1, 1, 1, 1, 0, 1, 1]"
14748,2,2,4,0.0625613151416411,"[1, 0, 1, 1, 1, 1, 0, 0, 1, 0]"
14749,1,1,2,0.9407083821880872,"[0, 1, 0, 0, 1, 0, 0, 0, 1, 1]"
14750,1,1,2,0.6323193867778674,"[1, 0, 1, 0, 0, 1, 0, 0, 0, 1]"
14751,1,1,2,0.8997021446390706,"[0, 1, 1, 0, 0, 0, 0, 1, 1, 0]"
14752,1,1,2,0.16375578632709487,"[1, 0, 1, 0, 0, 1, 1, 0, 1, 0]"
14753,2,2,4,0.4786477493247958,"[0, 1, 1, 0, 0, 1, 1, 1, 1, 1]"
14754,2,2,4,0.8758345559949379,"[1, 0, 1, 0, 0, 1, 0, 1, 0, 0]"
14755,1,1,2,0.8322071233281699,"[1, 0, 1, 1, 0, 0, 0, 0, 0, 1]"
14756,1,1,2,0.36220284147116066,"[1, 0, 1, 0, 1, 0, 0, 0, 0, 1]"
14757,1,1,2,0.812833842715192,"[1, 0, 1, 0, 1, 0, 1, 0, 0, 1]"
14758,1,1,2,0.3294288718258027,"[1, 0, 0, 0, 1, 0, 0, 0, 0, 0]"
14759,1,1,2,0.1527266110308586,"[0, 1, 1, 0, 1, 1, 1, 1, 0, 0]"
14760,1,1,2,0.11818574312696206,"[1, 0, 0, 0, 0, 1, 1, 1, 0, 1]"
14761,1,1,2,0.5113999776058855,"[1, 0, 0, 1, 1, 0, 0, 0, 1, 1]"
14762,1,1,2,0.4211852790372447,"[0, 1, 1, 0, 0, 0, 1, 1, 0, 0]"
14763,1,1,2,0.11900512987198841,"[1, 0, 1, 1, 1, 1, 1, 1, 0, 1]"
14764,1,1,2,0.855308745255935,"[1, 1, 1, 0, 1, 0, 1, 0, 0, 1]"
14765,1,1,2,0.10067909335337089,"[0, 0, 1, 1, 0, 1, 1, 0, 1, 1]"
14766,1,1,2,0.5139866803093348,"[0, 0, 0, 0, 1, 0, 0, 1, 0, 1]"
14767,1,1,2,0.3495540174863334,"[0, 1, 0, 0, 1, 0, 1, 0, 1, 1]"
14768,1,1,2,0.5201855648221921,"[1, 1, 0, 0, 1, 1, 1, 1, 0, 1]"
14769,1,1,2,0.02802774558178789,"[1, 1, 1, 0, 0, 0, 0, 0, 1, 1]"
14770,1,1,2,0.7143700260790719,"[1, 0, 0, 0, 1, 0, 0, 0, 1, 1]"
14771,1,1,2,0.9078808792472094,"[0, 0, 1, 1, 1, 1, 0, 0, 1, 0]"
14772,1,1,2,0.4220506487843957,"[0, 0, 1, 0, 1, 0, 0, 0, 1, 1]"
14773,1,1,2,0.7961497059073367,"[0, 0, 0, 1, 1, 0, 1, 0, 0, 1]"
14774,2,2,4,0.14701710563185333,"[0, 1, 0, 0, 1, 0, 1, 0, 1, 0]"
14775,1,1,2,0.33863573997407204,"[1, 1, 0, 0, 0, 0, 1, 0, 1, 1]"
14776,1,1,2,0.05520755802684696,"[1, 1, 1, 0, 1, 0, 1, 1, 0, 0]"
14777,1,1,2,0.14541203097014332,"[1, 0, 0, 1, 1, 0, 1, 1, 1, 0]"
14778,1,1,2,0.5828364334602198,"[1, 0, 0, 1, 0, 0, 1, 1, 1, 0]"
14779,1,1,2,0.30157849666090886,"[0, 0, 1, 0, 1, 0, 1, 0, 1, 0]"
14780,1,1,2,0.589220408549186,"[1, 0, 1, 0, 0, 1, 1, 0, 0, 0]"
14781,1,1,2,0.6486142306020934,"[0, 0, 1, 0, 0, 0, 0, 0, 1, 0]"
14782,2,2,4,0.7861285455259597,"[0, 0, 0, 0, 1, 1, 1, 1, 1, 0]"
14783,1,1,2,0.8343406360524567,"[0, 1, 0, 0, 1, 1, 1, 0, 1, 1]"
14784,1,1,2,0.9046040358082259,"[1, 1, 1, 1, 1, 1, 1, 0, 1, 0]"
14785,1,1,2,0.9558129280882015,"[1, 0, 1, 1, 0, 0, 0, 1, 0, 0]"
14786,1,1,2,0.008035356713143815,"[1, 0, 1, 1, 0, 0, 0, 0, 0, 1]"
14787,1,1,2,0.17929725496896098,"[0, 0, 0, 1, 1, 0, 1, 0, 1, 1]"
14788,1,1,2,0.6108916072730733,"[1, 1, 1, 1, 0, 1, 0, 1, 0, 1]"
14789,1,1,2,0.05168595676984311,"[1, 0, 1, 0, 0, 1, 0, 1, 1, 1]"
14790,1,1,2,0.947254592024894,"[1, 0, 0, 0, 1, 0, 0, 0, 1, 1]"
14791,1,1,2,0.9996769999048333,"[0, 1, 1, 1, 1, 1, 1, 0, 1, 1]"
14792,1,1,2,0.059797127756673896,"[1, 1, 1, 0, 0, 1, 1, 1, 0, 0]"
14793,1,1,2,0.4851230006800721,"[1, 1, 1, 0, 0, 1, 0, 1, 1, 0]"
14794,1,1,2,0.7235561297387102,"[1, 1, 0, 0, 0, 0, 0, 0, 1, 1]"
14795,1,1,2,0.2672731402832089,"[0, 1, 0, 1, 0, 0, 1, 0, 0, 0]"
14796,1,1,2,0.6888148194327087,"[0, 0, 0, 0, 0, 0, 0, 0, 1, 1]"
14797,1,1,2,0.4563375102990217,"[0, 1, 0, 0, 0, 1, 1, 1, 0, 0]"
14798,1,1,2,0.6041105649702048,"[0, 1, 0, 0, 1, 0, 0, 1, 1, 1]"
14799,1,1,2,0.9573659480068579,"[0, 1, 1, 0, 0, 0, 1, 0, 0, 1]"
14800,1,1,2,0.4657164664661867,"[1, 1, 1, 1, 0, 1, 1, 1, 0, 0]"
14801,1,1,2,0.3994018161256897,"[1, 0, 0, 0, 0, 1, 0, 0, 1, 1]"
14802,1,1,2,0.26399816199134696,"[1, 0, 0, 1, 1, 1, 1, 0, 1, 0]"
14803,1,1,2,0.10737146399900988,"[0, 0, 1, 0, 0, 1, 1, 0, 1, 1]"
14804,1,1,2,0.42776564370320547,"[0, 0, 1, 0, 0, 1, 1, 0, 0, 1]"
14805,1,1,2,0.3576234512934474,"[1, 1, 0, 1, 1, 1, 1, 1, 1, 0]"
14806,1,1,2,0.5186760143777245,"[0, 1, 1, 0, 1, 1, 0, 0, 0, 0]"
14807,1,1,2,0.8773344251350889,"[1, 1, 1, 0, 0, 0, 0, 0, 0, 1]"
14808,1,1,2,0.77394208343448,"[0, 1, 1, 0, 0, 1, 1, 0, 0, 0]"
14809,1,1,2,0.8933485666490772,"[0, 0, 0, 1, 0, 0, 0, 1, 1, 1]"
14810,1,1,2,0.538638448233209,"[1, 1, 0, 1, 1, 0, 0, 1, 1, 1]"
14811,1,1,2,0.6338260896404514,"[0, 0, 0, 0, 0, 1, 1, 1, 1, 0]"
14812,1,1,2,0.6882253643820243,"[0, 0, 0, 1, 0, 0, 0, 0, 1, 0]"
14813,1,1,2,0.14565306779413112,"[0, 0, 0, 0, 0, 1, 0, 0, 0, 0]"
14814,1,1,2,0.5839749386055529,"[0, 1, 1, 0, 1, 1, 0, 0, 1, 1]"
14815,1,1,2,0.9258604214338901,"[1, 1, 1, 0, 1, 0, 1, 0, 1, 0]"
14816,1,1,2,0.9235274159640499,"[0, 0, 1, 0, 0, 1, 1, 0, 1, 1]"
14817,1,1,2,0.5300532942783786,"[1, 0, 1, 0, 1, 1, 1, 0, 0, 0]"
14818,1,1,2,0.9188431905610616,"[0, 1, 0, 1, 0, 0, 0, 1, 1, 1]"
14819,1,1,2,0.44345549848041155,"[0, 1, 0, 1, 1, 1, 0, 1, 1, 0]"
14820,1,1,2,0.5526860690089032,"[0, 0, 0, 1, 0, 1, 1, 0, 1, 0]"
14821,1,1,2,0.5996972755521968,"[0, 1, 1, 1, 0, 0, 1, 0, 1, 0]"
14822,1,1,2,0.845352622382498,"[1, 1, 0, 0, 1, 0, 0, 1, 1, 1]"
14823,1,1,2,0.3462578914495099,"[1, 0, 0, 1, 0, 0, 0, 1, 0, 1]"
14824,1,1,2,0.20683984323789673,"[1, 1, 1, 0, 0, 0, 0, 1, 1, 0]"
14825,1,1,2,0.10928919381783242,"[1, 1, 1, 1, 1, 0, 1, 0, 1, 0]"
14826,1,1,2,0.8068889302749629,"[0, 0, 0, 0, 0, 0, 1, 1, 1, 0]"
14827,1,1,2,0.39508921223144944,"[1, 0, 1, 1, 0, 0, 1, 1, 0, 0]"
14828,1,1,2,0.5936639941011363,"[0, 0, 1, 0, 1, 0, 1, 0, 0, 0]"
14829,1,1,2,0.19031762047987588,"[1, 1, 1, 0, 0, 1, 0, 0, 0, 0]"
14830,1,1,2,0.4705920585113441,"[0, 0, 1, 1, 1, 1, 0, 0, 1, 0]"
14831,1,1,2,0.8046035136231942,"[1, 1, 1, 1, 0, 0, 1, 0, 1, 1]"
14832,1,1,2,0.4989529812235374,"[1, 0, 0, 0, 0, 1, 0, 1, 0, 0]"
14833,1,1,2,0.2029907545509252,"[0, 0, 0, 1, 0, 1, 0, 1, 0, 0]"
14834,1,1,2,0.012639083397878004,"[1, 0, 1, 1, 0, 0, 1, 0, 0, 0]"
14835,1,1,2,0.48095874685807793,"[0, 1, 0, 0, 1, 1, 1, 0, 0, 1]"
14836,1,1,2,0.984304834401287,"[0, 1, 1, 1, 0, 1, 1, 0, 0, 0]"
14837,1,1,2,0.46194300936196075,"[0, 1, 1, 0, 1, 1, 1, 0, 0, 1]"
14838,1,1,2,0.9123892627802943,"[1, 1, 0, 0, 1, 0, 0, 1, 0, 1]"
14839,1,1,2,0.7063693244607353,"[0, 0, 1, 1, 1, 0, 0, 1, 0, 0]"
14840,1,1,2,0.7099245959979715,"[1, 0, 1, 1, 1, 1, 1, 1, 0, 1]"
14841,1,1,2,0.051357763075574825,"[1, 0, 1, 1, 0, 0, 1, 1, 0, 1]"
14842,1,1,2,0.3655585484197086,"[1, 1, 1, 1, 1, 1, 0, 1, 0, 1]"
14843,1,1,2,0.4165921508330527,"[1, 1, 0, 1, 0, 0, 0, 0, 0, 0]"
14844,1,1,2,0.6147323397549841,"[1, 0, 0, 0, 0, 1, 1, 0, 1, 0]"
14845,1,1,2,0.5467089703829574,"[1, 1, 0, 0, 1, 0, 1, 1, 1, 0]"
14846,1,1,2,0.8630219605773394,"[1, 0, 1, 0, 1, 1, 0, 1, 1, 1]"
14847,1,1,2,0.7354404574350948,"[0, 0, 0, 0, 1, 1, 0, 0, 0, 1]"
14848,1,1,2,0.2460550884167162,"[1, 1, 1, 0, 0, 1, 0, 0, 0, 0]"
14849,1,1,2,0.5860070767174199,"[0, 0, 0, 0, 0, 0, 1, 1, 1, 1]"
14850,2,2,4,0.20878863451186747,"[1, 0, 1, 1, 1, 0, 1, 0, 0, 0]"
14851,1,1,2,0.23326968213933796,"[0, 1, 0, 1, 1, 1, 1, 1, 0, 0]"
14852,1,1,2,0.15123905293010043,"[0, 1, 0, 0, 0, 0, 1, 1, 1, 1]"
14853,1,1,2,0.5458481442384777,"[1, 0, 1, 1, 1, 0, 1, 1, 1, 1]"
14854,3,3,6,0.14373118800261797,"[1, 0, 0, 1, 0, 1, 0, 1, 1, 1]"
14855,1,1,2,0.4627063568181964,"[0, 1, 0, 1, 1, 1, 1, 0, 0, 0]"
14856,1,1,2,0.9876329552593043,"[0, 0, 1, 1, 1, 0, 1, 1, 0, 1]"
14857,1,1,2,0.560103656013781,"[0, 0, 0, 1, 0, 0, 0, 1, 0, 1]"
14858,1,1,2,0.576322247953032,"[0, 0, 0, 1, 1, 1, 0, 0, 1, 0]"
14859,1,1,2,0.37226063809878174,"[1, 1, 1, 1, 1, 1, 1, 0, 0, 1]"
14860,1,1,2,0.14859468318751978,"[1, 0, 0, 0, 1, 0, 0, 1, 0, 1]"
14861,1,1,2,0.4809144773206514,"[1, 0, 1, 1, 1, 1, 1, 0, 0, 1]"
14862,1,1,2,0.7967949016263575,"[1, 1, 0, 1, 1, 1, 0, 1, 1, 1]"
14863,2,2,4,0.5002880010421644,"[1, 0, 0, 1, 1, 1, 0, 0, 1, 1]"
14864,1,1,2,0.5153345263721805,"[1, 0, 1, 0, 0, 1, 0, 0, 0, 0]"
14865,1,1,2,0.6049664769859706,"[1, 0, 1, 0, 0, 1, 0, 1, 0, 0]"
14866,1,1,2,0.6132096233423321,"[0, 0, 0, 1, 1, 1, 0, 0, 1, 1]"
14867,1,1,2,0.976262359513023,"[0, 1, 0, 1, 1, 0, 0, 0, 1, 0]"
14868,1,1,2,0.37809761281254206,"[0, 1, 0, 1, 0, 1, 0, 0, 1, 1]"
14869,1,1,2,0.750535018706537,"[1, 0, 0, 1, 0, 1, 0, 0, 0, 0]"
14870,1,1,2,0.4713493362870651,"[0, 1, 1, 0, 0, 1, 1, 0, 1, 1]"
14871,1,1,2,0.6021604943037676,"[1, 1, 1, 1, 0, 0, 1, 0, 0, 1]"
14872,1,1,2,0.12027907329571985,"[0, 1, 1, 1, 1, 0, 1, 1, 0, 1]"
14873,1,1,2,0.5004857502253468,"[1, 1, 0, 1, 1, 1, 1, 1, 1, 0]"
14874,1,1,2,0.4531769332429789,"[1, 0, 0, 1, 1, 1, 0, 0, 1, 0]"
14875,1,1,2,0.3920811552238155,"[0, 1, 0, 1, 1, 0, 1, 0, 0, 0]"
14876,1,1,2,0.6073937137890513,"[0, 0, 1, 0, 1, 1, 1, 0, 1, 1]"
14877,1,1,2,0.908568524191972,"[1, 1, 0, 1, 0, 0, 1, 0, 0, 0]"
14878,1,1,2,0.5685934429847788,"[1, 1, 1, 0, 1, 0, 0, 1, 1, 0]"
14879,1,1,2,0.7310779025750578,"[1, 1, 1, 1, 1, 0, 0, 0, 0, 1]"
14880,1,1,2,0.663738119019182,"[1, 0, 1, 1, 0, 0, 0, 0, 0, 0]"
14881,1,1,2,0.032227678792354886,"[0, 1, 1, 1, 1, 0, 0, 0, 0, 0]"
14882,1,1,2,0.8102484323124639,"[1, 0, 0, 0, 0, 0, 0, 0, 1, 1]"
14883,1,1,2,0.7746797399736332,"[0, 1, 0, 1, 0, 1, 1, 0, 0, 1]"
14884,1,1,2,0.9619976885998581,"[0, 1, 0, 0, 1, 0, 1, 0, 0, 0]"
14885,1,1,2,0.3387588391085138,"[0, 0, 1, 1, 0, 0, 0, 1, 1, 0]"
14886,1,1,2,0.48298880769084795,"[1, 1, 0, 1, 0, 1, 1, 1, 0, 0]"
14887,1,1,2,0.7426995485082849,"[1, 0, 1, 1, 0, 1, 1, 1, 1, 0]"
14888,1,1,2,0.940092121666366,"[0, 1, 1, 0, 1, 1, 1, 0, 0, 0]"
14889,1,1,2,0.304283217454271,"[1, 0, 0, 1, 0, 0, 1, 0, 1, 0]"
14890,3,3,6,0.23525118033281456,"[1, 1, 1, 1, 0, 0, 1, 1, 0, 1]"
14891,1,1,2,0.7452900272513072,"[0, 0, 1, 0, 0, 1, 0, 0, 0, 1]"
14892,1,1,2,0.3955387679491217,"[1, 1, 1, 0, 0, 0, 0, 1, 1, 0]"
14893,1,1,2,0.2605048190884153,"[0, 1, 0, 1, 0, 0, 1, 1, 0, 0]"
14894,1,1,2,0.6203115470971019,"[0, 0, 1, 0, 0, 1, 1, 0, 0, 1]"
14895,1,1,2,0.8740596967438421,"[1, 1, 0, 0, 0, 0, 0, 1, 1, 0]"
14896,1,1,2,0.3329069684111836,"[0, 1, 0, 0, 0, 0, 0, 0, 1, 1]"
14897,4,4,8,0.9368191159783232,"[1, 0, 0, 1, 0, 1, 0, 1, 1, 1]"
14898,1,1,2,0.25121063811851296,"[0, 0, 0, 0, 0, 1, 1, 0, 0, 0]"
14899,1,1,2,0.8776123856615693,"[0, 1, 1, 1, 1, 1, 0, 0, 1, 0]"
14900,1,1,2,0.6269432208030242,"[0, 1, 1, 1, 1, 0, 1, 1, 0, 0]"
14901,1,1,2,0.6130490510188152,"[1, 0, 0, 0, 1, 1, 0, 1, 1, 1]"
14902,1,1,2,0.6054989832614339,"[1, 1, 0, 1, 1, 0, 1, 0, 0, 1]"
14903,1,1,2,0.68241673894801,"[0, 0, 0, 1, 0, 1, 0, 0, 1, 1]"
14904,1,1,2,0.541699121357475,"[1, 0, 0, 0, 1, 0, 0, 0, 0, 1]"
14905,1,1,2,0.21757121221764664,"[0, 1, 1, 0, 1, 0, 0, 1, 0, 1]"
14906,1,1,2,0.732068502435977,"[1, 1, 0, 1, 0, 0, 0, 0, 1, 1]"
14907,1,1,2,0.275491138226703,"[1, 0, 1, 0, 0, 0, 1, 0, 1, 0]"
14908,1,1,2,0.20269267982255434,"[0, 1, 0, 0, 0, 0, 0, 1, 1, 1]"
14909,1,1,2,0.940886097802509,"[0, 0, 1, 0, 0, 1, 0, 0, 0, 1]"
14910,1,1,2,0.29411605655377115,"[0, 0, 1, 0, 0, 1, 1, 0, 0, 0]"
14911,1,1,2,0.14116084305175447,"[0, 0, 0, 0, 1, 1, 1, 1, 0, 0]"
14912,1,1,2,0.19710386696353022,"[1, 0, 0, 1, 0, 0, 1, 0, 1, 1]"
14913,1,1,2,0.8665286779788154,"[1, 0, 0, 0, 1, 1, 1, 1, 0, 0]"
14914,1,1,2,0.6245198417483973,"[1, 0, 0, 0, 0, 0, 1, 1, 0, 0]"
14915,1,1,2,0.9589161513703441,"[0, 0, 1, 1, 0, 1, 1, 1, 1, 0]"
14916,1,1,2,0.42423936225147574,"[0, 0, 1, 1, 1, 1, 0, 0, 0, 0]"
14917,1,1,2,0.5709280653669018,"[0, 0, 1, 0, 0, 1, 1, 0, 1, 0]"
14918,1,1,2,0.9510240418927967,"[1, 0, 0, 0, 1, 0, 0, 1, 0, 0]"
14919,2,2,4,0.7528425162249471,"[0, 1, 1, 1, 1, 0, 0, 1, 1, 0]"
14920,1,1,2,0.3039800151646883,"[1, 1, 1, 1, 1, 1, 1, 0, 0, 0]"
14921,1,1,2,0.7587543168553503,"[1, 1, 1, 0, 0, 1, 0, 1, 0, 0]"
14922,1,1,2,0.43076181764641575,"[0, 0, 0, 0, 1, 1, 0, 0, 1, 0]"
14923,1,1,2,0.9911661048002612,"[1, 0, 1, 0, 0, 0, 1, 0, 0, 0]"
14924,1,1,2,0.7661933283092174,"[0, 0, 1, 1, 0, 0, 1, 1, 1, 0]"
14925,1,1,2,0.08441890729528623,"[1, 1, 1, 0, 1, 1, 1, 0, 0, 1]"
14926,1,1,2,0.22156574342558866,"[0, 1, 1, 1, 1, 1, 1, 1, 1, 0]"
14927,1,1,2,0.3381166094945951,"[1, 1, 0, 0, 0, 0, 1, 0, 1, 0]"
14928,1,1,2,0.3301597747256634,"[1, 1, 0, 0, 0, 0, 0, 0, 0, 1]"
14929,1,1,2,0.5371883732001108,"[0, 1, 1, 0, 1, 0, 1, 1, 1, 0]"
14930,1,1,2,0.7640201117609196,"[0, 0, 1, 1, 0, 1, 1, 1, 1, 0]"
14931,1,1,2,0.3263163742788745,"[0, 0, 0, 1, 0, 0, 0, 0, 0, 0]"
14932,1,1,2,0.5011429619042108,"[0, 1, 1, 0, 0, 0, 1, 1, 1, 1]"
14933,1,1,2,0.7156426556233167,"[0, 1, 1, 1, 1, 0, 1, 0, 1, 0]"
14934,1,1,2,0.8502175078857879,"[1, 0, 1, 0, 0, 0, 0, 0, 1, 0]"
14935,1,1,2,0.221817578752036,"[1, 1, 0, 1, 0, 0, 0, 0, 0, 0]"
14936,1,1,2,0.16946072512168664,"[0, 1, 0, 1, 0, 1, 0, 1, 1, 0]"
14937,1,1,2,0.2608419849531203,"[0, 1, 0, 1, 0, 1, 1, 0, 0, 1]"
14938,1,1,2,0.4148723512746274,"[1, 1, 0, 1, 0, 1, 0, 0, 0, 0]"
14939,1,1,2,0.25471380391601506,"[1, 1, 1, 1, 1, 0, 0, 1, 0, 1]"
14940,1,1,2,0.660746904255668,"[1, 0, 1, 1, 1, 1, 0, 0, 1, 1]"
14941,1,1,2,0.8890172951161351,"[1, 0, 0, 0, 1, 1, 1, 0, 0, 0]"
14942,1,1,2,0.7752466338420606,"[0, 0, 0, 0, 1, 1, 1, 0, 0, 0]"
14943,2,2,4,0.35938241211525734,"[0, 1, 1, 0, 0, 1, 0, 0, 1, 0]"
14944,1,1,2,0.2705234998607601,"[0, 0, 1, 1, 0, 1, 0, 1, 1, 0]"
14945,3,3,6,0.6213764221470351,"[1, 1, 0, 1, 0, 1, 1, 0, 0, 1]"
14946,2,2,4,0.7265372748227472,"[1, 1, 0, 1, 1, 1, 1, 0, 1, 1]"
14947,1,1,2,0.7292166752508965,"[0, 0, 1, 0, 1, 0, 1, 1, 1, 0]"
14948,2,2,4,0.7958866510779079,"[0, 1, 0, 1, 0, 1, 1, 1, 1, 1]"
14949,1,1,2,0.629739484859126,"[1, 0, 1, 0, 1, 0, 1, 0, 0, 1]"
14950,1,1,2,0.7606844058423984,"[0, 1, 1, 1, 1, 0, 1, 1, 0, 1]"
14951,1,1,2,0.9103157042764438,"[1, 1, 0, 1, 0, 1, 0, 1, 0, 0]"
14952,1,1,2,0.6450659530720625,"[0, 0, 0, 0, 0, 0, 0, 0, 0, 1]"
14953,1,1,2,0.6528426561838554,"[0, 0, 1, 0, 1, 0, 0, 1, 0, 0]"
14954,1,1,2,0.7456307394464146,"[1, 0, 1, 0, 0, 1, 1, 0, 0, 1]"
14955,1,1,2,0.44629457501815395,"[1, 0, 0, 0, 0, 1, 0, 1, 0, 0]"
14956,1,1,2,0.9529688142954196,"[0, 1, 0, 0, 1, 0, 0, 0, 0, 0]"
14957,1,1,2,0.7833953201161299,"[0, 1, 1, 0, 0, 1, 0, 0, 0, 0]"
14958,1,1,2,0.8096244466641455,"[0, 1, 0, 1, 0, 1, 1, 1, 0, 0]"
14959,1,1,2,0.5185296429276868,"[0, 1, 1, 1, 1, 0, 0, 0, 0, 1]"
14960,1,1,2,0.07134310839709634,"[1, 0, 1, 1, 0, 0, 1, 0, 0, 0]"
14961,1,1,2,0.11491214783812809,"[1, 1, 0, 0, 1, 0, 1, 0, 0, 1]"
14962,1,1,2,0.14114945593350625,"[0, 0, 0, 1, 0, 0, 0, 0, 1, 1]"
14963,1,1,2,0.856263121079243,"[0, 0, 0, 1, 0, 1, 0, 1, 0, 0]"
14964,1,1,2,0.9465672320770474,"[1, 1, 1, 1, 1, 0, 0, 1, 0, 0]"
14965,1,1,2,0.8745249610561733,"[0, 0, 0, 1, 1, 0, 1, 0, 1, 0]"
14966,1,1,2,0.37539122641865597,"[1, 1, 0, 1, 1, 0, 1, 1, 0, 0]"
14967,1,1,2,0.08591100478872449,"[0, 1, 1, 0, 0, 1, 0, 1, 1, 0]"
14968,1,1,2,0.5969190396178101,"[1, 1, 1, 0, 0, 0, 0, 1, 0, 0]"
14969,1,1,2,0.8662162707790412,"[0, 0, 0, 1, 1, 0, 0, 0, 1, 0]"
14970,1,1,2,0.40699681025017387,"[0, 0, 0, 0, 1, 1, 0, 0, 1, 0]"
14971,1,1,2,0.8578011908185507,"[1, 1, 0, 1, 1, 1, 1, 0, 0, 0]"
14972,1,1,2,0.5747928623697535,"[0, 0, 1, 1, 0, 0, 1, 1, 0, 1]"
14973,1,1,2,0.37858715262310283,"[0, 0, 1, 0, 0, 1, 0, 1, 0, 0]"
14974,1,1,2,0.5929951404893594,"[0, 0, 1, 0, 1, 1, 1, 1, 0, 0]"
14975,1,1,2,0.9978562187261398,"[1, 0, 1, 1, 0, 0, 0, 0, 1, 0]"
14976,1,1,2,0.403571046422894,"[0, 0, 1, 1, 0, 0, 1, 1, 1, 0]"
14977,2,2,4,0.1950803539550292,"[0, 0, 1, 1, 1, 0, 1, 0, 1, 1]"
14978,1,1,2,0.4553558312274285,"[0, 1, 1, 1, 0, 1, 1, 0, 0, 0]"
14979,1,1,2,0.08044768029301175,"[1, 0, 0, 0, 1, 1, 1, 1, 0, 0]"
14980,1,1,2,0.4174250093967121,"[0, 0, 1, 1, 1, 1, 0, 1, 0, 0]"
14981,1,1,2,0.0873757726635408,"[1, 1, 0, 1, 0, 1, 0, 1, 1, 1]"
14982,1,1,2,0.7034194982081736,"[1, 0, 0, 0, 1, 1, 0, 1, 1, 1]"
14983,1,1,2,0.9891231356922408,"[1, 1, 1, 1, 0, 1, 0, 1, 1, 1]"
14984,1,1,2,0.48336042909921695,"[1, 0, 1, 1, 0, 1, 0, 1, 0, 1]"
14985,1,1,2,0.19068023514321653,"[0, 1, 0, 1, 1, 1, 1, 1, 1, 1]"
14986,1,1,2,0.8995546691883625,"[1, 0, 1, 1, 0, 0, 1, 1, 1, 0]"
14987,1,1,2,0.513221367289286,"[0, 1, 1, 1, 1, 0, 0, 1, 0, 0]"
14988,1,1,2,0.0566446423439112,"[0, 0, 1, 1, 1, 1, 0, 1, 0, 0]"
14989,1,1,2,0.2125204452962487,"[1, 0, 1, 1, 0, 1, 0, 1, 1, 0]"
14990,1,1,2,0.40287115693509346,"[1, 0, 1, 0, 0, 0, 1, 0, 1, 0]"
14991,1,1,2,0.8405857469668896,"[1, 0, 0, 0, 1, 0, 0, 1, 1, 1]"
14992,1,1,2,0.30398091679501293,"[1, 1, 1, 0, 1, 1, 1, 0, 0, 1]"
14993,1,1,2,0.6027444948799724,"[0, 1, 0, 1, 0, 0, 1, 0, 0, 1]"
14994,1,1,2,0.5499685371426489,"[1, 0, 0, 1, 0, 1, 0, 1, 0, 1]"
14995,1,1,2,0.7592014618062716,"[0, 1, 0, 1, 0, 0, 0, 1, 1, 1]"
14996,1,1,2,0.5775853159159542,"[0, 0, 1, 1, 0, 1, 0, 0, 1, 0]"
14997,1,1,2,0.4018255344338646,"[0, 1, 0, 1, 1, 1, 0, 1, 1, 0]"
14998,2,2,4,0.5469308543961806,"[0, 0, 0, 1, 1, 0, 1, 1, 1, 0]"
14999,1,1,2,0.5603428292245842,"[1, 1, 0, 1, 0, 0, 1, 1, 0, 1]"
15000,1,1,2,0.05234434198381133,"[0, 0, 0, 1, 1, 0, 1, 1, 0, 1]"
15001,1,1,2,0.661254533487456,"[1, 1, 0, 1, 0, 0, 0, 0, 1, 0]"
15002,1,1,2,0.8597815030986231,"[0, 1, 1, 0, 0, 0, 1, 0, 1, 1]"
15003,3,3,6,0.6800955656433476,"[0, 0, 0, 0, 1, 0, 0, 1, 1, 1]"
15004,1,1,2,0.6708044039941568,"[0, 1, 1, 0, 1, 0, 1, 0, 0, 0]"
15005,1,1,2,0.4696470498952007,"[0, 0, 1, 1, 0, 1, 1, 1, 0, 1]"
15006,1,1,2,0.31312472178066353,"[1, 0, 0, 1, 0, 1, 1, 1, 0, 1]"
15007,3,3,6,0.4867267020342193,"[1, 0, 0, 1, 1, 1, 1, 1, 1, 1]"
15008,1,1,2,0.10573218208838875,"[0, 1, 0, 1, 1, 0, 0, 0, 0, 1]"
15009,1,1,2,0.7465064656439228,"[0, 1, 1, 1, 0, 1, 1, 0, 0, 0]"
15010,2,2,4,0.38311103842917826,"[1, 1, 0, 0, 1, 1, 1, 0, 1, 1]"
15011,1,1,2,0.6439844652313437,"[0, 1, 0, 1, 1, 0, 0, 0, 1, 0]"
15012,1,1,2,0.1573028532356432,"[1, 0, 0, 0, 1, 1, 0, 0, 0, 0]"
15013,1,1,2,0.016173837059622387,"[0, 0, 0, 1, 1, 1, 0, 1, 0, 1]"
15014,1,1,2,0.09322278487205826,"[0, 1, 1, 1, 0, 1, 1, 1, 1, 0]"
15015,1,1,2,0.08573031085631255,"[0, 1, 1, 1, 1, 1, 0, 1, 0, 0]"
15016,1,1,2,0.2314478631001381,"[0, 0, 0, 1, 1, 0, 0, 0, 0, 0]"
15017,1,1,2,0.5359625722132926,"[1, 0, 0, 1, 0, 0, 1, 1, 0, 1]"
15018,1,1,2,0.10473767939138912,"[0, 1, 1, 0, 1, 1, 1, 0, 0, 0]"
15019,1,1,2,0.19426712765676502,"[1, 0, 1, 0, 1, 0, 0, 1, 1, 0]"
15020,1,1,2,0.09315066697282992,"[0, 1, 0, 1, 1, 0, 0, 0, 1, 1]"
15021,1,1,2,0.08743290060057396,"[0, 0, 1, 0, 0, 1, 0, 0, 1, 0]"
15022,2,2,4,0.9525355467545,"[1, 1, 1, 1, 1, 1, 0, 0, 0, 0]"
15023,2,2,4,0.5412696092395409,"[0, 1, 0, 0, 1, 0, 0, 1, 1, 0]"
15024,2,2,4,0.8999437957768971,"[0, 0, 0, 1, 1, 1, 1, 0, 1, 0]"
15025,1,1,2,0.3799203882477201,"[0, 1, 0, 0, 1, 1, 1, 0, 0, 0]"
15026,1,1,2,0.16927463841188672,"[0, 0, 0, 1, 1, 1, 0, 0, 1, 1]"
15027,1,1,2,0.5686933111914854,"[1, 0, 1, 1, 0, 1, 1, 1, 1, 1]"
15028,1,1,2,0.5264717633966498,"[1, 0, 1, 1, 0, 1, 1, 0, 1, 1]"
15029,1,1,2,0.999373159248158,"[0, 1, 1, 1, 0, 0, 0, 0, 1, 0]"
15030,1,1,2,0.6600618645314607,"[0, 0, 1, 0, 1, 0, 1, 0, 0, 1]"
15031,1,1,2,0.17602927353168196,"[0, 1, 1, 1, 1, 0, 1, 0, 1, 0]"
15032,1,1,2,0.056038595557721504,"[1, 1, 1, 0, 1, 0, 1, 1, 0, 0]"
15033,1,1,2,0.731430595452143,"[0, 1, 1, 0, 1, 1, 1, 0, 0, 0]"
15034,1,1,2,0.7942576501277152,"[1, 0, 0, 0, 1, 1, 1, 0, 0, 1]"
15035,1,1,2,0.7630159151483767,"[1, 1, 1, 1, 0, 1, 1, 1, 0, 0]"
15036,1,1,2,0.9474384646261108,"[1, 1, 1, 1, 0, 1, 1, 1, 1, 0]"
15037,1,1,2,0.6971102627197022,"[0, 0, 1, 1, 0, 0, 1, 1, 1, 0]"
15038,1,1,2,0.5902235969698829,"[1, 0, 0, 0, 1, 0, 0, 1, 0, 1]"
15039,1,1,2,0.15018403970284544,"[1, 1, 0, 1, 0, 0, 0, 0, 1, 0]"
15040,1,1,2,0.3505258217062991,"[1, 1, 0, 0, 0, 0, 0, 1, 1, 0]"
15041,1,1,2,0.8465493427479849,"[1, 0, 0, 1, 1, 0, 1, 0, 0, 0]"
15042,1,1,2,0.632617018933454,"[1, 1, 0, 0, 0, 1, 1, 1, 0, 1]"
15043,1,1,2,0.8308525659096014,"[0, 0, 1, 1, 1, 0, 1, 0, 1, 0]"
15044,1,1,2,0.671319927494868,"[0, 0, 0, 0, 1, 1, 0, 1, 0, 0]"
15045,2,2,4,0.641958780399626,"[1, 0, 1, 1, 1, 1, 0, 1, 1, 1]"
15046,1,1,2,0.29477871282424895,"[0, 1, 0, 1, 1, 1, 1, 1, 1, 0]"
15047,1,1,2,0.2819635357598317,"[1, 1, 0, 0, 1, 0, 1, 1, 0, 1]"
15048,2,2,4,0.5759805855563761,"[1, 1, 0, 0, 0, 1, 1, 1, 1, 0]"
15049,1,1,2,0.7383966505504218,"[0, 1, 1, 1, 1, 0, 0, 0, 0, 0]"
15050,1,1,2,0.5807749733027354,"[0, 1, 1, 0, 0, 0, 1, 0, 1, 0]"
15051,1,1,2,0.9382321167574711,"[0, 0, 0, 1, 0, 0, 0, 0, 0, 1]"
15052,1,1,2,0.06330116871304348,"[1, 0, 1, 0, 1, 1, 1, 1, 0, 1]"
15053,1,1,2,0.07133446196768356,"[0, 0, 0, 0, 1, 0, 0, 0, 0, 1]"
15054,2,2,4,0.8608362817452482,"[0, 1, 1, 1, 1, 1, 0, 1, 1, 1]"
15055,1,1,2,0.5776031846970132,"[0, 0, 1, 1, 0, 0, 0, 0, 1, 0]"
15056,1,1,2,0.5642569547679813,"[1, 1, 0, 0, 0, 1, 0, 0, 0, 0]"
15057,1,1,2,0.9496464888789927,"[1, 0, 1, 1, 1, 0, 1, 1, 0, 1]"
15058,1,1,2,0.13251229542182275,"[1, 0, 0, 1, 1, 0, 1, 1, 1, 1]"
15059,1,1,2,0.8904812438037973,"[1, 0, 1, 1, 0, 0, 1, 1, 0, 0]"
15060,1,1,2,0.6652170679427035,"[0, 1, 0, 0, 0, 1, 0, 0, 1, 1]"
15061,1,1,2,0.7771379325659178,"[1, 0, 0, 0, 0, 0, 0, 0, 0, 1]"
15062,1,1,2,0.06115286963000288,"[0, 1, 1, 1, 0, 1, 0, 1, 1, 0]"
15063,1,1,2,0.8168217727916529,"[1, 0, 1, 1, 0, 1, 0, 1, 0, 0]"
15064,1,1,2,0.3281642784570773,"[1, 0, 1, 1, 0, 1, 1, 0, 0, 0]"
15065,1,1,2,0.6929826228168161,"[1, 0, 1, 1, 0, 1, 0, 0, 1, 1]"
15066,1,1,2,0.8082413900686515,"[1, 1, 1, 0, 0, 1, 0, 0, 1, 0]"
15067,1,1,2,0.9926509599236879,"[1, 1, 1, 1, 1, 0, 0, 0, 1, 1]"
15068,1,1,2,0.5496114159635959,"[0, 0, 1, 0, 0, 1, 1, 1, 1, 0]"
15069,1,1,2,0.7872044403499788,"[1, 1, 0, 1, 1, 1, 0, 0, 0, 0]"
15070,1,1,2,0.5349681321345592,"[0, 0, 0, 1, 1, 0, 0, 1, 0, 0]"
15071,1,1,2,0.5305632780749301,"[1, 0, 1, 0, 1, 0, 0, 0, 1, 0]"
15072,1,1,2,0.33679885309584057,"[0, 0, 1, 0, 1, 1, 0, 0, 0, 0]"
15073,1,1,2,0.3945450064026197,"[0, 0, 0, 0, 1, 1, 0, 1, 1, 1]"
15074,1,1,2,0.8168942730278455,"[0, 1, 0, 1, 0, 0, 0, 1, 1, 1]"
15075,1,1,2,0.5414098255841098,"[0, 0, 0, 1, 1, 1, 0, 1, 1, 0]"
15076,1,1,2,0.6414634935118674,"[0, 0, 1, 0, 1, 0, 0, 0, 0, 1]"
15077,1,1,2,0.6165357366541591,"[0, 0, 0, 1, 1, 0, 1, 1, 1, 1]"
15078,1,1,2,0.09622367537725873,"[0, 0, 1, 1, 0, 1, 1, 1, 1, 0]"
15079,1,1,2,0.48035875129208994,"[1, 1, 0, 1, 1, 0, 0, 1, 0, 0]"
15080,1,1,2,0.33877564905260893,"[1, 0, 1, 0, 1, 1, 0, 0, 0, 0]"
15081,1,1,2,0.4354229151547999,"[0, 1, 1, 1, 1, 0, 1, 1, 1, 1]"
15082,1,1,2,0.26788641040607974,"[0, 1, 0, 1, 0, 1, 1, 0, 1, 0]"
15083,1,1,2,0.538057688528262,"[0, 1, 0, 1, 0, 1, 0, 1, 1, 1]"
15084,2,2,4,0.46866898872423957,"[1, 1, 1, 0, 0, 1, 1, 0, 1, 0]"
15085,1,1,2,0.3430573756437699,"[1, 1, 1, 0, 1, 0, 0, 1, 0, 0]"
15086,1,1,2,0.3639327555592752,"[0, 0, 0, 0, 1, 1, 1, 1, 0, 1]"
15087,1,1,2,0.2421157120065962,"[0, 1, 1, 0, 0, 0, 0, 1, 0, 0]"
15088,1,1,2,0.9344266539010275,"[0, 1, 1, 0, 0, 1, 0, 1, 0, 0]"
15089,1,1,2,0.4977110290288964,"[0, 1, 0, 1, 0, 0, 0, 0, 1, 1]"
15090,1,1,2,0.7694382986058383,"[1, 1, 0, 0, 1, 0, 0, 1, 1, 0]"
15091,1,1,2,0.6189513372120837,"[0, 0, 1, 1, 0, 0, 0, 1, 0, 1]"
15092,1,1,2,0.8000759796141748,"[1, 0, 1, 0, 1, 0, 1, 0, 0, 0]"
15093,1,1,2,0.71447662305896,"[1, 0, 0, 1, 0, 0, 0, 0, 1, 0]"
15094,1,1,2,0.3885326942258993,"[0, 0, 1, 0, 0, 0, 1, 1, 0, 1]"
15095,1,1,2,0.5388047572673903,"[0, 0, 1, 0, 0, 1, 1, 0, 1, 0]"
15096,1,1,2,0.42951084701542286,"[1, 1, 0, 1, 0, 1, 0, 1, 0, 1]"
15097,1,1,2,0.15910996222512386,"[0, 1, 0, 0, 1, 1, 1, 0, 1, 1]"
15098,1,1,2,0.4371031456261476,"[0, 0, 1, 1, 0, 0, 0, 0, 1, 1]"
15099,1,1,2,0.5707051388511417,"[1, 0, 1, 0, 1, 0, 0, 1, 0, 1]"
15100,1,1,2,0.20983571083484676,"[1, 0, 1, 1, 0, 1, 1, 1, 0, 0]"
15101,1,1,2,0.9108901322726402,"[1, 0, 1, 1, 0, 1, 0, 1, 0, 1]"
15102,1,1,2,0.6531815690403378,"[1, 1, 1, 1, 0, 0, 0, 1, 1, 0]"
15103,1,1,2,0.19434006161882367,"[1, 1, 1, 1, 1, 1, 1, 1, 1, 0]"
15104,1,1,2,0.37919106113956136,"[1, 1, 0, 0, 1, 0, 0, 0, 1, 0]"
15105,1,1,2,0.3153699193534909,"[1, 1, 1, 0, 0, 1, 1, 0, 0, 1]"
15106,1,1,2,0.4221419460625958,"[0, 1, 1, 0, 0, 1, 1, 1, 1, 1]"
15107,1,1,2,0.6901735243290704,"[0, 0, 0, 0, 0, 0, 0, 0, 0, 1]"
15108,2,2,4,0.2790974796351857,"[1, 1, 1, 1, 1, 0, 0, 0, 1, 1]"
15109,1,1,2,0.03447765203841502,"[0, 1, 1, 0, 0, 1, 1, 1, 0, 0]"
15110,1,1,2,0.9270730499875822,"[0, 0, 1, 0, 1, 0, 0, 0, 1, 0]"
15111,1,1,2,0.24615877348922643,"[1, 0, 0, 1, 0, 0, 0, 1, 0, 0]"
15112,1,1,2,0.8394749055090129,"[1, 0, 0, 0, 1, 1, 1, 0, 1, 0]"
15113,1,1,2,0.9688543016093694,"[0, 0, 1, 1, 0, 1, 1, 0, 0, 0]"
15114,1,1,2,0.7396081267003277,"[0, 0, 0, 1, 1, 1, 0, 0, 0, 0]"
15115,1,1,2,0.17999984390642565,"[1, 0, 1, 0, 0, 0, 0, 0, 1, 1]"
15116,1,1,2,0.502135271495163,"[1, 0, 0, 0, 1, 1, 0, 1, 0, 1]"
15117,1,1,2,0.2956441949495401,"[1, 1, 0, 0, 1, 0, 0, 1, 1, 1]"
15118,1,1,2,0.6097475586437033,"[0, 0, 1, 1, 1, 1, 0, 0, 0, 0]"
15119,1,1,2,0.008060053016557323,"[0, 0, 0, 1, 1, 0, 0, 1, 0, 1]"
15120,1,1,2,0.6679066402204317,"[1, 1, 0, 0, 1, 0, 1, 0, 1, 1]"
15121,1,1,2,0.7157893748661411,"[1, 1, 0, 1, 1, 1, 0, 0, 0, 1]"
15122,2,2,4,0.6364841450010994,"[0, 1, 1, 0, 0, 1, 0, 1, 0, 1]"
15123,1,1,2,0.7808681361712698,"[1, 1, 1, 1, 0, 1, 0, 1, 1, 1]"
15124,2,2,4,0.6435106667080787,"[0, 0, 0, 0, 1, 1, 0, 1, 0, 0]"
15125,1,1,2,0.011164258824548412,"[1, 1, 1, 0, 0, 0, 0, 1, 1, 1]"
15126,1,1,2,0.7043939708589163,"[0, 0, 1, 0, 0, 1, 0, 1, 1, 1]"
15127,1,1,2,0.27795275502474315,"[1, 0, 1, 1, 0, 1, 1, 1, 1, 0]"
15128,1,1,2,0.7182286482995832,"[1, 1, 1, 1, 1, 0, 0, 0, 0, 0]"
15129,1,1,2,0.739515821926393,"[0, 1, 1, 0, 1, 0, 1, 0, 1, 0]"
15130,1,1,2,0.5835875472393595,"[0, 1, 1, 0, 0, 1, 0, 0, 1, 1]"
15131,1,1,2,0.4592229027492404,"[1, 0, 1, 1, 1, 0, 1, 1, 0, 0]"
15132,2,2,4,0.5963489271146993,"[1, 1, 1, 1, 1, 1, 1, 0, 0, 1]"
15133,1,1,2,0.5697835992690032,"[0, 1, 1, 0, 0, 1, 1, 1, 1, 1]"
15134,1,1,2,0.10179357956377721,"[1, 1, 1, 1, 0, 0, 1, 0, 0, 1]"
15135,2,2,4,0.5436518480497713,"[1, 1, 0, 1, 1, 1, 1, 1, 1, 0]"
15136,1,1,2,0.4651022814478146,"[0, 1, 1, 0, 1, 1, 0, 0, 1, 1]"
15137,2,2,4,0.477585102759126,"[1, 1, 0, 1, 1, 1, 1, 1, 1, 1]"
15138,1,1,2,0.4359382192207264,"[1, 1, 1, 1, 1, 1, 0, 0, 1, 1]"
15139,1,1,2,0.05242607701837376,"[1, 1, 0, 0, 0, 0, 0, 1, 1, 1]"
15140,1,1,2,0.4961324193095157,"[0, 1, 0, 0, 1, 0, 0, 0, 0, 0]"
15141,1,1,2,0.8213880990335957,"[0, 1, 0, 1, 1, 0, 0, 1, 0, 1]"
15142,1,1,2,0.7904407196365785,"[1, 1, 1, 1, 1, 1, 1, 0, 0, 1]"
15143,2,2,4,0.37413657221389074,"[0, 0, 0, 1, 0, 0, 1, 0, 0, 0]"
15144,1,1,2,0.2461928709094402,"[1, 1, 0, 0, 1, 0, 0, 1, 1, 1]"
15145,1,1,2,0.7886354766290963,"[1, 1, 1, 1, 0, 1, 1, 1, 1, 0]"
15146,1,1,2,0.1547409060552235,"[1, 1, 1, 0, 1, 0, 0, 0, 0, 0]"
15147,3,3,6,0.4203041085729672,"[1, 1, 0, 1, 1, 0, 1, 0, 1, 0]"
15148,1,1,2,0.6879719164927124,"[1, 0, 1, 0, 0, 1, 0, 1, 1, 1]"
15149,1,1,2,0.7847625580825022,"[0, 1, 0, 1, 0, 0, 0, 1, 0, 0]"
15150,2,2,4,0.05837160179499845,"[1, 1, 1, 0, 0, 1, 0, 0, 0, 1]"
15151,1,1,2,0.6176680917818966,"[0, 1, 0, 1, 0, 0, 1, 1, 0, 0]"
15152,1,1,2,0.8868238236057846,"[0, 1, 1, 0, 0, 0, 1, 1, 0, 0]"
15153,1,1,2,0.901935338066399,"[1, 0, 0, 1, 0, 0, 1, 0, 0, 1]"
15154,1,1,2,0.0392151940876565,"[0, 0, 0, 1, 0, 0, 1, 0, 0, 0]"
15155,1,1,2,0.35602702237888617,"[0, 1, 0, 0, 1, 1, 0, 0, 0, 0]"
15156,1,1,2,0.8008372967760988,"[1, 0, 0, 1, 1, 1, 0, 0, 0, 0]"
15157,1,1,2,0.21749823766437715,"[0, 0, 0, 1, 1, 1, 0, 1, 1, 0]"
15158,1,1,2,0.3479100281113757,"[1, 0, 0, 0, 1, 1, 1, 1, 0, 0]"
15159,1,1,2,0.9655616226914835,"[0, 0, 0, 0, 0, 1, 1, 0, 0, 1]"
15160,1,1,2,0.06637872790589816,"[0, 1, 0, 1, 1, 0, 0, 1, 0, 0]"
15161,1,1,2,0.8938627569699799,"[0, 0, 0, 0, 1, 1, 0, 1, 1, 0]"
15162,1,1,2,0.31219912728925114,"[0, 1, 0, 1, 1, 0, 0, 0, 1, 0]"
15163,2,2,4,0.8665379536066627,"[0, 1, 1, 1, 0, 0, 1, 1, 1, 1]"
15164,1,1,2,0.44817287031912323,"[0, 1, 1, 0, 1, 1, 1, 0, 1, 1]"
15165,1,1,2,0.5476993293029673,"[1, 1, 0, 0, 1, 1, 1, 1, 0, 0]"
15166,1,1,2,0.03160058170326463,"[0, 0, 0, 1, 0, 0, 0, 1, 0, 0]"
15167,3,3,6,0.9400621276421376,"[0, 0, 1, 1, 1, 0, 0, 1, 1, 1]"
15168,1,1,2,0.0728341274770723,"[0, 0, 1, 0, 0, 1, 1, 0, 0, 1]"
15169,1,1,2,0.7078849830222957,"[1, 1, 1, 1, 1, 0, 0, 0, 1, 0]"
15170,1,1,2,0.18687780074879823,"[1, 0, 1, 1, 0, 0, 0, 0, 0, 1]"
15171,1,1,2,0.5069908701440993,"[1, 0, 1, 1, 0, 0, 0, 0, 1, 1]"
15172,1,1,2,0.6722763153930849,"[1, 0, 1, 1, 1, 1, 1, 1, 0, 0]"
15173,1,1,2,0.6268308620664748,"[0, 1, 0, 0, 1, 0, 1, 0, 1, 0]"
15174,1,1,2,0.9508105984030446,"[0, 0, 0, 1, 1, 1, 0, 1, 0, 1]"
15175,1,1,2,0.22666591868093433,"[0, 0, 1, 1, 0, 1, 1, 1, 0, 0]"
15176,1,1,2,0.3922513652087003,"[0, 0, 0, 1, 0, 1, 0, 0, 1, 1]"
15177,1,1,2,0.6627883224171414,"[1, 0, 0, 1, 1, 1, 1, 0, 0, 1]"
15178,1,1,2,0.5766734374873886,"[1, 0, 1, 0, 0, 0, 1, 1, 1, 1]"
15179,1,1,2,0.0800916795272647,"[0, 1, 0, 0, 0, 0, 1, 0, 0, 1]"
15180,1,1,2,0.42506978828380293,"[0, 1, 1, 0, 1, 1, 0, 1, 0, 0]"
15181,1,1,2,0.857855509057938,"[0, 1, 1, 1, 0, 0, 0, 0, 1, 0]"
15182,1,1,2,0.17386041713312317,"[1, 1, 1, 0, 0, 0, 1, 0, 1, 0]"
15183,2,2,4,0.7484548003998766,"[0, 0, 0, 1, 0, 0, 1, 1, 1, 0]"
15184,1,1,2,0.12987833474214427,"[0, 1, 1, 0, 1, 1, 1, 0, 1, 0]"
15185,2,2,4,0.15891034264114556,"[1, 0, 0, 1, 0, 1, 1, 1, 0, 0]"
15186,1,1,2,0.9586226394452858,"[1, 0, 1, 0, 0, 0, 0, 1, 0, 1]"
15187,1,1,2,0.4811816191658932,"[1, 0, 1, 1, 1, 1, 0, 1, 0, 1]"
15188,1,1,2,0.24025847736409578,"[0, 1, 0, 1, 0, 1, 1, 0, 0, 0]"
15189,1,1,2,0.6025613365571582,"[1, 0, 0, 0, 0, 1, 0, 1, 1, 1]"
15190,1,1,2,0.8411742445884084,"[1, 0, 1, 1, 1, 1, 1, 1, 1, 0]"
15191,2,2,4,0.07111359348398816,"[0, 1, 0, 1, 1, 0, 0, 0, 0, 1]"
15192,1,1,2,0.007989047012737949,"[0, 1, 0, 1, 0, 0, 1, 0, 1, 1]"
15193,1,1,2,0.6587118625105599,"[1, 0, 0, 1, 1, 0, 0, 0, 0, 0]"
15194,1,1,2,0.5702179100037005,"[1, 0, 1, 0, 0, 0, 1, 1, 0, 1]"
15195,1,1,2,0.23188086015811482,"[1, 0, 1, 1, 0, 0, 1, 1, 1, 1]"
15196,2,2,4,0.28840600974847386,"[0, 1, 0, 1, 1, 1, 0, 1, 1, 0]"
15197,1,1,2,0.24054577772238572,"[0, 0, 1, 1, 0, 1, 1, 0, 1, 1]"
15198,1,1,2,0.49265603690108783,"[1, 0, 1, 0, 0, 0, 1, 1, 0, 0]"
15199,1,1,2,0.9626962720800686,"[0, 1, 1, 0, 0, 1, 0, 0, 1, 1]"
15200,2,2,4,0.8168878954523477,"[1, 1, 1, 0, 1, 0, 1, 0, 1, 0]"
15201,1,1,2,0.0876831824712132,"[0, 1, 0, 1, 1, 0, 1, 1, 1, 0]"
15202,1,1,2,0.36876172419674247,"[1, 1, 0, 0, 0, 0, 1, 1, 1, 0]"
15203,1,1,2,0.7134434324618478,"[1, 1, 1, 1, 0, 0, 0, 0, 0, 0]"
15204,2,2,4,0.4162845953771669,"[1, 1, 1, 1, 0, 1, 1, 0, 1, 1]"
15205,1,1,2,0.648997456895619,"[0, 0, 0, 0, 1, 1, 0, 1, 1, 1]"
15206,1,1,2,0.5363877587706194,"[1, 0, 1, 0, 1, 1, 1, 1, 0, 1]"
15207,1,1,2,0.08388587741434794,"[1, 0, 1, 0, 0, 1, 0, 1, 0, 1]"
15208,1,1,2,0.06713590327259067,"[0, 1, 0, 0, 1, 1, 1, 1, 1, 1]"
15209,1,1,2,0.4563056227622495,"[1, 0, 1, 1, 0, 0, 1, 0, 1, 0]"
15210,1,1,2,0.7341952862682666,"[1, 0, 0, 1, 0, 0, 1, 0, 0, 0]"
15211,2,2,4,0.02874095792108866,"[1, 0, 0, 0, 1, 0, 1, 0, 0, 0]"
15212,1,1,2,0.4968680006353531,"[1, 0, 1, 0, 0, 0, 0, 0, 0, 1]"
15213,2,2,4,0.42315727087422117,"[0, 1, 1, 0, 1, 1, 1, 1, 1, 0]"
15214,2,2,4,0.7748746575813819,"[1, 1, 0, 0, 0, 1, 1, 1, 0, 0]"
15215,1,1,2,0.9403882962241975,"[0, 1, 1, 1, 0, 1, 0, 0, 0, 0]"
15216,1,1,2,0.9951778661320566,"[0, 1, 0, 1, 1, 1, 1, 1, 0, 0]"
15217,1,1,2,0.8105901367582448,"[1, 0, 1, 1, 1, 0, 1, 0, 1, 1]"
15218,1,1,2,0.9045000947832119,"[1, 1, 1, 1, 0, 1, 1, 0, 0, 1]"
15219,1,1,2,0.5528269778623249,"[1, 1, 0, 0, 0, 0, 1, 0, 0, 0]"
15220,1,1,2,0.221209171451215,"[1, 1, 1, 0, 0, 1, 1, 0, 0, 1]"
15221,1,1,2,0.5973326350062642,"[1, 1, 1, 0, 1, 1, 1, 0, 0, 0]"
15222,1,1,2,0.16005371029359194,"[0, 1, 0, 0, 0, 0, 1, 0, 0, 1]"
15223,2,2,4,0.07604495601824446,"[0, 1, 1, 1, 1, 1, 1, 1, 0, 0]"
15224,1,1,2,0.9110973454374386,"[1, 0, 0, 1, 1, 1, 1, 1, 1, 0]"
15225,1,1,2,0.07162716245622403,"[1, 1, 1, 0, 1, 1, 0, 0, 0, 0]"
15226,1,1,2,0.37790175132135195,"[0, 1, 0, 0, 1, 1, 1, 0, 1, 0]"
15227,1,1,2,0.33284965607415284,"[0, 0, 0, 0, 0, 1, 1, 1, 1, 0]"
15228,1,1,2,0.5990812307575317,"[0, 0, 1, 0, 1, 1, 1, 0, 1, 1]"
15229,2,2,4,0.9055063270761718,"[1, 0, 0, 0, 1, 0, 1, 1, 1, 0]"
15230,1,1,2,0.49987446004737657,"[1, 0, 0, 0, 1, 0, 1, 1, 1, 1]"
15231,1,1,2,0.31889385565486095,"[1, 1, 0, 0, 1, 0, 1, 0, 1, 0]"
15232,1,1,2,0.6825523959423357,"[1, 0, 1, 0, 0, 0, 1, 1, 0, 1]"
15233,1,1,2,0.127193504621522,"[1, 0, 1, 1, 0, 1, 0, 0, 0, 1]"
15234,1,1,2,0.1925277514239283,"[1, 0, 0, 1, 0, 0, 0, 0, 1, 1]"
15235,1,1,2,0.3284914246908418,"[0, 1, 1, 0, 0, 1, 1, 1, 0, 1]"
15236,1,1,2,0.1020803914063263,"[1, 1, 0, 0, 1, 1, 0, 0, 0, 0]"
15237,2,2,4,0.2648532326460017,"[1, 0, 1, 0, 1, 0, 1, 1, 1, 0]"
15238,1,1,2,0.5895521745707308,"[1, 1, 0, 0, 0, 0, 1, 1, 0, 1]"
15239,1,1,2,0.8363703542736843,"[0, 1, 1, 1, 0, 0, 0, 1, 0, 1]"
15240,1,1,2,0.3057222341510909,"[0, 1, 1, 0, 1, 0, 0, 0, 0, 1]"
15241,1,1,2,0.04009694902431893,"[1, 1, 1, 1, 0, 0, 0, 0, 0, 0]"
15242,1,1,2,0.7498955610434371,"[1, 1, 1, 1, 0, 0, 0, 0, 1, 1]"
15243,1,1,2,0.32448334522744804,"[0, 0, 0, 1, 0, 0, 1, 0, 0, 0]"
15244,1,1,2,0.08777008365953465,"[0, 1, 1, 0, 0, 1, 1, 0, 1, 1]"
15245,1,1,2,0.6133197646376918,"[0, 0, 0, 1, 1, 1, 0, 1, 0, 0]"
15246,1,1,2,0.8855220817020895,"[1, 1, 0, 0, 0, 1, 0, 1, 1, 1]"
15247,1,1,2,0.11808825140569357,"[1, 0, 0, 0, 1, 1, 0, 0, 1, 0]"
15248,2,2,4,0.7622474161582027,"[1, 1, 1, 0, 1, 0, 1, 0, 0, 1]"
15249,1,1,2,0.6878024195682692,"[0, 1, 0, 1, 1, 1, 0, 1, 0, 0]"
15250,1,1,2,0.26451334748475164,"[0, 1, 0, 1, 0, 1, 1, 0, 0, 0]"
15251,1,1,2,0.07849792122432309,"[0, 0, 0, 1, 1, 1, 1, 1, 1, 1]"
15252,1,1,2,0.2611349921751852,"[0, 1, 1, 0, 1, 0, 1, 1, 1, 1]"
15253,1,1,2,0.5839442361205346,"[0, 1, 1, 0, 1, 0, 1, 1, 1, 1]"
15254,1,1,2,0.26969260249292304,"[0, 0, 1, 1, 0, 0, 1, 0, 0, 0]"
15255,1,1,2,0.9526136986146095,"[1, 0, 0, 0, 0, 1, 1, 0, 0, 1]"
15256,1,1,2,0.03140637527031409,"[1, 1, 1, 0, 0, 0, 0, 1, 0, 0]"
15257,1,1,2,0.3674254136421128,"[1, 1, 1, 1, 0, 1, 1, 1, 0, 0]"
15258,1,1,2,0.21596721564483845,"[0, 0, 1, 1, 0, 0, 1, 1, 0, 0]"
15259,1,1,2,0.29435112260966567,"[1, 1, 1, 1, 0, 0, 1, 0, 1, 0]"
15260,2,2,4,0.9158466978158175,"[1, 0, 1, 0, 0, 1, 1, 1, 1, 1]"
15261,1,1,2,0.4353719507880306,"[1, 1, 1, 1, 0, 1, 1, 1, 1, 0]"
15262,1,1,2,0.06388641635612524,"[0, 0, 0, 0, 1, 1, 1, 0, 0, 1]"
15263,1,1,2,0.045166621061992096,"[0, 1, 1, 1, 0, 1, 1, 0, 0, 1]"
15264,1,1,2,0.4305256254937705,"[0, 0, 1, 0, 1, 1, 0, 1, 0, 1]"
15265,1,1,2,0.7985477021862656,"[0, 0, 0, 1, 1, 1, 0, 0, 0, 0]"
15266,1,1,2,0.45767652398115155,"[0, 1, 1, 0, 1, 1, 1, 1, 1, 0]"
15267,1,1,2,0.6072966079899825,"[1, 1, 1, 1, 1, 0, 0, 0, 1, 0]"
15268,3,3,6,0.42054354782148595,"[1, 0, 0, 0, 0, 1, 1, 1, 1, 1]"
15269,1,1,2,0.26640191582988737,"[0, 0, 0, 0, 0, 0, 1, 1, 0, 0]"
15270,1,1,2,0.015317697610080061,"[0, 1, 0, 0, 0, 1, 0, 0, 0, 1]"
15271,1,1,2,0.860756683531729,"[0, 0, 0, 0, 0, 0, 1, 0, 0, 0]"
15272,1,1,2,0.006617514175984773,"[1, 1, 0, 0, 1, 0, 1, 0, 0, 1]"
15273,1,1,2,0.18551149562542502,"[0, 0, 1, 0, 0, 1, 0, 0, 0, 0]"
15274,1,1,2,0.8300147394096336,"[1, 1, 1, 0, 0, 1, 0, 0, 0, 0]"
15275,1,1,2,0.7923967680615155,"[0, 0, 1, 0, 1, 1, 1, 1, 0, 1]"
15276,1,1,2,0.3475908496378065,"[0, 1, 0, 0, 1, 0, 0, 1, 0, 1]"
15277,1,1,2,0.9932889380322054,"[1, 1, 0, 0, 1, 0, 0, 0, 1, 1]"
15278,1,1,2,0.6441489813651665,"[1, 0, 1, 1, 1, 1, 0, 0, 1, 0]"
15279,1,1,2,0.7806110753484218,"[0, 0, 1, 1, 1, 0, 0, 1, 0, 0]"
15280,1,1,2,0.08625792586076264,"[1, 1, 1, 1, 1, 0, 1, 0, 0, 0]"
15281,2,2,4,0.9224341368570701,"[0, 1, 1, 0, 1, 1, 1, 1, 1, 1]"
15282,1,1,2,0.691230872929954,"[1, 0, 1, 1, 0, 0, 0, 0, 0, 1]"
15283,1,1,2,0.1349178815893971,"[1, 0, 0, 0, 0, 1, 1, 1, 1, 0]"
15284,1,1,2,0.5267972012678691,"[1, 0, 1, 0, 1, 0, 0, 1, 0, 0]"
15285,2,2,4,0.00217028647097961,"[0, 1, 1, 1, 1, 0, 1, 0, 1, 1]"
15286,1,1,2,0.5406346717346255,"[0, 0, 0, 0, 0, 1, 1, 1, 1, 0]"
15287,1,1,2,0.22877413788981582,"[0, 1, 0, 1, 1, 1, 1, 0, 1, 0]"
15288,1,1,2,0.4299368033516465,"[0, 0, 0, 1, 1, 0, 0, 0, 1, 0]"
15289,1,1,2,0.6830459011140453,"[1, 0, 0, 0, 0, 1, 0, 1, 1, 1]"
15290,1,1,2,0.21891049961475006,"[0, 1, 0, 1, 0, 0, 1, 0, 1, 0]"
15291,1,1,2,0.756454792972124,"[0, 0, 1, 0, 0, 0, 1, 1, 0, 0]"
15292,1,1,2,0.5031860473302382,"[0, 1, 0, 1, 0, 0, 1, 0, 0, 1]"
15293,1,1,2,0.5809939186694111,"[0, 0, 0, 1, 1, 0, 0, 1, 0, 0]"
15294,1,1,2,0.48306184820531217,"[0, 0, 0, 0, 0, 0, 1, 0, 1, 0]"
15295,1,1,2,0.5412888389335367,"[1, 1, 1, 0, 0, 1, 0, 1, 0, 0]"
15296,1,1,2,0.1847852098253201,"[1, 0, 0, 0, 0, 1, 1, 1, 1, 1]"
15297,1,1,2,0.43432114031701063,"[0, 0, 1, 1, 1, 1, 1, 1, 0, 0]"
15298,1,1,2,0.7269987792061494,"[1, 0, 1, 0, 1, 0, 1, 0, 0, 1]"
15299,2,2,4,0.2745396805609962,"[0, 1, 1, 1, 0, 0, 1, 0, 1, 1]"
15300,1,1,2,0.04391449592313246,"[1, 0, 1, 1, 1, 1, 0, 0, 0, 1]"
15301,1,1,2,0.0049367731768728,"[0, 0, 0, 0, 0, 1, 1, 0, 1, 1]"
15302,1,1,2,0.25983504605366137,"[0, 0, 1, 1, 0, 1, 0, 1, 1, 1]"
15303,1,1,2,0.6994472115019198,"[0, 0, 0, 1, 0, 0, 0, 1, 1, 1]"
15304,1,1,2,0.5253075723073654,"[1, 1, 1, 0, 0, 1, 1, 1, 1, 1]"
15305,1,1,2,0.614360476844664,"[0, 1, 0, 1, 1, 0, 0, 1, 0, 0]"
15306,1,1,2,0.4983793932240924,"[1, 0, 0, 0, 0, 1, 1, 1, 1, 1]"
15307,1,1,2,0.6301722484325464,"[0, 1, 1, 1, 1, 1, 0, 0, 1, 1]"
15308,1,1,2,0.11624611069441337,"[1, 0, 1, 1, 0, 1, 0, 0, 1, 1]"
15309,1,1,2,0.6087314079820824,"[1, 0, 1, 1, 0, 1, 0, 0, 0, 0]"
15310,3,3,6,0.09954092440462714,"[0, 0, 0, 1, 1, 0, 1, 1, 0, 0]"
15311,1,1,2,0.43611037755721116,"[0, 0, 0, 0, 1, 1, 0, 1, 1, 1]"
15312,1,1,2,0.9985218427633581,"[0, 1, 0, 1, 0, 1, 0, 1, 0, 0]"
15313,1,1,2,0.13109854786856956,"[0, 1, 1, 1, 0, 1, 1, 1, 1, 0]"
15314,1,1,2,0.3280534703134852,"[0, 1, 1, 1, 1, 1, 0, 1, 1, 0]"
15315,1,1,2,0.6481650272587149,"[1, 1, 1, 0, 1, 0, 1, 0, 0, 0]"
15316,1,1,2,0.32555587681349696,"[1, 0, 1, 0, 1, 1, 1, 0, 1, 1]"
15317,2,2,4,0.12204710948634323,"[1, 0, 1, 0, 0, 1, 1, 0, 1, 1]"
15318,2,2,4,0.2593112535714448,"[0, 1, 1, 1, 1, 1, 1, 1, 0, 0]"
15319,2,2,4,0.2525267887915844,"[1, 1, 0, 1, 0, 1, 0, 1, 0, 1]"
15320,1,1,2,0.2201615144164566,"[1, 0, 1, 1, 1, 0, 0, 1, 0, 1]"
15321,1,1,2,0.26165834726008597,"[0, 0, 1, 1, 0, 0, 1, 1, 1, 1]"
15322,1,1,2,0.8947865892072796,"[1, 1, 1, 0, 1, 1, 0, 1, 1, 1]"
15323,1,1,2,0.29891492394070573,"[0, 1, 0, 1, 1, 1, 0, 1, 1, 0]"
15324,1,1,2,0.8077382416331951,"[0, 1, 0, 0, 1, 1, 1, 0, 0, 1]"
15325,1,1,2,0.6604712790498234,"[0, 0, 1, 0, 0, 1, 1, 0, 1, 1]"
15326,1,1,2,0.8617030205161019,"[0, 1, 1, 1, 0, 0, 0, 1, 0, 0]"
15327,1,1,2,0.4277923190562335,"[1, 0, 1, 1, 0, 1, 1, 1, 0, 0]"
15328,1,1,2,0.26947283919322484,"[1, 1, 1, 1, 1, 0, 0, 0, 1, 1]"
15329,1,1,2,0.15878939505530065,"[0, 1, 1, 0, 1, 0, 0, 0, 0, 1]"
15330,1,1,2,0.7655629993728649,"[0, 1, 1, 1, 0, 1, 0, 0, 1, 0]"
15331,2,2,4,0.7229590776844497,"[1, 0, 0, 1, 0, 1, 0, 1, 0, 1]"
15332,1,1,2,0.9340742835213305,"[1, 0, 0, 1, 1, 0, 1, 1, 0, 0]"
15333,1,1,2,0.15515591007513496,"[1, 0, 0, 1, 0, 1, 1, 0, 1, 1]"
15334,1,1,2,0.8497722802360835,"[1, 1, 0, 0, 0, 0, 1, 0, 0, 0]"
15335,1,1,2,0.6686959921652822,"[1, 0, 0, 1, 1, 1, 0, 0, 0, 0]"
15336,1,1,2,0.04521405888943031,"[0, 0, 1, 0, 1, 0, 1, 0, 1, 1]"
15337,1,1,2,0.7814164425635328,"[1, 0, 0, 1, 0, 0, 1, 1, 0, 0]"
15338,1,1,2,0.27102931559936205,"[1, 1, 1, 0, 0, 0, 0, 1, 0, 1]"
15339,1,1,2,0.9611149062275018,"[0, 0, 0, 1, 1, 1, 1, 0, 0, 0]"
15340,1,1,2,0.11953705339735887,"[1, 1, 1, 1, 1, 0, 0, 0, 1, 0]"
15341,1,1,2,0.4395504959491179,"[0, 1, 1, 0, 1, 0, 0, 1, 1, 1]"
15342,1,1,2,0.6412656117802578,"[0, 0, 1, 1, 1, 1, 1, 1, 1, 0]"
15343,1,1,2,0.776256710637217,"[0, 1, 1, 1, 1, 1, 1, 1, 0, 1]"
15344,2,2,4,0.5267319698260744,"[0, 1, 0, 1, 0, 1, 1, 0, 1, 1]"
15345,2,2,4,0.03655961352374326,"[1, 0, 0, 0, 0, 1, 0, 0, 0, 1]"
15346,1,1,2,0.8304491443388061,"[1, 1, 1, 0, 0, 1, 1, 1, 1, 0]"
15347,1,1,2,0.47032347023732934,"[1, 1, 1, 0, 0, 1, 0, 1, 1, 0]"
15348,1,1,2,0.614929570336934,"[0, 1, 1, 0, 0, 0, 1, 0, 0, 0]"
15349,1,1,2,0.4091012718204835,"[1, 0, 1, 0, 1, 1, 1, 1, 0, 1]"
15350,1,1,2,0.3359056561259596,"[1, 1, 0, 1, 0, 1, 1, 0, 0, 0]"
15351,1,1,2,0.899306122025497,"[1, 1, 0, 1, 0, 1, 1, 1, 1, 1]"
15352,1,1,2,0.33714449066196406,"[1, 0, 0, 0, 0, 0, 1, 0, 1, 0]"
15353,1,1,2,0.3469329714517273,"[0, 0, 0, 1, 1, 0, 0, 0, 1, 0]"
15354,1,1,2,0.41950994329972024,"[0, 1, 0, 1, 0, 1, 1, 0, 0, 0]"
15355,1,1,2,0.6367694632532981,"[0, 0, 0, 0, 1, 1, 1, 1, 1, 0]"
15356,2,2,4,0.1782723132697046,"[1, 0, 1, 1, 0, 0, 0, 0, 1, 1]"
15357,1,1,2,0.6573090399364622,"[1, 0, 1, 1, 0, 0, 1, 0, 0, 0]"
15358,1,1,2,0.24285129495894597,"[0, 1, 0, 0, 0, 1, 0, 1, 1, 1]"
15359,1,1,2,0.2834701598411966,"[1, 1, 1, 1, 1, 1, 1, 0, 1, 1]"
15360,1,1,2,0.7379608795426392,"[1, 0, 0, 1, 1, 0, 1, 1, 1, 1]"
15361,1,1,2,0.14222220945732322,"[1, 1, 0, 0, 1, 1, 1, 0, 1, 0]"
15362,3,3,6,0.21676206499725892,"[0, 1, 1, 0, 1, 0, 0, 1, 1, 1]"
15363,1,1,2,0.3221148053373163,"[0, 0, 0, 1, 0, 1, 1, 1, 1, 1]"
15364,1,1,2,0.2629511153119676,"[0, 0, 0, 1, 0, 1, 0, 1, 0, 1]"
15365,1,1,2,0.2788457820232738,"[1, 1, 1, 0, 1, 1, 0, 0, 1, 0]"
15366,1,1,2,0.34158994273707577,"[0, 1, 0, 0, 0, 1, 0, 0, 0, 1]"
15367,1,1,2,0.18191154360198025,"[0, 1, 1, 1, 0, 1, 0, 1, 1, 1]"
15368,1,1,2,0.5275143634771877,"[0, 1, 0, 0, 1, 0, 0, 0, 1, 0]"
15369,1,1,2,0.01745974627349578,"[0, 0, 0, 1, 1, 1, 1, 1, 0, 1]"
15370,1,1,2,0.5820701716360287,"[0, 1, 1, 0, 0, 0, 0, 0, 1, 1]"
15371,1,1,2,0.28648243067259216,"[0, 0, 0, 0, 0, 0, 0, 0, 1, 0]"
15372,1,1,2,0.28519473120145844,"[1, 0, 1, 1, 1, 1, 0, 0, 1, 1]"
15373,1,1,2,0.3746100825467875,"[1, 1, 1, 1, 0, 0, 1, 0, 1, 0]"
15374,1,1,2,0.9762470771837102,"[0, 1, 0, 0, 0, 1, 1, 1, 0, 1]"
15375,1,1,2,0.5458910923002909,"[0, 1, 1, 1, 1, 1, 1, 0, 1, 0]"
15376,1,1,2,0.4842491188084026,"[1, 1, 0, 0, 0, 1, 0, 1, 0, 0]"
15377,1,1,2,0.5530978602666814,"[1, 1, 1, 1, 0, 1, 1, 0, 0, 0]"
15378,1,1,2,0.8162688688078895,"[1, 1, 0, 0, 1, 1, 0, 0, 1, 1]"
15379,1,1,2,0.5741810632530715,"[0, 0, 1, 1, 1, 1, 0, 1, 1, 0]"
15380,1,1,2,0.6060183616111638,"[1, 1, 0, 0, 1, 0, 1, 0, 0, 1]"
15381,1,1,2,0.43692370580206275,"[0, 0, 0, 0, 0, 1, 0, 0, 1, 1]"
15382,1,1,2,0.19924624560735327,"[0, 0, 0, 1, 1, 0, 0, 0, 0, 1]"
15383,1,1,2,0.25461099806058984,"[0, 0, 1, 1, 1, 0, 1, 0, 1, 1]"
15384,1,1,2,0.8579313240575565,"[0, 0, 0, 1, 1, 0, 0, 0, 0, 0]"
15385,1,1,2,0.7465608446729716,"[0, 0, 0, 0, 1, 1, 0, 1, 1, 1]"
15386,1,1,2,0.8877356321223949,"[0, 0, 1, 0, 0, 0, 0, 1, 1, 1]"
15387,1,1,2,0.651791074204458,"[1, 1, 0, 0, 0, 0, 1, 0, 1, 1]"
15388,1,1,2,0.036185086508362274,"[0, 1, 1, 1, 0, 1, 1, 1, 0, 0]"
15389,2,2,4,0.7412930941987366,"[1, 1, 1, 0, 1, 0, 0, 0, 1, 0]"
15390,1,1,2,0.42564722021730994,"[0, 0, 0, 1, 0, 1, 1, 1, 1, 0]"
15391,1,1,2,0.9476209118116152,"[1, 0, 0, 1, 0, 0, 1, 1, 0, 0]"
15392,1,1,2,0.6875171699911232,"[0, 0, 0, 1, 1, 1, 1, 0, 0, 1]"
15393,1,1,2,0.3531673039805948,"[1, 1, 0, 1, 0, 1, 1, 0, 1, 0]"
15394,1,1,2,0.7648532529095987,"[1, 1, 1, 1, 0, 1, 1, 1, 1, 1]"
15395,1,1,2,0.5475927978678746,"[0, 0, 0, 0, 1, 1, 0, 0, 0, 0]"
15396,1,1,2,0.3187343087524642,"[1, 0, 1, 1, 1, 0, 0, 0, 0, 1]"
15397,1,1,2,0.01697478377495798,"[1, 0, 1, 0, 0, 1, 1, 1, 0, 1]"
15398,1,1,2,0.5668165898460986,"[1, 0, 0, 0, 1, 1, 1, 0, 1, 1]"
15399,1,1,2,0.0012529762283041146,"[1, 1, 1, 1, 1, 1, 0, 1, 1, 0]"
15400,1,1,2,0.8704143606272553,"[0, 0, 0, 1, 1, 1, 1, 0, 1, 1]"
15401,1,1,2,0.7468827916711316,"[0, 1, 0, 1, 1, 1, 1, 1, 0, 0]"
15402,1,1,2,0.48693664802968395,"[1, 0, 0, 0, 0, 1, 0, 0, 0, 0]"
15403,1,1,2,0.6334787897358253,"[1, 0, 1, 0, 0, 0, 0, 1, 1, 0]"
15404,1,1,2,0.4254368031881156,"[0, 0, 1, 1, 0, 1, 0, 0, 0, 0]"
15405,1,1,2,0.7880391071396994,"[1, 0, 0, 0, 0, 0, 1, 1, 1, 1]"
15406,1,1,2,0.22159676480605361,"[1, 1, 1, 1, 0, 0, 0, 1, 0, 1]"
15407,1,1,2,0.4267750901128051,"[0, 1, 0, 1, 1, 1, 0, 1, 0, 1]"
15408,1,1,2,0.9742933629585847,"[1, 1, 1, 0, 1, 0, 1, 1, 0, 0]"
15409,1,1,2,0.25909391985556807,"[1, 0, 1, 0, 0, 0, 0, 1, 1, 0]"
15410,1,1,2,0.11052194739543542,"[1, 0, 0, 1, 1, 1, 1, 0, 1, 1]"
15411,2,2,4,0.14311354231284767,"[1, 1, 1, 1, 0, 1, 0, 1, 0, 0]"
15412,1,1,2,0.9307394744125863,"[0, 0, 0, 0, 0, 0, 1, 1, 0, 0]"
15413,1,1,2,0.7848807516904186,"[1, 1, 0, 0, 0, 1, 1, 1, 1, 1]"
15414,1,1,2,0.9600678743049584,"[1, 0, 1, 0, 1, 1, 0, 1, 0, 0]"
15415,1,1,2,0.458156740234996,"[0, 0, 0, 1, 1, 0, 1, 1, 1, 1]"
15416,1,1,2,0.34743437524825294,"[1, 1, 0, 1, 1, 0, 0, 1, 0, 0]"
15417,1,1,2,0.25400555010873416,"[0, 0, 1, 0, 0, 0, 0, 1, 0, 1]"
15418,1,1,2,0.6170612348827422,"[0, 1, 0, 0, 1, 0, 1, 0, 0, 0]"
15419,1,1,2,0.8577865650707464,"[1, 1, 0, 1, 1, 0, 0, 1, 1, 1]"
15420,1,1,2,0.38509138584156444,"[0, 1, 1, 1, 1, 1, 0, 1, 1, 0]"
15421,1,1,2,0.1641585115309332,"[1, 1, 0, 0, 1, 1, 0, 1, 1, 0]"
15422,1,1,2,0.769469683828281,"[0, 1, 1, 1, 0, 0, 1, 1, 0, 1]"
15423,1,1,2,0.2514719877747331,"[1, 1, 0, 0, 0, 1, 1, 0, 1, 1]"
15424,1,1,2,0.5569619059122564,"[0, 1, 1, 0, 0, 1, 1, 0, 1, 0]"
15425,1,1,2,0.8549277504169112,"[0, 0, 1, 1, 0, 1, 1, 0, 0, 0]"
15426,1,1,2,0.7049144589397153,"[1, 0, 0, 1, 0, 0, 0, 0, 0, 0]"
15427,1,1,2,0.3627007290094242,"[0, 1, 0, 1, 0, 0, 0, 0, 0, 0]"
15428,1,1,2,0.026718615298670034,"[0, 0, 1, 1, 0, 0, 0, 1, 1, 0]"
15429,1,1,2,0.9371827159563281,"[0, 1, 0, 1, 0, 0, 1, 0, 1, 0]"
15430,1,1,2,0.9141918381668419,"[1, 0, 0, 1, 1, 0, 0, 0, 0, 1]"
15431,1,1,2,0.48428696966312024,"[1, 1, 0, 0, 0, 1, 0, 0, 1, 1]"
15432,1,1,2,0.5329886478109999,"[1, 1, 1, 0, 1, 1, 1, 0, 0, 1]"
15433,1,1,2,0.45139903615291066,"[1, 1, 1, 1, 1, 1, 0, 0, 1, 1]"
15434,3,3,6,0.8387660682849809,"[1, 0, 1, 0, 1, 1, 0, 1, 1, 1]"
15435,1,1,2,0.3836754980569961,"[1, 0, 0, 0, 0, 1, 1, 0, 0, 1]"
15436,1,1,2,0.8162415446131122,"[0, 0, 1, 1, 1, 0, 0, 1, 0, 0]"
15437,1,1,2,0.7224518740911956,"[0, 1, 1, 1, 1, 1, 1, 0, 1, 1]"
15438,1,1,2,0.6239061123196283,"[1, 1, 0, 1, 0, 1, 1, 1, 1, 1]"
15439,2,2,4,0.9089611097782245,"[0, 1, 1, 1, 0, 1, 0, 0, 0, 0]"
15440,1,1,2,0.3986110567462561,"[0, 0, 1, 0, 1, 1, 1, 0, 0, 0]"
15441,1,1,2,0.9714624195574804,"[1, 1, 1, 1, 0, 1, 0, 1, 0, 1]"
15442,1,1,2,0.35292547595419044,"[0, 0, 1, 0, 0, 1, 1, 1, 1, 0]"
15443,1,1,2,0.07006271493436145,"[0, 1, 1, 1, 1, 1, 0, 0, 1, 0]"
15444,1,1,2,0.32215110231529676,"[0, 1, 0, 0, 0, 0, 1, 1, 1, 0]"
15445,1,1,2,0.3985464736909967,"[1, 0, 0, 1, 1, 0, 0, 1, 1, 1]"
15446,1,1,2,0.3161938356503943,"[0, 0, 1, 1, 0, 0, 1, 1, 0, 0]"
15447,1,1,2,0.8256737059150236,"[1, 1, 0, 1, 1, 1, 0, 1, 1, 1]"
15448,1,1,2,0.8869622590964311,"[0, 0, 1, 0, 0, 0, 0, 0, 0, 1]"
15449,1,1,2,0.0819162732741574,"[1, 0, 1, 0, 1, 0, 0, 0, 0, 0]"
15450,1,1,2,0.13876730883177868,"[0, 0, 1, 1, 0, 0, 0, 1, 0, 0]"
15451,1,1,2,0.6520157485642716,"[0, 0, 0, 1, 0, 1, 0, 0, 1, 1]"
15452,1,1,2,0.2626140998680103,"[0, 0, 1, 1, 1, 1, 1, 0, 0, 0]"
15453,1,1,2,0.5405248506225914,"[1, 0, 1, 0, 1, 1, 1, 1, 0, 0]"
15454,1,1,2,0.5447243906431647,"[0, 1, 0, 0, 0, 1, 1, 0, 1, 1]"
15455,1,1,2,0.42092001464058393,"[1, 0, 1, 1, 1, 1, 0, 1, 0, 1]"
15456,1,1,2,0.10075259390231417,"[1, 0, 0, 0, 0, 1, 1, 0, 1, 1]"
15457,1,1,2,0.8798189581744874,"[1, 0, 0, 0, 0, 1, 1, 0, 0, 0]"
15458,1,1,2,0.6193093613862273,"[1, 0, 0, 1, 0, 1, 1, 0, 1, 0]"
15459,1,1,2,0.6251470314327499,"[0, 0, 1, 0, 1, 1, 1, 0, 1, 1]"
15460,1,1,2,0.7531464605651612,"[0, 1, 0, 1, 1, 1, 0, 0, 0, 0]"
15461,1,1,2,0.2760167781536068,"[1, 0, 1, 1, 1, 1, 1, 0, 0, 0]"
15462,1,1,2,0.062416755113155475,"[0, 0, 1, 0, 1, 0, 1, 0, 1, 0]"
15463,1,1,2,0.7793031280977116,"[1, 0, 0, 1, 1, 1, 0, 0, 0, 0]"
15464,1,1,2,0.8923584359385933,"[0, 1, 1, 1, 1, 0, 0, 1, 1, 0]"
15465,1,1,2,0.7667590995220346,"[1, 1, 1, 0, 1, 0, 1, 0, 0, 0]"
15466,1,1,2,0.7182530613344905,"[0, 1, 0, 1, 1, 1, 0, 0, 0, 1]"
15467,1,1,2,0.37975455151413706,"[0, 1, 1, 1, 1, 1, 1, 1, 1, 1]"
15468,1,1,2,0.6685835842526231,"[0, 1, 1, 1, 1, 0, 0, 1, 0, 1]"
15469,1,1,2,0.7489457140780587,"[0, 0, 1, 1, 1, 0, 1, 1, 0, 0]"
15470,1,1,2,0.22387283802800628,"[1, 0, 1, 1, 0, 1, 0, 1, 1, 0]"
15471,1,1,2,0.3625582894203794,"[1, 1, 1, 0, 0, 1, 1, 1, 1, 0]"
15472,1,1,2,0.6039687216799388,"[0, 0, 0, 1, 1, 0, 1, 0, 1, 1]"
15473,1,1,2,0.9986663642910022,"[0, 1, 0, 0, 0, 0, 1, 1, 1, 0]"
15474,2,2,4,0.9598460901633235,"[1, 1, 0, 0, 0, 0, 1, 0, 1, 1]"
15475,1,1,2,0.9312364704330057,"[0, 1, 0, 0, 0, 0, 0, 0, 1, 1]"
15476,1,1,2,0.36341051435434146,"[0, 0, 0, 0, 1, 1, 0, 0, 0, 0]"
15477,1,1,2,0.5471650111359452,"[1, 0, 0, 0, 1, 1, 1, 0, 1, 0]"
15478,1,1,2,0.09449749094614879,"[0, 1, 0, 0, 1, 0, 0, 0, 1, 0]"
15479,1,1,2,0.7631113293456965,"[0, 0, 1, 1, 0, 1, 1, 1, 1, 0]"
15480,1,1,2,0.2574592798908023,"[0, 1, 0, 0, 0, 0, 1, 1, 1, 1]"
15481,1,1,2,0.1424537308389513,"[1, 0, 0, 1, 1, 1, 1, 1, 0, 0]"
15482,1,1,2,0.6956638598237801,"[1, 0, 1, 1, 0, 1, 0, 0, 1, 0]"
15483,2,2,4,0.8276980114311439,"[1, 1, 0, 1, 0, 1, 1, 1, 1, 0]"
15484,2,2,4,0.5086571308610841,"[0, 1, 0, 1, 1, 1, 1, 1, 1, 1]"
15485,1,1,2,0.030713186033473616,"[1, 1, 0, 1, 0, 0, 1, 1, 1, 0]"
15486,1,1,2,0.03684768024568841,"[0, 0, 0, 0, 0, 0, 1, 0, 0, 0]"
15487,1,1,2,0.1437909218976411,"[1, 0, 0, 1, 0, 1, 0, 0, 1, 1]"
15488,1,1,2,0.9161029634888257,"[1, 1, 1, 1, 1, 0, 0, 1, 0, 1]"
15489,1,1,2,0.3385528585628701,"[0, 1, 0, 0, 1, 0, 1, 1, 1, 1]"
15490,1,1,2,0.9272332647570602,"[1, 0, 0, 1, 1, 1, 0, 1, 1, 0]"
15491,2,2,4,0.7106032135392075,"[1, 1, 1, 1, 0, 0, 0, 1, 0, 0]"
15492,2,2,4,0.20285027410024292,"[0, 0, 1, 1, 1, 1, 0, 0, 1, 0]"
15493,2,2,4,0.3835302420092638,"[1, 0, 0, 1, 1, 1, 1, 1, 1, 0]"
15494,1,1,2,0.1953915338949498,"[0, 1, 0, 1, 1, 1, 0, 1, 1, 1]"
15495,1,1,2,0.3650854108193957,"[1, 0, 0, 1, 0, 0, 0, 0, 1, 0]"
15496,1,1,2,0.0727714236140461,"[1, 0, 0, 0, 1, 0, 1, 0, 0, 1]"
15497,1,1,2,0.7837839187838457,"[1, 0, 1, 1, 1, 0, 1, 1, 1, 0]"
15498,1,1,2,0.18179754207664012,"[0, 0, 0, 0, 0, 1, 1, 1, 0, 0]"
15499,1,1,2,0.3363124049098416,"[1, 0, 1, 1, 0, 1, 1, 0, 1, 0]"
15500,1,1,2,0.8423467086898649,"[0, 1, 0, 1, 0, 1, 1, 1, 0, 1]"
15501,1,1,2,0.9547963735055335,"[1, 1, 0, 1, 1, 0, 0, 1, 0, 1]"
15502,1,1,2,0.5858234274069676,"[0, 0, 0, 0, 1, 1, 1, 1, 0, 1]"
15503,1,1,2,0.4672042727854666,"[0, 0, 0, 1, 0, 0, 0, 0, 1, 0]"
15504,1,1,2,0.8686314131952942,"[1, 1, 1, 1, 1, 0, 1, 1, 1, 0]"
15505,1,1,2,0.5353808057600431,"[0, 0, 0, 0, 0, 0, 0, 0, 0, 0]"
15506,1,1,2,0.7155849224277938,"[0, 0, 1, 1, 0, 0, 1, 1, 0, 0]"
15507,1,1,2,0.5951677309472934,"[1, 0, 1, 1, 0, 1, 0, 1, 0, 0]"
15508,1,1,2,0.5688102012806502,"[1, 1, 0, 1, 0, 1, 0, 1, 0, 1]"
15509,1,1,2,0.052312587480771056,"[0, 0, 1, 1, 0, 1, 1, 0, 0, 0]"
15510,1,1,2,0.04513870386435248,"[0, 0, 0, 1, 0, 1, 1, 1, 0, 0]"
15511,1,1,2,0.7264119952492692,"[1, 1, 0, 0, 1, 1, 1, 0, 0, 0]"
15512,4,4,8,0.32831749722679704,"[1, 1, 1, 1, 0, 1, 1, 0, 1, 0]"
15513,1,1,2,0.7255962855609837,"[0, 0, 0, 1, 0, 0, 0, 0, 1, 0]"
15514,1,1,2,0.09397911821455363,"[1, 0, 0, 0, 1, 0, 1, 1, 1, 0]"
15515,1,1,2,0.9939442901098042,"[1, 1, 0, 0, 0, 1, 0, 1, 1, 1]"
15516,1,1,2,0.8765307247122516,"[0, 1, 1, 1, 1, 1, 1, 0, 1, 0]"
15517,1,1,2,0.4484922511004724,"[0, 1, 1, 0, 0, 1, 1, 1, 0, 1]"
15518,1,1,2,0.10206898627160188,"[0, 1, 0, 1, 0, 1, 0, 1, 0, 1]"
15519,2,2,4,0.9717552983260088,"[1, 0, 1, 0, 0, 1, 1, 1, 1, 1]"
15520,1,1,2,0.23535100913809015,"[1, 1, 0, 1, 1, 0, 0, 1, 1, 0]"
15521,1,1,2,0.6095790876710266,"[0, 0, 0, 0, 0, 1, 1, 0, 0, 0]"
15522,1,1,2,0.6486793334399478,"[0, 0, 1, 1, 1, 1, 0, 0, 1, 1]"
15523,1,1,2,0.6223093394558211,"[1, 0, 0, 0, 0, 1, 0, 0, 1, 1]"
15524,1,1,2,0.031865642762748725,"[1, 0, 1, 0, 0, 1, 1, 0, 1, 1]"
15525,1,1,2,0.9333112334218486,"[1, 1, 0, 1, 1, 1, 0, 0, 1, 0]"
15526,1,1,2,0.6317093614702357,"[0, 0, 0, 1, 0, 0, 0, 0, 1, 1]"
15527,1,1,2,0.43776897938772785,"[0, 1, 1, 0, 1, 1, 0, 0, 1, 0]"
15528,1,1,2,0.013759688258677016,"[0, 1, 0, 1, 0, 0, 0, 1, 0, 0]"
15529,1,1,2,0.19498035214902154,"[1, 1, 0, 1, 0, 0, 1, 0, 1, 1]"
15530,1,1,2,0.120103950778649,"[1, 0, 0, 1, 0, 0, 0, 0, 0, 1]"
15531,1,1,2,0.5098093942363466,"[1, 1, 0, 0, 1, 0, 1, 1, 0, 0]"
15532,2,2,4,0.652671059280518,"[0, 0, 1, 1, 1, 1, 1, 1, 0, 0]"
15533,1,1,2,0.8339848329257957,"[1, 1, 1, 1, 1, 0, 0, 0, 1, 1]"
15534,1,1,2,0.45160796963667327,"[0, 1, 1, 1, 1, 1, 1, 0, 0, 1]"
15535,1,1,2,0.48604422019056337,"[1, 0, 0, 1, 1, 1, 1, 0, 1, 0]"
15536,1,1,2,0.32314388269727634,"[0, 1, 0, 0, 1, 0, 1, 1, 0, 1]"
15537,1,1,2,0.7599436338029077,"[0, 0, 0, 0, 0, 1, 1, 1, 0, 0]"
15538,1,1,2,0.9902374902972488,"[0, 1, 0, 1, 1, 1, 0, 0, 0, 0]"
15539,1,1,2,0.8194273992388146,"[0, 0, 1, 1, 0, 1, 1, 1, 1, 0]"
15540,1,1,2,0.3995062222376077,"[1, 1, 0, 1, 0, 0, 0, 1, 1, 0]"
15541,1,1,2,0.6837501789139714,"[1, 0, 1, 1, 1, 1, 0, 0, 0, 1]"
15542,1,1,2,0.5417010291788042,"[1, 1, 1, 0, 0, 0, 0, 1, 1, 0]"
15543,2,2,4,0.9659056208935792,"[1, 0, 1, 1, 0, 0, 0, 0, 1, 1]"
15544,1,1,2,0.1034737570143115,"[1, 0, 1, 1, 1, 0, 1, 1, 0, 0]"
15545,1,1,2,0.5124493216684574,"[0, 0, 0, 1, 1, 0, 0, 0, 0, 1]"
15546,1,1,2,0.45892202064427623,"[0, 1, 0, 1, 0, 0, 1, 1, 0, 1]"
15547,1,1,2,0.22783178592055875,"[1, 0, 0, 1, 1, 1, 0, 1, 1, 0]"
15548,2,2,4,0.9882071274394003,"[1, 0, 0, 1, 1, 1, 1, 0, 0, 0]"
15549,1,1,2,0.2661230738254611,"[1, 1, 0, 1, 1, 0, 0, 1, 0, 0]"
15550,2,2,4,0.1958264239264268,"[0, 1, 0, 1, 1, 1, 0, 1, 1, 0]"
15551,1,1,2,0.02859303935717883,"[1, 1, 0, 1, 1, 0, 1, 0, 1, 1]"
15552,1,1,2,0.18775248736811967,"[1, 0, 1, 1, 1, 0, 0, 0, 0, 1]"
15553,1,1,2,0.6529443284883454,"[1, 0, 0, 1, 1, 1, 0, 1, 0, 1]"
15554,1,1,2,0.1725804943668392,"[1, 1, 0, 0, 0, 0, 1, 0, 1, 1]"
15555,1,1,2,0.0963855737164605,"[0, 0, 1, 0, 1, 1, 0, 1, 1, 1]"
15556,1,1,2,0.021665898329488287,"[0, 0, 1, 1, 1, 1, 1, 1, 0, 1]"
15557,1,1,2,0.7947490881100511,"[1, 0, 0, 0, 0, 0, 0, 0, 1, 1]"
15558,1,1,2,0.3180795946543633,"[0, 0, 0, 0, 0, 0, 0, 0, 1, 0]"
15559,2,2,4,0.5762195210508231,"[1, 0, 0, 0, 0, 1, 0, 0, 0, 0]"
15560,1,1,2,0.6877414585497917,"[1, 0, 0, 1, 0, 0, 0, 0, 1, 1]"
15561,1,1,2,0.8533982629549983,"[1, 0, 0, 0, 1, 1, 0, 0, 0, 1]"
15562,1,1,2,0.9398600937758157,"[1, 0, 0, 0, 0, 0, 0, 1, 0, 0]"
15563,1,1,2,0.0861551237483158,"[1, 0, 1, 0, 1, 1, 0, 0, 1, 0]"
15564,1,1,2,0.7096651954515533,"[1, 0, 1, 1, 1, 0, 0, 1, 1, 0]"
15565,1,1,2,0.6973298518795424,"[0, 1, 1, 0, 1, 1, 0, 1, 0, 1]"
15566,1,1,2,0.7284892399740676,"[0, 0, 1, 0, 1, 0, 0, 1, 1, 1]"
15567,1,1,2,0.7559105923316763,"[0, 1, 0, 1, 0, 0, 0, 1, 1, 1]"
15568,2,2,4,0.9263644848370416,"[0, 1, 1, 0, 1, 0, 0, 0, 1, 1]"
15569,1,1,2,0.4139632183826383,"[1, 1, 1, 1, 0, 1, 0, 1, 1, 1]"
15570,1,1,2,0.023559496675665925,"[0, 1, 0, 0, 1, 0, 1, 1, 1, 1]"
15571,1,1,2,0.007923126441420125,"[1, 0, 1, 0, 1, 0, 0, 1, 1, 1]"
15572,2,2,4,0.8717400327944899,"[0, 1, 1, 1, 0, 0, 1, 0, 0, 1]"
15573,1,1,2,0.00590983794033717,"[0, 1, 1, 1, 1, 0, 1, 0, 1, 0]"
15574,1,1,2,0.7494246909799694,"[1, 1, 0, 1, 1, 0, 1, 0, 1, 0]"
15575,1,1,2,0.7438647628517049,"[1, 1, 0, 0, 0, 1, 0, 0, 0, 1]"
15576,2,2,4,0.3505488694307203,"[1, 0, 1, 0, 0, 1, 0, 0, 1, 0]"
15577,1,1,2,0.09987310190535714,"[1, 1, 0, 1, 0, 1, 1, 1, 1, 1]"
15578,1,1,2,0.9472755749145052,"[0, 0, 1, 1, 0, 0, 0, 1, 1, 0]"
15579,1,1,2,0.0020189553686194017,"[1, 0, 1, 0, 1, 1, 1, 0, 1, 0]"
15580,1,1,2,0.40735544008826163,"[0, 0, 1, 0, 1, 0, 1, 0, 1, 0]"
15581,1,1,2,0.43722852409813484,"[1, 1, 1, 0, 1, 0, 0, 0, 1, 1]"
15582,1,1,2,0.9801312531224636,"[0, 0, 0, 0, 0, 0, 0, 0, 1, 0]"
15583,2,2,4,0.799880502690609,"[0, 0, 1, 1, 1, 1, 0, 1, 1, 0]"
15584,1,1,2,0.1997831660758127,"[0, 1, 0, 0, 0, 1, 0, 1, 0, 1]"
15585,1,1,2,0.8934257237893108,"[1, 1, 1, 1, 0, 0, 0, 0, 1, 0]"
15586,1,1,2,0.3049973152226385,"[1, 0, 0, 0, 1, 0, 1, 1, 0, 0]"
15587,1,1,2,0.6658807493597588,"[0, 0, 0, 1, 1, 1, 0, 0, 0, 0]"
15588,1,1,2,0.7793533344499918,"[1, 0, 0, 1, 1, 1, 1, 0, 0, 1]"
15589,1,1,2,0.8262098436991039,"[1, 1, 1, 1, 0, 0, 0, 1, 1, 0]"
15590,1,1,2,0.5914634585838161,"[0, 0, 1, 1, 0, 0, 1, 1, 1, 1]"
15591,1,1,2,0.23614815991683324,"[1, 0, 1, 1, 1, 1, 1, 1, 0, 0]"
15592,1,1,2,0.8844349219348329,"[0, 0, 0, 1, 0, 0, 1, 1, 0, 0]"
15593,1,1,2,0.9420117709514801,"[1, 0, 1, 1, 1, 1, 1, 0, 0, 1]"
15594,1,1,2,0.49498198677983374,"[1, 0, 0, 0, 0, 1, 0, 1, 0, 1]"
15595,1,1,2,0.7994037822195635,"[1, 0, 1, 0, 0, 1, 1, 0, 0, 1]"
15596,1,1,2,0.874402253608628,"[1, 1, 0, 0, 0, 0, 1, 0, 1, 1]"
15597,1,1,2,0.07814340548074994,"[0, 0, 0, 0, 0, 1, 1, 1, 1, 1]"
15598,1,1,2,0.39209670546987874,"[0, 0, 1, 1, 1, 0, 0, 1, 1, 0]"
15599,1,1,2,0.8396075121058894,"[0, 1, 0, 1, 0, 1, 0, 0, 0, 0]"
15600,2,2,4,0.06283793411687866,"[0, 0, 1, 0, 0, 0, 1, 1, 1, 0]"
15601,1,1,2,0.6961973428436421,"[1, 0, 1, 1, 1, 1, 0, 1, 0, 1]"
15602,2,2,4,0.47824115762609287,"[1, 1, 0, 1, 1, 0, 1, 1, 1, 0]"
15603,1,1,2,0.13064290618993102,"[0, 0, 1, 1, 1, 0, 0, 1, 0, 1]"
15604,1,1,2,0.026564665407858512,"[0, 0, 0, 0, 0, 0, 0, 1, 0, 0]"
15605,2,2,4,0.8354043648661117,"[1, 1, 0, 0, 1, 0, 0, 0, 1, 1]"
15606,1,1,2,0.20199297253516924,"[0, 1, 1, 1, 1, 0, 1, 1, 1, 1]"
15607,1,1,2,0.3374903999975596,"[1, 1, 0, 0, 1, 0, 1, 1, 1, 1]"
15608,1,1,2,0.798306322163378,"[1, 1, 0, 0, 0, 0, 0, 1, 0, 0]"
15609,1,1,2,0.6444394669672084,"[0, 1, 1, 0, 1, 1, 0, 0, 1, 0]"
15610,1,1,2,0.05140269823862498,"[1, 0, 0, 1, 1, 0, 1, 1, 1, 0]"
15611,1,1,2,0.002755858196771266,"[0, 1, 1, 0, 1, 0, 1, 1, 0, 0]"
15612,1,1,2,0.6352576072785494,"[0, 1, 1, 1, 1, 0, 0, 0, 0, 0]"
15613,1,1,2,0.7475360775947829,"[0, 0, 1, 0, 0, 0, 0, 0, 0, 1]"
15614,1,1,2,0.4160396747286699,"[0, 1, 0, 1, 0, 1, 0, 0, 0, 1]"
15615,1,1,2,0.18487376185588833,"[1, 1, 0, 1, 0, 1, 1, 0, 1, 1]"
15616,1,1,2,0.5925327134907206,"[1, 1, 1, 1, 0, 1, 0, 0, 1, 1]"
15617,1,1,2,0.7404384225146722,"[0, 0, 0, 0, 1, 1, 1, 1, 1, 0]"
15618,1,1,2,0.9833164092483104,"[1, 0, 1, 0, 0, 1, 1, 1, 1, 0]"
15619,1,1,2,0.2084617004246242,"[0, 1, 1, 0, 1, 0, 1, 1, 0, 1]"
15620,1,1,2,0.5730465460023949,"[1, 0, 1, 1, 1, 1, 1, 0, 0, 0]"
15621,1,1,2,0.24105226091082854,"[0, 1, 1, 0, 0, 1, 1, 0, 0, 1]"
15622,1,1,2,0.6944393108341623,"[1, 1, 1, 1, 0, 1, 0, 1, 0, 1]"
15623,1,1,2,0.34252865564461266,"[1, 0, 0, 0, 1, 0, 0, 1, 0, 1]"
15624,1,1,2,0.8783778567225852,"[1, 0, 1, 1, 0, 1, 1, 0, 1, 1]"
15625,1,1,2,0.4111930410399025,"[0, 0, 0, 0, 1, 0, 1, 0, 1, 1]"
15626,3,3,6,0.37832206590320816,"[0, 0, 0, 1, 1, 1, 0, 1, 1, 1]"
15627,1,1,2,0.9319748222719241,"[0, 1, 0, 0, 1, 1, 1, 1, 0, 0]"
15628,1,1,2,0.08014570665426779,"[1, 0, 1, 0, 1, 1, 1, 0, 1, 0]"
15629,1,1,2,0.383402156807787,"[0, 0, 0, 0, 1, 0, 0, 1, 0, 0]"
15630,1,1,2,0.23493195958059487,"[0, 1, 0, 0, 0, 0, 1, 0, 1, 0]"
15631,1,1,2,0.8304203966025014,"[0, 1, 1, 1, 1, 0, 0, 1, 0, 0]"
15632,1,1,2,0.9421489875758166,"[0, 0, 0, 0, 0, 1, 1, 0, 0, 1]"
15633,1,1,2,0.8308294821332698,"[0, 0, 1, 1, 1, 1, 0, 1, 0, 1]"
15634,1,1,2,0.7503585873949666,"[0, 0, 0, 1, 0, 0, 0, 1, 1, 1]"
15635,1,1,2,0.23420327455466894,"[0, 1, 0, 1, 0, 1, 1, 0, 1, 1]"
15636,1,1,2,0.9564500079693948,"[0, 0, 1, 1, 1, 0, 0, 0, 1, 1]"
15637,1,1,2,0.1147944398382219,"[0, 1, 0, 0, 1, 1, 1, 1, 0, 1]"
15638,1,1,2,0.917354864638609,"[0, 0, 1, 1, 1, 0, 0, 1, 1, 1]"
15639,1,1,2,0.35365427854203,"[1, 0, 1, 1, 0, 1, 1, 1, 1, 1]"
15640,1,1,2,0.13017823782705285,"[0, 1, 1, 1, 1, 0, 1, 0, 0, 0]"
15641,1,1,2,0.2510411889619738,"[0, 0, 0, 0, 1, 0, 1, 0, 0, 1]"
15642,1,1,2,0.09885032560425744,"[1, 1, 0, 0, 1, 1, 1, 1, 1, 0]"
15643,1,1,2,0.8233237652899441,"[0, 0, 0, 1, 1, 0, 1, 1, 1, 0]"
15644,2,2,4,0.8265787000989403,"[1, 1, 1, 1, 0, 0, 1, 1, 1, 0]"
15645,1,1,2,0.7239271565209598,"[1, 1, 1, 0, 1, 1, 1, 1, 0, 1]"
15646,1,1,2,0.9565539748054507,"[0, 1, 1, 0, 1, 0, 0, 1, 0, 1]"
15647,2,2,4,0.050706964322423276,"[1, 1, 1, 0, 1, 1, 1, 0, 1, 1]"
15648,1,1,2,0.8173185373679794,"[1, 0, 1, 1, 1, 1, 1, 0, 0, 1]"
15649,2,2,4,0.17042101416172195,"[1, 0, 0, 0, 0, 0, 1, 1, 1, 1]"
15650,1,1,2,0.9304067381737013,"[0, 0, 0, 0, 0, 0, 1, 0, 1, 1]"
15651,1,1,2,0.8999095394192526,"[1, 1, 1, 0, 1, 1, 1, 1, 0, 0]"
15652,1,1,2,0.13295914256007646,"[0, 0, 1, 1, 1, 1, 1, 1, 1, 0]"
15653,1,1,2,0.9518944812776811,"[1, 0, 0, 1, 1, 0, 0, 1, 0, 0]"
15654,1,1,2,0.20496762682422642,"[1, 0, 1, 1, 0, 0, 1, 1, 0, 0]"
15655,1,1,2,0.11676671397348282,"[1, 1, 1, 0, 0, 0, 0, 0, 0, 0]"
15656,1,1,2,0.6081101266163291,"[1, 0, 1, 0, 0, 1, 1, 1, 1, 0]"
15657,1,1,2,0.4997694220597769,"[0, 1, 0, 0, 0, 1, 1, 1, 0, 1]"
15658,1,1,2,0.8859086066298688,"[1, 1, 0, 0, 1, 0, 1, 0, 0, 0]"
15659,3,3,6,0.3908801782438005,"[0, 0, 0, 1, 1, 1, 0, 1, 1, 0]"
15660,1,1,2,0.15165951362914842,"[1, 1, 1, 1, 1, 0, 0, 1, 0, 0]"
15661,1,1,2,0.11738000803071669,"[1, 0, 0, 1, 0, 0, 1, 1, 0, 0]"
15662,1,1,2,0.4700563424575377,"[0, 1, 1, 0, 0, 0, 1, 1, 0, 0]"
15663,1,1,2,0.7345000196442062,"[0, 1, 0, 0, 0, 0, 0, 0, 0, 0]"
15664,1,1,2,0.06421847930081981,"[1, 1, 1, 1, 0, 0, 0, 0, 1, 0]"
15665,1,1,2,0.06850236652821495,"[0, 0, 0, 0, 0, 0, 1, 0, 0, 1]"
15666,1,1,2,0.22858492834897137,"[0, 1, 0, 0, 1, 0, 1, 1, 0, 1]"
15667,1,1,2,0.7746337896510439,"[1, 1, 0, 0, 0, 1, 0, 1, 0, 1]"
15668,1,1,2,0.8158933647605171,"[1, 1, 0, 0, 1, 1, 1, 1, 0, 0]"
15669,2,2,4,0.45455156793002793,"[0, 1, 0, 0, 1, 1, 0, 1, 1, 0]"
15670,1,1,2,0.608066389388201,"[1, 1, 1, 0, 0, 0, 1, 1, 1, 1]"
15671,1,1,2,0.3574445910401357,"[0, 0, 1, 1, 0, 0, 0, 1, 1, 0]"
15672,1,1,2,0.8273518140547926,"[1, 1, 1, 0, 0, 0, 0, 0, 0, 0]"
15673,1,1,2,0.32331958444584297,"[1, 0, 1, 0, 0, 1, 0, 1, 0, 1]"
15674,2,2,4,0.4007233212132245,"[0, 0, 0, 1, 0, 1, 1, 0, 1, 0]"
15675,1,1,2,0.768043160482538,"[1, 0, 1, 1, 1, 1, 0, 0, 1, 0]"
15676,1,1,2,0.4596507715430752,"[1, 0, 0, 0, 0, 0, 1, 1, 1, 0]"
15677,1,1,2,0.9721437995835958,"[0, 0, 1, 0, 0, 0, 1, 1, 0, 1]"
15678,1,1,2,0.1390514625717333,"[0, 0, 1, 1, 0, 1, 1, 1, 0, 0]"
15679,1,1,2,0.809545115321508,"[1, 1, 0, 0, 0, 0, 1, 0, 1, 0]"
15680,1,1,2,0.6296747696053957,"[0, 0, 1, 0, 0, 1, 1, 0, 0, 0]"
15681,2,2,4,0.501765264989284,"[1, 1, 0, 1, 1, 1, 0, 0, 1, 0]"
15682,1,1,2,0.7482352834156767,"[1, 1, 1, 0, 1, 0, 0, 0, 1, 0]"
15683,1,1,2,0.820458971867073,"[0, 1, 0, 1, 0, 1, 1, 1, 0, 0]"
15684,2,2,4,0.6720966788274704,"[1, 1, 0, 0, 0, 0, 1, 1, 1, 1]"
15685,1,1,2,0.5294456181397063,"[1, 1, 1, 1, 1, 1, 1, 0, 0, 1]"
15686,1,1,2,0.819260482169064,"[1, 0, 0, 1, 0, 0, 1, 0, 1, 0]"
15687,1,1,2,0.7765765188027898,"[1, 1, 0, 0, 1, 1, 1, 0, 1, 1]"
15688,1,1,2,0.9699871315811407,"[1, 0, 1, 1, 1, 1, 0, 1, 0, 0]"
15689,1,1,2,0.275618033006644,"[0, 1, 0, 0, 1, 1, 1, 1, 0, 0]"
15690,1,1,2,0.1690410130723018,"[0, 0, 1, 0, 0, 0, 0, 1, 1, 1]"
15691,1,1,2,0.07588232013219864,"[1, 0, 0, 0, 1, 0, 1, 0, 1, 0]"
15692,1,1,2,0.8879504998351967,"[0, 0, 1, 0, 0, 0, 0, 1, 0, 1]"
15693,1,1,2,0.6769695836416503,"[0, 1, 0, 0, 1, 1, 0, 0, 1, 0]"
15694,1,1,2,0.4545949466015634,"[1, 1, 1, 0, 0, 1, 1, 1, 1, 1]"
15695,1,1,2,0.693275833034907,"[1, 1, 0, 1, 1, 0, 0, 1, 1, 1]"
15696,1,1,2,0.11138835114424583,"[1, 1, 0, 1, 0, 0, 1, 0, 1, 0]"
15697,1,1,2,0.23562009393314687,"[1, 1, 1, 0, 1, 0, 0, 1, 1, 1]"
15698,1,1,2,0.8042131928538878,"[1, 0, 1, 1, 1, 1, 1, 1, 1, 1]"
15699,1,1,2,0.28530410383512894,"[0, 0, 1, 1, 1, 1, 0, 1, 1, 0]"
15700,1,1,2,0.6198530502388242,"[1, 1, 1, 0, 0, 1, 0, 1, 0, 0]"
15701,1,1,2,0.6928418782405289,"[0, 0, 0, 1, 1, 0, 0, 1, 0, 0]"
15702,1,1,2,0.8070887676579774,"[0, 0, 0, 0, 0, 1, 1, 1, 0, 0]"
15703,1,1,2,0.6650732433296189,"[0, 0, 0, 0, 0, 1, 1, 1, 1, 1]"
15704,1,1,2,0.5546002364689422,"[0, 1, 0, 1, 0, 1, 0, 1, 1, 1]"
15705,1,1,2,0.501071817113982,"[0, 0, 0, 1, 0, 0, 0, 1, 1, 0]"
15706,2,2,4,0.7197099201217694,"[1, 1, 0, 0, 0, 1, 0, 1, 1, 1]"
15707,1,1,2,0.9220624932204167,"[0, 1, 1, 0, 1, 0, 0, 1, 1, 1]"
15708,1,1,2,0.40519001235910024,"[0, 1, 0, 1, 0, 1, 1, 0, 1, 1]"
15709,1,1,2,0.6661138770304849,"[1, 1, 0, 0, 0, 0, 0, 0, 0, 0]"
15710,1,1,2,0.9073826620474605,"[0, 1, 1, 0, 1, 1, 1, 0, 1, 0]"
15711,1,1,2,0.5624611872592145,"[0, 0, 0, 0, 1, 1, 0, 0, 0, 0]"
15712,1,1,2,0.9063935839528459,"[1, 1, 1, 0, 1, 0, 0, 1, 1, 0]"
15713,1,1,2,0.9986773049803268,"[0, 1, 1, 1, 0, 0, 0, 1, 0, 0]"
15714,1,1,2,0.5708659872134256,"[0, 0, 1, 1, 0, 0, 1, 0, 0, 1]"
15715,1,1,2,0.2980592911833059,"[1, 1, 1, 0, 0, 0, 0, 0, 0, 1]"
15716,2,2,4,0.8362317500739961,"[1, 1, 1, 1, 0, 0, 1, 0, 1, 1]"
15717,1,1,2,0.6875582652342537,"[0, 0, 1, 0, 1, 0, 0, 0, 1, 0]"
15718,1,1,2,0.2913593059736631,"[0, 0, 1, 1, 1, 1, 0, 0, 0, 1]"
15719,1,1,2,0.7814974647853515,"[0, 1, 0, 0, 1, 1, 0, 0, 0, 1]"
15720,1,1,2,0.9930334475946675,"[1, 0, 1, 1, 0, 0, 1, 1, 1, 1]"
15721,1,1,2,0.20342561671168957,"[0, 1, 0, 1, 1, 0, 0, 1, 0, 1]"
15722,1,1,2,0.3093616934494904,"[0, 0, 1, 0, 1, 0, 1, 1, 1, 1]"
15723,1,1,2,0.89999059973677,"[0, 1, 1, 0, 0, 0, 1, 1, 1, 1]"
15724,1,1,2,0.8035802527516688,"[1, 0, 1, 0, 0, 0, 1, 0, 0, 1]"
15725,1,1,2,0.6420200964183387,"[1, 1, 0, 1, 0, 0, 1, 1, 0, 1]"
15726,1,1,2,0.026695775067623106,"[0, 1, 1, 1, 0, 1, 1, 0, 0, 0]"
15727,1,1,2,0.8959642795062344,"[1, 1, 1, 1, 0, 0, 0, 0, 1, 0]"
15728,1,1,2,0.24851701622620903,"[0, 1, 1, 1, 0, 0, 0, 0, 0, 1]"
15729,2,2,4,0.5937132525244854,"[1, 1, 0, 0, 1, 1, 1, 1, 1, 1]"
15730,1,1,2,0.281780373587307,"[0, 0, 0, 1, 1, 0, 1, 1, 1, 1]"
15731,1,1,2,0.023081324741209386,"[1, 1, 0, 1, 1, 1, 0, 0, 1, 1]"
15732,1,1,2,0.8852282205558724,"[1, 0, 0, 1, 1, 1, 1, 1, 0, 1]"
15733,2,2,4,0.361594748956913,"[1, 0, 0, 0, 1, 0, 1, 0, 0, 0]"
15734,1,1,2,0.2704219014886732,"[0, 0, 0, 1, 0, 0, 1, 0, 1, 1]"
15735,1,1,2,0.7646904877480155,"[0, 1, 0, 0, 0, 1, 0, 0, 0, 0]"
15736,1,1,2,0.17465748937916248,"[1, 1, 1, 1, 0, 0, 1, 1, 0, 0]"
15737,1,1,2,0.8755661735892905,"[0, 1, 1, 1, 1, 1, 1, 1, 0, 1]"
15738,1,1,2,0.5124878608767768,"[0, 1, 1, 1, 0, 1, 0, 1, 0, 1]"
15739,1,1,2,0.20650935408414428,"[0, 0, 1, 1, 1, 0, 1, 0, 0, 1]"
15740,1,1,2,0.6310697221719733,"[0, 1, 1, 0, 1, 0, 1, 0, 0, 0]"
15741,1,1,2,0.8650135090758371,"[0, 1, 0, 1, 1, 1, 1, 0, 0, 1]"
15742,1,1,2,0.13680107444605694,"[0, 1, 0, 0, 1, 1, 1, 1, 0, 1]"
15743,2,2,4,0.2381664437197878,"[1, 0, 1, 0, 1, 1, 1, 0, 1, 1]"
15744,1,1,2,0.9678309707392682,"[1, 0, 0, 1, 0, 0, 1, 1, 0, 1]"
15745,1,1,2,0.9638358987633336,"[1, 1, 1, 1, 0, 1, 0, 0, 1, 1]"
15746,1,1,2,0.6547893171885739,"[0, 1, 0, 0, 0, 0, 0, 1, 1, 1]"
15747,1,1,2,0.3261462273565101,"[0, 0, 0, 0, 0, 0, 1, 1, 0, 1]"
15748,1,1,2,0.520179307406436,"[0, 0, 1, 0, 0, 0, 0, 0, 1, 0]"
15749,1,1,2,0.4100176736274589,"[0, 1, 1, 0, 1, 1, 1, 1, 0, 0]"
15750,1,1,2,0.8804408946525475,"[0, 0, 0, 1, 0, 1, 1, 1, 0, 1]"
15751,1,1,2,0.5075583130780756,"[0, 1, 0, 1, 1, 1, 0, 1, 0, 1]"
15752,1,1,2,0.5213944088906733,"[1, 1, 0, 1, 0, 0, 1, 0, 1, 1]"
15753,1,1,2,0.6311187031098794,"[0, 1, 0, 0, 1, 1, 1, 1, 1, 0]"
15754,1,1,2,0.5933534408622996,"[1, 1, 1, 0, 1, 0, 0, 0, 1, 0]"
15755,1,1,2,0.14837124526152767,"[0, 1, 1, 1, 0, 1, 0, 0, 0, 1]"
15756,1,1,2,0.27309412067484107,"[1, 0, 0, 0, 1, 0, 1, 0, 0, 0]"
15757,3,3,6,0.6788676937416793,"[0, 0, 1, 1, 1, 1, 0, 1, 1, 0]"
15758,1,1,2,0.5575817193804736,"[0, 1, 0, 1, 1, 0, 1, 0, 0, 1]"
15759,1,1,2,0.9369674626163068,"[0, 1, 0, 1, 1, 0, 1, 0, 1, 1]"
15760,2,2,4,0.3019002069024601,"[1, 1, 1, 1, 0, 1, 0, 0, 0, 0]"
15761,1,1,2,0.6318381812490274,"[0, 1, 0, 1, 1, 0, 0, 0, 0, 1]"
15762,1,1,2,0.15067239219910122,"[0, 0, 0, 0, 1, 0, 0, 0, 1, 0]"
15763,2,2,4,0.7330972678191356,"[0, 0, 0, 1, 1, 1, 1, 0, 0, 0]"
15764,1,1,2,0.26319503940031064,"[0, 1, 1, 1, 0, 1, 1, 0, 0, 1]"
15765,1,1,2,0.461532877878004,"[0, 1, 1, 0, 0, 0, 0, 1, 1, 0]"
15766,2,2,4,0.964923701242273,"[0, 0, 1, 0, 0, 1, 1, 0, 1, 1]"
15767,1,1,2,0.892135201205469,"[0, 1, 1, 1, 1, 0, 1, 1, 1, 0]"
15768,1,1,2,0.31066776303005206,"[1, 1, 0, 1, 1, 0, 1, 1, 0, 1]"
15769,1,1,2,0.28949661577393637,"[0, 0, 1, 1, 0, 1, 1, 0, 1, 0]"
15770,1,1,2,0.6777157453531107,"[0, 0, 0, 1, 0, 1, 1, 0, 1, 0]"
15771,1,1,2,0.6709301058527856,"[0, 1, 0, 0, 1, 0, 1, 0, 0, 1]"
15772,1,1,2,0.8673526963524498,"[0, 1, 0, 1, 1, 1, 1, 0, 0, 1]"
15773,1,1,2,0.9166022004269562,"[0, 0, 0, 0, 1, 0, 1, 1, 1, 1]"
15774,1,1,2,0.43776978619375506,"[0, 0, 0, 0, 0, 1, 1, 1, 1, 0]"
15775,1,1,2,0.604463875997755,"[0, 0, 0, 1, 1, 1, 0, 1, 0, 1]"
15776,1,1,2,0.21463271451782517,"[0, 0, 1, 0, 0, 1, 0, 0, 0, 0]"
15777,1,1,2,0.7629822222744816,"[1, 1, 0, 0, 0, 0, 1, 0, 1, 0]"
15778,1,1,2,0.19286355381350218,"[0, 1, 0, 1, 1, 1, 0, 1, 0, 1]"
15779,1,1,2,0.45479604974478816,"[1, 1, 0, 1, 0, 0, 0, 0, 0, 1]"
15780,1,1,2,0.6517353527049796,"[0, 0, 1, 1, 1, 0, 1, 1, 1, 1]"
15781,1,1,2,0.143509868896605,"[0, 0, 1, 1, 0, 0, 0, 0, 0, 0]"
15782,2,2,4,0.7626312257373502,"[0, 1, 0, 0, 1, 1, 0, 1, 1, 0]"
15783,1,1,2,0.8516234661410791,"[0, 1, 1, 1, 1, 1, 0, 0, 0, 1]"
15784,1,1,2,0.798845282608098,"[1, 1, 1, 1, 1, 0, 1, 0, 1, 1]"
15785,1,1,2,0.33101509465109236,"[1, 0, 0, 1, 0, 1, 0, 0, 0, 0]"
15786,1,1,2,0.17750750900170165,"[1, 1, 0, 1, 0, 1, 1, 0, 1, 0]"
15787,1,1,2,0.4173072991690112,"[1, 0, 1, 1, 0, 0, 1, 1, 1, 0]"
15788,1,1,2,0.4163377572444428,"[0, 0, 1, 0, 1, 0, 1, 0, 0, 1]"
15789,2,2,4,0.47869297507050323,"[0, 0, 1, 0, 1, 1, 1, 1, 1, 0]"
15790,1,1,2,0.2861041276725529,"[0, 1, 0, 0, 0, 0, 1, 0, 0, 1]"
15791,1,1,2,0.745229465887313,"[1, 0, 1, 0, 1, 0, 0, 0, 1, 1]"
15792,1,1,2,0.7209189717240719,"[1, 1, 1, 1, 1, 0, 0, 1, 0, 1]"
15793,1,1,2,0.5177548415665266,"[0, 0, 1, 0, 0, 1, 1, 0, 1, 0]"
15794,1,1,2,0.23463698750343331,"[0, 1, 0, 0, 0, 0, 0, 0, 0, 1]"
15795,1,1,2,0.4154540272811137,"[0, 1, 1, 0, 0, 0, 0, 1, 1, 0]"
15796,1,1,2,0.3085646485852571,"[1, 1, 1, 1, 0, 1, 0, 0, 1, 0]"
15797,1,1,2,0.986686788889838,"[0, 0, 1, 0, 0, 1, 1, 0, 0, 0]"
15798,1,1,2,0.08639861850734998,"[1, 0, 0, 1, 1, 1, 0, 0, 0, 0]"
15799,1,1,2,0.9089998636395724,"[0, 0, 0, 0, 1, 1, 1, 1, 1, 0]"
15800,1,1,2,0.6735080180903886,"[0, 0, 1, 0, 1, 0, 1, 1, 0, 0]"
15801,1,1,2,0.9669424725553736,"[1, 0, 1, 0, 0, 1, 0, 1, 0, 0]"
15802,1,1,2,0.7602898626807783,"[0, 1, 0, 0, 1, 0, 0, 0, 0, 1]"
15803,1,1,2,0.5343466733164924,"[1, 1, 1, 1, 0, 0, 1, 0, 0, 1]"
15804,1,1,2,0.41135270085771936,"[0, 1, 0, 0, 0, 0, 0, 1, 0, 1]"
15805,1,1,2,0.6471882200410639,"[1, 1, 1, 0, 0, 0, 1, 0, 0, 1]"
15806,1,1,2,0.6126909257662911,"[0, 1, 1, 1, 0, 1, 0, 0, 1, 0]"
15807,1,1,2,0.017156158696460144,"[1, 0, 0, 0, 1, 0, 1, 0, 1, 1]"
15808,1,1,2,0.6189441789804357,"[1, 0, 1, 1, 1, 0, 1, 0, 1, 1]"
15809,2,2,4,0.6345974875048824,"[0, 1, 0, 1, 1, 0, 0, 0, 1, 1]"
15810,2,2,4,0.0816553043021081,"[1, 0, 0, 1, 0, 1, 1, 1, 1, 1]"
15811,2,2,4,0.6087460900123146,"[1, 1, 0, 0, 1, 1, 0, 1, 1, 0]"
15812,1,1,2,0.4637740858680943,"[0, 1, 1, 0, 1, 1, 0, 1, 0, 0]"
15813,1,1,2,0.4308311902709141,"[0, 1, 0, 1, 0, 1, 1, 1, 1, 0]"
15814,1,1,2,0.21861972304180155,"[0, 1, 0, 0, 0, 1, 1, 0, 1, 0]"
15815,1,1,2,0.7375922180984449,"[1, 0, 0, 1, 1, 0, 1, 0, 1, 1]"
15816,1,1,2,0.7882504723312803,"[1, 0, 1, 0, 0, 1, 0, 0, 1, 1]"
15817,2,2,4,0.8197172699348106,"[1, 1, 1, 1, 1, 1, 1, 0, 1, 1]"
15818,1,1,2,0.9523937262854412,"[1, 1, 0, 1, 0, 0, 0, 1, 1, 1]"
15819,1,1,2,0.9031407126505845,"[0, 1, 0, 1, 1, 0, 0, 0, 0, 1]"
15820,1,1,2,0.2449259869736543,"[1, 0, 0, 0, 0, 1, 1, 0, 1, 1]"
15821,1,1,2,0.10949832808220072,"[1, 0, 1, 0, 0, 0, 0, 1, 0, 0]"
15822,1,1,2,0.6397071700514978,"[0, 1, 1, 1, 0, 0, 1, 1, 0, 1]"
15823,1,1,2,0.36839150700422896,"[0, 0, 1, 1, 1, 1, 0, 0, 1, 1]"
15824,1,1,2,0.6933912119470906,"[1, 0, 0, 1, 1, 0, 0, 1, 0, 0]"
15825,1,1,2,0.3974380367040541,"[1, 0, 0, 1, 1, 0, 0, 1, 1, 0]"
15826,1,1,2,0.8285925088447278,"[0, 1, 1, 1, 1, 0, 1, 0, 0, 1]"
15827,1,1,2,0.776619941185099,"[1, 1, 1, 0, 1, 0, 0, 0, 1, 1]"
15828,1,1,2,0.47765458902037583,"[1, 1, 1, 1, 1, 0, 1, 1, 0, 0]"
15829,1,1,2,0.9596683789610269,"[1, 1, 0, 0, 0, 0, 0, 1, 0, 0]"
15830,1,1,2,0.006673219950697917,"[1, 1, 0, 0, 1, 0, 0, 0, 1, 0]"
15831,1,1,2,0.1758224979397468,"[0, 0, 1, 0, 0, 0, 0, 1, 0, 0]"
15832,1,1,2,0.46076766163787974,"[0, 0, 0, 1, 1, 1, 1, 0, 0, 0]"
15833,1,1,2,0.7282938001564984,"[1, 0, 1, 0, 0, 0, 0, 0, 0, 0]"
15834,1,1,2,0.5324198845742311,"[1, 1, 1, 1, 0, 0, 1, 0, 1, 0]"
15835,1,1,2,0.5558634816497311,"[0, 0, 1, 1, 0, 0, 1, 0, 1, 0]"
15836,1,1,2,0.2057474312542391,"[1, 1, 0, 0, 1, 1, 1, 0, 1, 1]"
15837,1,1,2,0.13005119984801894,"[0, 1, 0, 1, 1, 1, 0, 1, 1, 0]"
15838,1,1,2,0.622204071847186,"[0, 0, 0, 1, 1, 1, 0, 1, 0, 0]"
15839,1,1,2,0.753411398430667,"[0, 1, 0, 0, 0, 1, 1, 1, 0, 0]"
15840,1,1,2,0.41519476957388934,"[1, 1, 1, 0, 0, 1, 0, 0, 1, 0]"
15841,1,1,2,0.2057370218049389,"[1, 0, 0, 0, 1, 0, 1, 0, 1, 0]"
15842,1,1,2,0.3147016030530688,"[0, 1, 0, 1, 1, 0, 0, 0, 1, 1]"
15843,1,1,2,0.23538974060475337,"[0, 1, 1, 0, 0, 1, 1, 0, 0, 1]"
15844,1,1,2,0.3129472940478285,"[0, 0, 0, 1, 0, 1, 0, 0, 0, 1]"
15845,1,1,2,0.15815856681179175,"[1, 0, 1, 0, 1, 1, 0, 0, 1, 0]"
15846,1,1,2,0.32603173406222064,"[0, 1, 0, 0, 1, 1, 1, 0, 1, 1]"
15847,1,1,2,0.5386283021439479,"[1, 0, 0, 1, 0, 1, 1, 1, 1, 0]"
15848,2,2,4,0.015867739816362247,"[1, 0, 0, 1, 1, 0, 0, 1, 1, 1]"
15849,1,1,2,0.11455563655334555,"[0, 1, 1, 1, 1, 0, 0, 0, 1, 1]"
15850,1,1,2,0.6025894431354201,"[1, 0, 1, 1, 1, 0, 0, 0, 0, 1]"
15851,1,1,2,0.11162244956097711,"[1, 1, 1, 0, 1, 1, 0, 1, 0, 0]"
15852,2,2,4,0.41526450452929786,"[1, 0, 1, 0, 0, 1, 1, 1, 0, 0]"
15853,1,1,2,0.5091931404215515,"[0, 0, 1, 1, 0, 0, 1, 0, 1, 0]"
15854,1,1,2,0.7868785988014454,"[0, 0, 0, 1, 0, 0, 1, 0, 0, 1]"
15855,1,1,2,0.9472702851847088,"[1, 1, 1, 1, 1, 1, 1, 0, 0, 0]"
15856,1,1,2,0.9097417273941119,"[0, 1, 0, 0, 1, 0, 1, 0, 0, 1]"
15857,1,1,2,0.0881108115436463,"[1, 1, 0, 0, 0, 0, 1, 1, 0, 0]"
15858,1,1,2,0.9414269995383147,"[0, 1, 0, 1, 1, 1, 0, 1, 0, 0]"
15859,1,1,2,0.9298073984293296,"[1, 1, 0, 1, 1, 0, 0, 1, 0, 1]"
15860,1,1,2,0.02009753624445776,"[0, 1, 0, 0, 1, 1, 0, 1, 0, 1]"
15861,1,1,2,0.1546691250898281,"[0, 1, 1, 0, 0, 0, 1, 0, 1, 1]"
15862,1,1,2,0.16880565347788623,"[1, 0, 0, 0, 1, 1, 1, 0, 1, 1]"
15863,1,1,2,0.7760471086538689,"[0, 1, 1, 0, 1, 1, 1, 1, 1, 0]"
15864,2,2,4,0.09694407751913914,"[1, 0, 0, 0, 1, 1, 1, 1, 1, 0]"
15865,1,1,2,0.7587360280054549,"[1, 1, 0, 0, 1, 0, 0, 0, 1, 0]"
15866,1,1,2,0.5917732543166728,"[0, 1, 1, 0, 0, 1, 0, 0, 1, 1]"
15867,1,1,2,0.7789271345850216,"[0, 0, 0, 1, 1, 1, 0, 0, 1, 1]"
15868,1,1,2,0.08721683997632745,"[0, 0, 0, 0, 1, 0, 0, 1, 1, 0]"
15869,1,1,2,0.29591943354084016,"[0, 0, 1, 0, 1, 1, 1, 0, 1, 1]"
15870,1,1,2,0.47075177924036404,"[0, 0, 0, 0, 0, 1, 0, 0, 1, 0]"
15871,1,1,2,0.9656343780411316,"[1, 1, 1, 0, 0, 1, 1, 0, 0, 0]"
15872,1,1,2,0.0756092043668235,"[0, 0, 1, 1, 0, 0, 1, 0, 0, 1]"
15873,1,1,2,0.40369540730901354,"[1, 0, 0, 0, 0, 0, 1, 1, 1, 1]"
15874,1,1,2,0.36299907354712047,"[0, 1, 1, 1, 0, 0, 0, 0, 0, 0]"
15875,2,2,4,0.04486375794362896,"[0, 1, 1, 1, 1, 1, 1, 0, 0, 0]"
15876,1,1,2,0.49329706038274523,"[0, 1, 1, 1, 0, 1, 0, 1, 1, 0]"
15877,1,1,2,0.14538212483911617,"[1, 0, 0, 0, 1, 1, 0, 1, 0, 0]"
15878,1,1,2,0.4195119704130865,"[1, 1, 1, 0, 0, 1, 1, 0, 1, 0]"
15879,1,1,2,0.6002376014006572,"[0, 1, 0, 0, 1, 0, 0, 0, 0, 1]"
15880,1,1,2,0.6942676376609392,"[1, 1, 0, 0, 0, 0, 1, 1, 0, 0]"
15881,1,1,2,0.7707927756986397,"[0, 0, 1, 1, 0, 1, 1, 0, 1, 0]"
15882,1,1,2,0.4639257412967801,"[0, 0, 0, 0, 1, 1, 1, 1, 1, 1]"
15883,1,1,2,0.7927990721958812,"[0, 0, 0, 0, 0, 0, 0, 1, 1, 0]"
15884,1,1,2,0.820235209234429,"[1, 1, 0, 0, 1, 1, 0, 1, 0, 1]"
15885,1,1,2,0.2834141689355667,"[0, 0, 0, 0, 0, 1, 0, 1, 1, 0]"
15886,1,1,2,0.2309511364311816,"[0, 0, 1, 0, 1, 0, 0, 0, 1, 0]"
15887,1,1,2,0.698793134429913,"[0, 0, 1, 0, 0, 0, 0, 0, 0, 1]"
15888,1,1,2,0.4334897220774009,"[1, 0, 0, 1, 0, 1, 0, 0, 0, 1]"
15889,1,1,2,0.7403309803741508,"[0, 1, 0, 0, 1, 0, 0, 1, 0, 0]"
15890,1,1,2,0.40354820262603985,"[1, 0, 0, 0, 0, 1, 0, 0, 0, 1]"
15891,1,1,2,0.9972906957372654,"[0, 1, 1, 0, 0, 0, 0, 1, 0, 0]"
15892,2,2,4,0.3840554929618546,"[1, 0, 1, 0, 0, 0, 1, 1, 0, 1]"
15893,1,1,2,0.587464986016164,"[1, 1, 0, 0, 1, 0, 0, 0, 1, 0]"
15894,1,1,2,0.8117612345128107,"[1, 0, 0, 1, 1, 0, 0, 1, 0, 0]"
15895,1,1,2,0.8404197765066722,"[1, 0, 0, 0, 1, 0, 0, 0, 1, 0]"
15896,2,2,4,0.871927650547839,"[1, 0, 1, 1, 0, 1, 1, 0, 1, 0]"
15897,1,1,2,0.028438197639695795,"[0, 0, 1, 1, 1, 1, 0, 0, 1, 1]"
15898,2,2,4,0.8161450990617527,"[0, 1, 0, 1, 1, 0, 0, 1, 1, 1]"
15899,1,1,2,0.39676474940004636,"[0, 1, 1, 0, 1, 0, 1, 0, 0, 0]"
15900,1,1,2,0.7548667631904517,"[1, 0, 0, 0, 0, 1, 1, 1, 1, 0]"
15901,1,1,2,0.8339938744290359,"[0, 1, 1, 1, 1, 0, 1, 1, 1, 0]"
15902,1,1,2,0.6065346737464135,"[0, 1, 1, 0, 0, 0, 1, 0, 1, 0]"
15903,1,1,2,0.7596561662250657,"[0, 0, 1, 0, 0, 1, 1, 1, 0, 0]"
15904,1,1,2,0.8074259504993011,"[0, 1, 0, 1, 1, 1, 1, 0, 1, 1]"
15905,1,1,2,0.5140691574866412,"[1, 1, 0, 1, 1, 1, 0, 1, 1, 1]"
15906,1,1,2,0.14210221034158088,"[1, 0, 1, 0, 1, 0, 0, 0, 1, 0]"
15907,1,1,2,0.3882186942743634,"[0, 1, 1, 0, 1, 1, 0, 0, 0, 1]"
15908,1,1,2,0.27060643912044013,"[0, 0, 1, 1, 1, 1, 1, 1, 1, 0]"
15909,1,1,2,0.22171951424966707,"[0, 1, 1, 0, 1, 1, 1, 1, 0, 0]"
15910,1,1,2,0.9109483115578494,"[0, 0, 1, 0, 1, 1, 1, 1, 1, 0]"
15911,1,1,2,0.30727331248067424,"[1, 0, 1, 1, 0, 0, 1, 0, 0, 1]"
15912,1,1,2,0.4885149616486557,"[0, 0, 1, 0, 1, 0, 0, 0, 1, 1]"
15913,1,1,2,0.005762725234130794,"[0, 0, 1, 1, 1, 0, 1, 0, 0, 1]"
15914,1,1,2,0.26478866131823897,"[0, 1, 0, 0, 1, 0, 0, 1, 0, 0]"
15915,1,1,2,0.3022326261499778,"[0, 1, 1, 1, 0, 0, 0, 0, 1, 0]"
15916,1,1,2,0.693744219613594,"[0, 1, 0, 1, 1, 0, 0, 1, 0, 0]"
15917,1,1,2,0.523691419552931,"[1, 1, 1, 0, 1, 1, 1, 1, 0, 0]"
15918,1,1,2,0.4869603258973638,"[1, 0, 1, 1, 0, 0, 1, 0, 1, 1]"
15919,1,1,2,0.954356832096998,"[1, 1, 1, 1, 1, 1, 1, 0, 1, 0]"
15920,1,1,2,0.9519751279324161,"[0, 0, 1, 0, 0, 1, 1, 1, 1, 1]"
15921,1,1,2,0.11133531197703994,"[0, 1, 0, 0, 0, 1, 1, 1, 1, 0]"
15922,2,2,4,0.6351919262696019,"[1, 1, 0, 0, 1, 0, 1, 0, 0, 0]"
15923,1,1,2,0.5278759084741528,"[0, 0, 0, 0, 0, 0, 1, 0, 1, 0]"
15924,1,1,2,0.7100379663528876,"[1, 1, 0, 0, 0, 1, 1, 1, 0, 1]"
15925,1,1,2,0.6717429906506427,"[0, 0, 1, 0, 0, 1, 1, 0, 1, 0]"
15926,1,1,2,0.25761511297420836,"[0, 0, 1, 0, 0, 1, 1, 1, 1, 0]"
15927,1,1,2,0.7738382134659373,"[0, 0, 1, 1, 0, 0, 0, 0, 0, 0]"
15928,1,1,2,0.4964470453344826,"[1, 0, 1, 0, 0, 1, 0, 1, 1, 0]"
15929,1,1,2,0.69646569784875,"[0, 1, 0, 0, 0, 1, 1, 1, 1, 1]"
15930,1,1,2,0.5642626309593289,"[1, 0, 1, 1, 1, 0, 1, 1, 0, 1]"
15931,1,1,2,0.9888702755353823,"[0, 0, 1, 1, 1, 1, 1, 0, 0, 0]"
15932,2,2,4,0.8251731077475815,"[0, 0, 1, 1, 1, 1, 0, 0, 0, 0]"
15933,1,1,2,0.08233967401465458,"[0, 1, 1, 1, 0, 1, 0, 0, 0, 1]"
15934,2,2,4,0.7944992987919214,"[0, 1, 1, 1, 1, 0, 1, 1, 0, 0]"
15935,1,1,2,0.00017681898944110763,"[0, 0, 1, 1, 0, 0, 1, 1, 0, 1]"
15936,1,1,2,0.9397989269916723,"[0, 1, 0, 1, 0, 1, 1, 1, 1, 1]"
15937,1,1,2,0.9629730539940146,"[0, 1, 1, 1, 1, 1, 0, 1, 1, 0]"
15938,1,1,2,0.3586509779196926,"[0, 0, 1, 1, 1, 1, 0, 0, 1, 1]"
15939,1,1,2,0.269340605643395,"[1, 0, 0, 0, 0, 0, 1, 0, 0, 0]"
15940,1,1,2,0.08424383556198001,"[1, 1, 1, 1, 1, 1, 1, 0, 0, 1]"
15941,1,1,2,0.6202211676859376,"[0, 0, 1, 1, 0, 1, 1, 1, 0, 0]"
15942,1,1,2,0.29115486621439546,"[1, 1, 1, 1, 0, 0, 0, 0, 0, 1]"
15943,1,1,2,0.8462119064703871,"[0, 1, 1, 0, 0, 1, 1, 0, 0, 1]"
15944,1,1,2,0.752415869947896,"[1, 1, 1, 1, 0, 1, 1, 1, 1, 1]"
15945,1,1,2,0.49734581822895896,"[1, 1, 0, 1, 0, 0, 1, 0, 1, 0]"
15946,1,1,2,0.8591112973965264,"[1, 0, 1, 0, 1, 1, 0, 1, 0, 0]"
15947,1,1,2,0.2539664677090254,"[0, 0, 1, 0, 1, 0, 0, 0, 1, 1]"
15948,1,1,2,0.6550856784671871,"[0, 0, 0, 1, 0, 0, 1, 1, 1, 1]"
15949,1,1,2,0.7591448465125589,"[0, 1, 1, 0, 0, 1, 0, 1, 1, 0]"
15950,1,1,2,0.33953732038708806,"[0, 1, 1, 1, 0, 1, 0, 0, 0, 1]"
15951,1,1,2,0.5515740256845579,"[0, 1, 0, 0, 1, 1, 0, 0, 0, 1]"
15952,1,1,2,0.13232553267399572,"[1, 0, 1, 1, 1, 1, 1, 1, 0, 1]"
15953,1,1,2,0.8745537242281156,"[1, 0, 0, 0, 0, 1, 0, 1, 1, 1]"
15954,1,1,2,0.27916938610765496,"[1, 0, 0, 0, 1, 1, 0, 1, 0, 0]"
15955,1,1,2,0.02215507327051569,"[1, 1, 0, 0, 1, 0, 0, 0, 1, 0]"
15956,1,1,2,0.10693066203925738,"[0, 1, 1, 0, 1, 0, 1, 0, 0, 0]"
15957,2,2,4,0.6051302226105775,"[1, 1, 1, 1, 0, 1, 0, 0, 0, 0]"
15958,1,1,2,0.5389180847327896,"[0, 0, 0, 0, 1, 0, 1, 1, 0, 0]"
15959,1,1,2,0.09197604771619916,"[0, 0, 1, 0, 1, 0, 1, 1, 1, 1]"
15960,1,1,2,0.32914144087388564,"[1, 0, 1, 0, 1, 1, 0, 1, 1, 0]"
15961,1,1,2,0.21983943628277747,"[1, 0, 1, 1, 0, 1, 1, 1, 0, 0]"
15962,1,1,2,0.7922687056164589,"[0, 0, 0, 0, 0, 0, 1, 1, 0, 0]"
15963,2,2,4,0.5839446218856666,"[1, 1, 1, 0, 1, 0, 1, 1, 0, 1]"
15964,1,1,2,0.8523029558925811,"[1, 0, 0, 1, 0, 0, 1, 0, 1, 1]"
15965,1,1,2,0.08461454017589032,"[1, 1, 1, 0, 0, 1, 0, 0, 1, 1]"
15966,1,1,2,0.8764996838502095,"[0, 1, 1, 0, 1, 1, 0, 0, 0, 1]"
15967,1,1,2,0.9831151177025076,"[0, 0, 1, 0, 0, 1, 1, 0, 0, 0]"
15968,1,1,2,0.4948763609395772,"[0, 1, 0, 0, 0, 0, 1, 1, 0, 1]"
15969,1,1,2,0.33236684389902416,"[1, 1, 0, 1, 1, 0, 1, 1, 0, 0]"
15970,1,1,2,0.7787759088217021,"[1, 1, 0, 1, 1, 0, 1, 1, 0, 0]"
15971,1,1,2,0.7722692044980738,"[0, 0, 1, 0, 0, 0, 1, 0, 1, 1]"
15972,1,1,2,0.24313962886532103,"[1, 0, 1, 1, 1, 1, 1, 0, 0, 0]"
15973,1,1,2,0.7865022837057271,"[1, 0, 0, 0, 1, 1, 1, 1, 1, 1]"
15974,1,1,2,0.38182606117934437,"[1, 0, 0, 1, 1, 1, 1, 1, 0, 1]"
15975,1,1,2,0.6242712336305068,"[1, 1, 1, 1, 0, 0, 0, 0, 1, 1]"
15976,1,1,2,0.17263215798327236,"[1, 0, 1, 1, 0, 1, 1, 0, 0, 0]"
15977,1,1,2,0.25112275126085204,"[1, 0, 0, 0, 0, 1, 1, 1, 0, 0]"
15978,1,1,2,0.70821228142295,"[0, 0, 1, 1, 0, 1, 1, 1, 1, 1]"
15979,1,1,2,0.7130278089481662,"[1, 1, 0, 1, 0, 1, 0, 1, 1, 1]"
15980,1,1,2,0.5454421263958591,"[1, 1, 0, 1, 1, 1, 0, 1, 0, 1]"
15981,1,1,2,0.6031635790260855,"[1, 1, 0, 0, 1, 1, 1, 1, 0, 1]"
15982,1,1,2,0.43811810261596285,"[1, 1, 1, 0, 0, 0, 0, 0, 0, 1]"
15983,1,1,2,0.06123376976078154,"[1, 0, 0, 1, 0, 1, 0, 1, 1, 0]"
15984,1,1,2,0.5477853656951149,"[0, 1, 1, 1, 0, 1, 0, 1, 0, 1]"
15985,2,2,4,0.39267525571985384,"[1, 0, 0, 0, 1, 1, 1, 0, 1, 0]"
15986,1,1,2,0.5339271678681631,"[0, 0, 1, 1, 0, 0, 1, 1, 1, 0]"
15987,2,2,4,0.2648164185278301,"[1, 1, 0, 0, 0, 0, 1, 1, 0, 0]"
15988,1,1,2,0.35042254745073953,"[0, 0, 1, 0, 0, 1, 1, 1, 1, 0]"
15989,1,1,2,0.43205370269219356,"[1, 0, 0, 0, 1, 0, 1, 1, 0, 1]"
15990,1,1,2,0.7128025469889125,"[0, 0, 1, 0, 1, 1, 1, 0, 1, 0]"
15991,1,1,2,0.8150145120948985,"[0, 1, 0, 1, 1, 0, 1, 0, 1, 0]"
15992,1,1,2,0.5537392452456681,"[1, 0, 0, 0, 1, 1, 1, 0, 1, 1]"
15993,1,1,2,0.26621299203814763,"[0, 1, 0, 0, 1, 0, 1, 1, 1, 0]"
15994,2,2,4,0.22276324178005125,"[1, 0, 1, 0, 1, 1, 0, 0, 0, 1]"
15995,1,1,2,0.9936965500535544,"[0, 0, 1, 0, 0, 1, 1, 1, 1, 1]"
15996,1,1,2,0.5086262672138496,"[1, 0, 1, 0, 1, 0, 1, 0, 1, 0]"
15997,1,1,2,0.8692705960657556,"[1, 1, 1, 0, 0, 1, 0, 0, 1, 1]"
15998,1,1,2,0.5180111455564349,"[1, 0, 1, 1, 1, 1, 1, 1, 1, 0]"
15999,1,1,2,0.2922158055468269,"[0, 0, 0, 1, 0, 0, 0, 0, 0, 1]"
16000,1,1,2,0.5438294167266843,"[1, 0, 1, 0, 1, 0, 1, 0, 0, 0]"
16001,1,1,2,0.0006700007509672368,"[1, 1, 1, 0, 1, 0, 0, 0, 0, 0]"
16002,1,1,2,0.31243869543699143,"[1, 1, 0, 0, 1, 0, 0, 1, 1, 1]"
16003,1,1,2,0.9322597688132916,"[1, 1, 0, 1, 0, 0, 1, 1, 1, 1]"
16004,1,1,2,0.48271979264175047,"[0, 1, 1, 1, 0, 0, 0, 1, 0, 1]"
16005,1,1,2,0.17623187977223886,"[1, 0, 0, 1, 1, 1, 1, 0, 0, 1]"
16006,1,1,2,0.22118136445312542,"[0, 0, 0, 1, 1, 0, 1, 1, 1, 0]"
16007,1,1,2,0.4244362821493991,"[1, 0, 1, 1, 0, 0, 1, 1, 0, 0]"
16008,1,1,2,0.09539348476891718,"[1, 0, 1, 0, 0, 0, 1, 1, 1, 0]"
16009,2,2,4,0.7313073355505268,"[1, 0, 1, 0, 1, 0, 1, 0, 1, 1]"
16010,1,1,2,0.9648681958424251,"[1, 0, 0, 1, 1, 0, 1, 1, 1, 1]"
16011,1,1,2,0.3634677167570297,"[1, 1, 0, 0, 1, 0, 0, 1, 0, 0]"
16012,1,1,2,0.16625164159218542,"[0, 1, 0, 0, 1, 0, 0, 1, 1, 0]"
16013,1,1,2,0.16506566564796876,"[1, 1, 1, 1, 0, 0, 0, 1, 0, 0]"
16014,1,1,2,0.8618392259360824,"[0, 1, 0, 1, 1, 1, 1, 1, 0, 0]"
16015,1,1,2,0.9870210135527349,"[1, 1, 1, 0, 1, 0, 0, 0, 0, 1]"
16016,1,1,2,0.5695825608758847,"[1, 0, 0, 0, 0, 0, 1, 0, 1, 0]"
16017,1,1,2,0.8430146920699849,"[0, 0, 0, 0, 0, 0, 0, 1, 0, 1]"
16018,2,2,4,0.48692327319043494,"[0, 1, 0, 1, 1, 1, 1, 1, 0, 0]"
16019,1,1,2,0.5076928027817723,"[1, 0, 1, 1, 1, 0, 0, 0, 0, 1]"
16020,1,1,2,0.5114395966670514,"[0, 1, 0, 1, 1, 0, 0, 1, 1, 0]"
16021,1,1,2,0.46505710051029636,"[0, 0, 1, 1, 0, 1, 0, 0, 0, 1]"
16022,1,1,2,0.8344539323300781,"[1, 0, 1, 1, 0, 1, 0, 1, 0, 1]"
16023,2,2,4,0.35506450270334367,"[1, 1, 0, 1, 0, 1, 0, 0, 0, 1]"
16024,1,1,2,0.8552247736149658,"[0, 1, 0, 0, 0, 0, 1, 1, 1, 1]"
16025,1,1,2,0.2904790983212294,"[0, 0, 1, 0, 0, 0, 0, 1, 1, 1]"
16026,1,1,2,0.7227947682460506,"[0, 0, 1, 0, 0, 1, 1, 1, 0, 0]"
16027,1,1,2,0.9392953481461007,"[0, 0, 0, 0, 0, 0, 0, 1, 0, 0]"
16028,1,1,2,0.45745993055224576,"[1, 0, 1, 1, 0, 0, 0, 1, 0, 0]"
16029,1,1,2,0.8012151248367243,"[0, 1, 0, 0, 0, 1, 0, 0, 1, 0]"
16030,1,1,2,0.589128855208181,"[0, 0, 1, 1, 0, 1, 1, 0, 0, 0]"
16031,1,1,2,0.26979703357496565,"[0, 1, 0, 1, 0, 1, 1, 0, 1, 0]"
16032,1,1,2,0.0812154479211964,"[0, 0, 0, 0, 1, 0, 1, 1, 0, 1]"
16033,2,2,4,0.4859636357248053,"[1, 1, 1, 1, 1, 0, 0, 1, 1, 1]"
16034,1,1,2,0.041648098610625905,"[0, 1, 1, 0, 0, 0, 0, 1, 0, 0]"
16035,1,1,2,0.998606222783128,"[1, 0, 0, 1, 0, 1, 1, 1, 0, 1]"
16036,1,1,2,0.6204387920124556,"[1, 1, 0, 0, 0, 1, 0, 0, 1, 1]"
16037,1,1,2,0.6328302109465398,"[0, 0, 1, 1, 0, 0, 1, 0, 0, 0]"
16038,1,1,2,0.37872810905572496,"[0, 0, 1, 1, 1, 1, 0, 1, 1, 1]"
16039,1,1,2,0.8363475398839136,"[0, 1, 1, 1, 0, 0, 0, 0, 1, 1]"
16040,1,1,2,0.4176800059086676,"[0, 0, 0, 0, 0, 0, 1, 1, 0, 1]"
16041,1,1,2,0.04414193483418871,"[0, 0, 0, 0, 0, 1, 0, 1, 0, 0]"
16042,1,1,2,0.8199610917218924,"[1, 0, 1, 1, 1, 0, 1, 1, 1, 0]"
16043,1,1,2,0.5697379766067476,"[0, 1, 1, 0, 1, 1, 1, 1, 1, 0]"
16044,1,1,2,0.3343540738894636,"[1, 1, 0, 1, 0, 0, 0, 1, 0, 0]"
16045,1,1,2,0.44180628007208544,"[0, 1, 1, 0, 1, 0, 0, 1, 0, 0]"
16046,1,1,2,0.27143586363957406,"[0, 1, 0, 0, 0, 1, 1, 0, 0, 1]"
16047,1,1,2,0.4850377203519023,"[1, 1, 1, 0, 0, 1, 0, 0, 1, 1]"
16048,2,2,4,0.26132276490059503,"[0, 1, 1, 0, 1, 0, 1, 1, 1, 1]"
16049,1,1,2,0.39484823508121714,"[0, 0, 1, 1, 0, 0, 0, 0, 1, 1]"
16050,1,1,2,0.10184593198621361,"[1, 0, 0, 1, 0, 0, 1, 0, 1, 0]"
16051,1,1,2,0.03707029888061231,"[1, 0, 0, 0, 1, 1, 1, 1, 0, 1]"
16052,1,1,2,0.44304837796695795,"[1, 0, 0, 0, 1, 1, 0, 1, 0, 0]"
16053,1,1,2,0.4749682281561298,"[0, 0, 1, 0, 1, 1, 1, 0, 0, 0]"
16054,1,1,2,0.04388556857320047,"[1, 0, 0, 0, 0, 1, 1, 1, 0, 1]"
16055,1,1,2,0.4841155251343773,"[0, 0, 1, 1, 1, 1, 0, 1, 0, 0]"
16056,1,1,2,0.3757083800587334,"[0, 1, 1, 1, 1, 0, 0, 0, 0, 0]"
16057,1,1,2,0.6957475350630566,"[0, 0, 1, 0, 1, 0, 1, 0, 0, 1]"
16058,1,1,2,0.6074990081129699,"[0, 0, 1, 1, 1, 1, 0, 0, 1, 0]"
16059,1,1,2,0.6599701331054498,"[0, 1, 0, 1, 1, 1, 0, 0, 0, 1]"
16060,1,1,2,0.2619402954867447,"[0, 1, 1, 1, 0, 0, 0, 1, 0, 0]"
16061,1,1,2,0.4429376514460681,"[0, 0, 1, 0, 1, 1, 1, 1, 1, 0]"
16062,1,1,2,0.21862548241206392,"[1, 0, 0, 0, 0, 1, 1, 0, 0, 1]"
16063,1,1,2,0.9966111205888778,"[0, 0, 1, 1, 0, 0, 0, 0, 0, 0]"
16064,2,2,4,0.72478463381953,"[1, 0, 1, 1, 1, 0, 0, 1, 1, 1]"
16065,1,1,2,0.2735399665313819,"[0, 0, 0, 0, 1, 0, 0, 1, 0, 1]"
16066,1,1,2,0.645555463019024,"[1, 1, 1, 0, 0, 0, 0, 1, 0, 0]"
16067,2,2,4,0.22917477296099587,"[1, 0, 0, 0, 0, 1, 0, 0, 0, 1]"
16068,1,1,2,0.8598218170165658,"[0, 0, 0, 0, 0, 1, 1, 1, 0, 1]"
16069,1,1,2,0.7870481956887468,"[0, 1, 0, 0, 1, 0, 0, 1, 1, 1]"
16070,1,1,2,0.13060106396565585,"[0, 0, 0, 0, 1, 0, 1, 0, 0, 1]"
16071,1,1,2,0.22530302722558138,"[0, 0, 1, 0, 0, 0, 0, 1, 0, 0]"
16072,1,1,2,0.11392239117035763,"[0, 0, 1, 0, 1, 1, 0, 1, 0, 0]"
16073,1,1,2,0.24435559912652371,"[0, 1, 1, 1, 1, 1, 1, 0, 0, 1]"
16074,1,1,2,0.9242102075604554,"[1, 0, 1, 0, 1, 1, 0, 0, 0, 0]"
16075,1,1,2,0.8686840983709591,"[0, 0, 1, 1, 1, 1, 1, 1, 1, 0]"
16076,1,1,2,0.42866185283461744,"[0, 0, 0, 1, 0, 1, 0, 0, 0, 0]"
16077,1,1,2,0.7340880415213376,"[0, 1, 1, 1, 0, 0, 0, 0, 0, 1]"
16078,1,1,2,0.02787442668568174,"[0, 1, 0, 1, 0, 1, 0, 0, 0, 0]"
16079,1,1,2,0.4176429139745753,"[1, 1, 1, 0, 1, 0, 1, 1, 1, 1]"
16080,1,1,2,0.9931215808489555,"[1, 0, 0, 0, 1, 0, 0, 0, 0, 0]"
16081,1,1,2,0.8718460179130294,"[1, 1, 0, 1, 1, 1, 0, 0, 0, 0]"
16082,1,1,2,0.060217039961759755,"[0, 0, 0, 0, 1, 0, 0, 0, 1, 1]"
16083,1,1,2,0.24225334436182822,"[1, 0, 1, 0, 0, 0, 0, 0, 0, 1]"
16084,1,1,2,0.6650990335312704,"[1, 1, 1, 1, 1, 1, 1, 0, 1, 1]"
16085,2,2,4,0.06234464283295804,"[0, 0, 0, 0, 0, 1, 1, 1, 0, 0]"
16086,1,1,2,0.42649282535132527,"[0, 0, 0, 0, 0, 0, 0, 1, 0, 1]"
16087,1,1,2,0.5781554642437535,"[1, 1, 1, 0, 0, 0, 1, 1, 1, 0]"
16088,1,1,2,0.7172946068872633,"[1, 1, 0, 0, 0, 1, 1, 1, 1, 1]"
16089,1,1,2,0.7353604835937069,"[0, 1, 0, 1, 1, 1, 1, 0, 1, 0]"
16090,1,1,2,0.9097309459535301,"[0, 1, 0, 1, 0, 1, 1, 1, 0, 0]"
16091,1,1,2,0.2602646794626726,"[1, 0, 1, 1, 0, 0, 1, 1, 1, 1]"
16092,1,1,2,0.743396820758263,"[1, 0, 0, 1, 1, 1, 1, 0, 1, 1]"
16093,1,1,2,0.16677119501382676,"[1, 0, 1, 1, 1, 0, 1, 0, 1, 1]"
16094,1,1,2,0.8179914014912996,"[0, 1, 0, 1, 0, 0, 1, 0, 1, 0]"
16095,1,1,2,0.5198805641197549,"[1, 1, 1, 0, 0, 1, 0, 0, 1, 1]"
16096,2,2,4,0.5301645381926033,"[1, 0, 0, 1, 0, 0, 1, 0, 0, 0]"
16097,2,2,4,0.2612565973494071,"[1, 1, 1, 1, 0, 1, 1, 0, 0, 1]"
16098,1,1,2,0.5213313151224221,"[1, 1, 0, 1, 1, 0, 0, 1, 0, 1]"
16099,1,1,2,0.5815106289161865,"[0, 1, 1, 0, 1, 1, 0, 0, 0, 1]"
16100,1,1,2,0.9895439653783468,"[1, 0, 1, 0, 0, 0, 1, 0, 0, 0]"
16101,1,1,2,0.726892520067482,"[1, 1, 0, 1, 1, 0, 0, 1, 0, 1]"
16102,2,2,4,0.7216325272552779,"[0, 1, 1, 0, 0, 1, 1, 0, 1, 1]"
16103,1,1,2,0.794937422904226,"[1, 1, 1, 1, 1, 0, 0, 0, 0, 0]"
16104,1,1,2,0.5237286733303373,"[0, 0, 1, 0, 1, 0, 0, 1, 1, 0]"
16105,2,2,4,0.8638534567737978,"[1, 1, 0, 0, 0, 1, 0, 0, 0, 1]"
16106,1,1,2,0.42389692738206963,"[0, 0, 1, 1, 1, 1, 0, 1, 0, 0]"
16107,1,1,2,0.6699271844506045,"[0, 1, 0, 1, 1, 0, 0, 0, 1, 0]"
16108,1,1,2,0.31278350598579097,"[1, 0, 0, 1, 0, 1, 0, 0, 0, 0]"
16109,2,2,4,0.874437818768573,"[0, 0, 1, 0, 1, 1, 0, 0, 0, 1]"
16110,2,2,4,0.8200630220366711,"[1, 0, 1, 0, 0, 1, 1, 0, 1, 0]"
16111,1,1,2,0.6664881623811751,"[1, 1, 1, 1, 1, 1, 1, 0, 0, 1]"
16112,3,3,6,0.3630532483777402,"[0, 1, 0, 0, 0, 0, 0, 1, 0, 1]"
16113,1,1,2,0.32025554213485685,"[0, 0, 0, 0, 1, 1, 0, 1, 0, 1]"
16114,1,1,2,0.3027965824587878,"[0, 1, 0, 1, 1, 1, 1, 0, 1, 0]"
16115,1,1,2,0.5976634420779353,"[0, 1, 0, 1, 1, 1, 0, 1, 1, 0]"
16116,1,1,2,0.626661611960566,"[1, 1, 1, 0, 1, 1, 1, 1, 0, 0]"
16117,1,1,2,0.27600751987303374,"[0, 1, 0, 1, 0, 0, 0, 1, 0, 0]"
16118,1,1,2,0.16602076724291026,"[0, 0, 0, 1, 0, 1, 1, 1, 1, 1]"
16119,1,1,2,0.810403938891672,"[0, 1, 1, 0, 1, 0, 1, 1, 1, 0]"
16120,1,1,2,0.09673364251861805,"[1, 0, 1, 1, 1, 1, 1, 0, 0, 1]"
16121,1,1,2,0.6091703565662252,"[1, 0, 1, 0, 0, 1, 1, 1, 0, 1]"
16122,1,1,2,0.6888642507164718,"[0, 1, 0, 1, 0, 0, 0, 0, 1, 0]"
16123,1,1,2,0.36240767875728286,"[0, 1, 1, 0, 1, 1, 1, 1, 0, 1]"
16124,1,1,2,0.47271224569140846,"[0, 1, 1, 1, 0, 1, 0, 1, 1, 0]"
16125,3,3,6,0.9027307088366978,"[1, 1, 0, 1, 1, 1, 0, 1, 1, 1]"
16126,1,1,2,0.8343797448514956,"[0, 1, 1, 0, 1, 1, 0, 0, 1, 1]"
16127,1,1,2,0.19421193426266892,"[0, 1, 0, 1, 0, 1, 1, 0, 0, 1]"
16128,2,2,4,0.6652051993630379,"[0, 1, 0, 1, 1, 0, 1, 1, 1, 1]"
16129,1,1,2,0.7385310589954666,"[0, 1, 0, 1, 1, 1, 0, 1, 0, 1]"
16130,1,1,2,0.41185237623226867,"[0, 1, 1, 0, 1, 1, 1, 1, 1, 0]"
16131,1,1,2,0.8341562320466572,"[0, 0, 0, 0, 1, 1, 0, 0, 1, 0]"
16132,2,2,4,0.41712559672178295,"[0, 0, 1, 0, 0, 1, 1, 0, 0, 0]"
16133,2,2,4,0.2191657929353824,"[1, 0, 1, 0, 1, 0, 1, 0, 0, 1]"
16134,1,1,2,0.8741706668394631,"[1, 0, 0, 1, 1, 0, 0, 0, 1, 1]"
16135,1,1,2,0.11968938708534549,"[1, 0, 0, 0, 0, 1, 0, 1, 0, 1]"
16136,1,1,2,0.2947138630702233,"[0, 0, 0, 1, 0, 0, 1, 1, 1, 1]"
16137,1,1,2,0.4849738220831632,"[1, 1, 0, 0, 1, 1, 0, 1, 0, 0]"
16138,1,1,2,0.04070927929725077,"[0, 0, 1, 1, 1, 1, 1, 0, 1, 0]"
16139,1,1,2,0.6670863851250782,"[1, 0, 0, 0, 0, 0, 0, 1, 0, 0]"
16140,1,1,2,0.9703183839483491,"[0, 0, 1, 1, 1, 1, 0, 0, 1, 0]"
16141,1,1,2,0.6219522823643077,"[1, 0, 0, 0, 0, 1, 0, 1, 1, 1]"
16142,2,2,4,0.8657849579558935,"[1, 0, 0, 1, 0, 0, 0, 0, 0, 1]"
16143,1,1,2,0.6854260483976947,"[1, 1, 0, 1, 0, 0, 0, 0, 0, 1]"
16144,1,1,2,0.06651790076464292,"[0, 1, 1, 1, 1, 0, 1, 1, 0, 1]"
16145,1,1,2,0.1599599980722598,"[1, 1, 1, 1, 1, 1, 0, 0, 0, 0]"
16146,1,1,2,0.1599148144043343,"[0, 0, 0, 0, 0, 1, 0, 1, 0, 0]"
16147,1,1,2,0.6265110521372007,"[0, 0, 1, 0, 0, 1, 0, 1, 1, 1]"
16148,1,1,2,0.6477526257118409,"[1, 0, 0, 0, 1, 0, 0, 0, 1, 0]"
16149,1,1,2,0.33544650593703174,"[0, 0, 0, 1, 1, 1, 1, 1, 0, 1]"
16150,1,1,2,0.8494524044274171,"[0, 1, 1, 1, 0, 1, 1, 0, 0, 0]"
16151,1,1,2,0.9654473299926554,"[1, 1, 0, 0, 1, 1, 1, 0, 0, 0]"
16152,1,1,2,0.4184617106016325,"[0, 1, 1, 1, 0, 1, 0, 0, 0, 1]"
16153,1,1,2,0.28461085803848885,"[0, 0, 0, 1, 0, 1, 1, 0, 0, 0]"
16154,1,1,2,0.859011850380785,"[0, 1, 1, 1, 1, 0, 1, 1, 0, 1]"
16155,1,1,2,0.9103331833866197,"[0, 1, 0, 1, 0, 0, 1, 0, 1, 0]"
16156,2,2,4,0.9472385739994355,"[0, 1, 1, 1, 0, 1, 1, 0, 0, 1]"
16157,1,1,2,0.7108898815364304,"[0, 1, 0, 0, 1, 1, 0, 1, 0, 1]"
16158,1,1,2,0.9544867889085717,"[0, 0, 1, 0, 0, 1, 1, 1, 0, 1]"
16159,1,1,2,0.176199570791846,"[1, 0, 1, 1, 1, 1, 1, 1, 1, 0]"
16160,1,1,2,0.40094283976918976,"[0, 1, 0, 0, 0, 1, 1, 1, 1, 0]"
16161,1,1,2,0.5502911213617822,"[1, 0, 1, 1, 1, 1, 1, 0, 0, 0]"
16162,1,1,2,0.017542983094861908,"[0, 1, 1, 1, 1, 1, 1, 0, 1, 0]"
16163,1,1,2,0.7137092949191585,"[0, 1, 0, 0, 0, 1, 0, 1, 1, 0]"
16164,1,1,2,0.6852514965973957,"[0, 1, 0, 1, 1, 0, 1, 1, 0, 0]"
16165,1,1,2,0.8785671408870646,"[0, 0, 0, 1, 0, 0, 0, 0, 0, 0]"
16166,1,1,2,0.41751731824746297,"[0, 1, 1, 1, 1, 0, 1, 0, 1, 1]"
16167,1,1,2,0.3992136080500952,"[0, 0, 1, 0, 1, 0, 1, 1, 1, 1]"
16168,1,1,2,0.8428257522384164,"[0, 1, 0, 0, 1, 0, 1, 0, 1, 0]"
16169,1,1,2,0.3267486565338602,"[0, 1, 1, 0, 1, 1, 1, 0, 1, 1]"
16170,1,1,2,0.04003485311673549,"[0, 1, 0, 0, 1, 1, 1, 0, 1, 0]"
16171,1,1,2,0.49417347160684355,"[0, 0, 1, 1, 0, 1, 0, 0, 1, 0]"
16172,1,1,2,0.04430877284265056,"[1, 1, 1, 1, 0, 1, 1, 0, 0, 1]"
16173,1,1,2,0.006566370657797638,"[0, 1, 0, 1, 0, 1, 0, 0, 1, 1]"
16174,1,1,2,0.3776046282734826,"[1, 0, 1, 0, 0, 1, 1, 1, 0, 0]"
16175,1,1,2,0.11099770781005047,"[0, 0, 1, 1, 0, 0, 0, 0, 0, 1]"
16176,1,1,2,0.2844207225430816,"[1, 0, 1, 0, 1, 1, 0, 0, 0, 1]"
16177,1,1,2,0.06022394612337845,"[0, 1, 0, 0, 0, 0, 1, 0, 0, 0]"
16178,1,1,2,0.1997450827737155,"[0, 0, 0, 1, 0, 1, 1, 1, 1, 0]"
16179,1,1,2,0.910112796819504,"[1, 1, 0, 0, 0, 0, 1, 0, 1, 0]"
16180,3,3,6,0.5026978601166381,"[1, 1, 0, 0, 0, 0, 1, 0, 1, 1]"
16181,1,1,2,0.9567994753314443,"[0, 1, 0, 1, 1, 1, 1, 1, 0, 0]"
16182,1,1,2,0.36193225297767284,"[1, 0, 0, 0, 0, 1, 0, 0, 1, 0]"
16183,1,1,2,0.29074629472791447,"[0, 1, 1, 1, 1, 1, 0, 1, 0, 1]"
16184,1,1,2,0.6904494075279224,"[0, 1, 1, 0, 0, 1, 0, 0, 0, 1]"
16185,1,1,2,0.5471595001835372,"[0, 0, 0, 0, 0, 0, 0, 1, 1, 1]"
16186,1,1,2,0.11860164180628785,"[1, 0, 1, 0, 0, 1, 0, 1, 1, 0]"
16187,1,1,2,0.02952664323394727,"[1, 1, 1, 0, 0, 0, 1, 0, 1, 0]"
16188,3,3,6,0.16394490732940237,"[1, 0, 1, 1, 1, 1, 0, 1, 1, 1]"
16189,1,1,2,0.6246240109936103,"[1, 1, 1, 0, 0, 1, 0, 0, 1, 0]"
16190,1,1,2,0.048332500855120863,"[1, 1, 1, 0, 1, 0, 1, 0, 0, 0]"
16191,1,1,2,0.1696772231202035,"[1, 0, 1, 0, 1, 0, 0, 0, 1, 0]"
16192,1,1,2,0.4115126698994893,"[1, 1, 1, 0, 1, 1, 0, 0, 0, 0]"
16193,1,1,2,0.3968433160486944,"[0, 0, 0, 0, 1, 0, 0, 1, 0, 0]"
16194,1,1,2,0.7688847938663271,"[1, 0, 1, 0, 1, 0, 1, 0, 0, 0]"
16195,2,2,4,0.3124475840870271,"[0, 1, 0, 0, 1, 1, 0, 0, 1, 1]"
16196,1,1,2,0.12396083547413972,"[0, 0, 1, 1, 1, 1, 0, 1, 1, 0]"
16197,1,1,2,0.5522665715215805,"[1, 1, 1, 0, 1, 1, 0, 1, 0, 0]"
16198,1,1,2,0.8552056670452474,"[0, 1, 0, 1, 1, 0, 0, 0, 0, 0]"
16199,1,1,2,0.06423010886068248,"[0, 0, 0, 1, 1, 1, 0, 0, 0, 1]"
16200,1,1,2,0.5789375693349783,"[1, 1, 1, 1, 0, 1, 1, 0, 0, 1]"
16201,1,1,2,0.7569305111927103,"[0, 1, 1, 1, 1, 1, 1, 0, 0, 0]"
16202,1,1,2,0.8053038827394381,"[0, 1, 1, 1, 1, 0, 1, 1, 1, 1]"
16203,1,1,2,0.8775050155601647,"[1, 1, 0, 1, 0, 0, 1, 0, 1, 1]"
16204,1,1,2,0.20229047654468424,"[1, 0, 0, 1, 0, 1, 1, 0, 0, 0]"
16205,1,1,2,0.8143761032695366,"[1, 1, 0, 0, 0, 1, 1, 0, 1, 0]"
16206,1,1,2,0.5131501765019296,"[1, 0, 1, 1, 0, 0, 1, 1, 0, 0]"
16207,1,1,2,0.4543680149560759,"[0, 1, 0, 0, 1, 0, 0, 1, 0, 0]"
16208,1,1,2,0.6825890081113877,"[1, 1, 1, 0, 0, 1, 0, 1, 0, 1]"
16209,1,1,2,0.9691397368793097,"[1, 1, 0, 0, 1, 1, 1, 1, 1, 1]"
16210,1,1,2,0.9425631859934829,"[1, 0, 1, 1, 1, 0, 0, 1, 0, 1]"
16211,1,1,2,0.38804603184886044,"[0, 1, 1, 0, 0, 0, 0, 0, 1, 1]"
16212,1,1,2,0.34189008387849107,"[1, 1, 1, 0, 0, 1, 0, 1, 0, 0]"
16213,1,1,2,0.7196131996628553,"[1, 0, 1, 1, 0, 0, 0, 0, 1, 1]"
16214,1,1,2,0.5856425499271956,"[1, 0, 1, 1, 1, 0, 1, 1, 1, 0]"
16215,1,1,2,0.40871343126267035,"[0, 1, 0, 0, 0, 1, 0, 1, 1, 1]"
16216,1,1,2,0.8352012020799447,"[0, 1, 0, 0, 1, 0, 1, 0, 0, 0]"
16217,1,1,2,0.5088800802752111,"[0, 1, 0, 0, 1, 1, 0, 0, 1, 1]"
16218,1,1,2,0.3679539817954456,"[1, 0, 0, 1, 1, 0, 1, 0, 1, 1]"
16219,2,2,4,0.8862293566099586,"[1, 1, 0, 1, 0, 1, 1, 0, 0, 0]"
16220,1,1,2,0.30932629878513807,"[1, 1, 0, 0, 0, 0, 0, 1, 0, 0]"
16221,1,1,2,0.9230407200170351,"[0, 0, 1, 1, 0, 1, 1, 0, 0, 1]"
16222,1,1,2,0.7784613917683892,"[1, 1, 0, 0, 0, 0, 0, 1, 0, 1]"
16223,1,1,2,0.871350287205513,"[0, 1, 1, 0, 0, 1, 0, 0, 0, 1]"
16224,1,1,2,0.6034225669510028,"[1, 1, 0, 1, 1, 1, 0, 1, 0, 1]"
16225,2,2,4,0.4621409362755502,"[0, 0, 1, 1, 1, 0, 1, 1, 0, 0]"
16226,1,1,2,0.08489087489722735,"[1, 1, 1, 0, 0, 0, 1, 0, 0, 0]"
16227,1,1,2,0.025193507408117988,"[0, 0, 1, 0, 1, 1, 0, 1, 0, 0]"
16228,1,1,2,0.6130318157525514,"[1, 0, 1, 0, 1, 0, 0, 0, 0, 0]"
16229,1,1,2,0.9182746469360198,"[0, 1, 0, 1, 0, 0, 0, 1, 1, 1]"
16230,1,1,2,0.2403528945251605,"[1, 0, 0, 0, 0, 1, 0, 0, 0, 1]"
16231,1,1,2,0.6339811246203466,"[0, 1, 0, 0, 0, 1, 1, 1, 1, 1]"
16232,1,1,2,0.13219993945200992,"[0, 0, 0, 1, 1, 0, 1, 0, 1, 0]"
16233,1,1,2,0.20761561394065797,"[0, 1, 1, 1, 1, 1, 0, 1, 0, 1]"
16234,1,1,2,0.964140180579594,"[0, 0, 1, 1, 0, 0, 1, 0, 0, 1]"
16235,1,1,2,0.6354358047520258,"[0, 0, 1, 1, 0, 1, 0, 1, 1, 0]"
16236,1,1,2,0.7279025607618307,"[0, 0, 0, 1, 1, 1, 1, 1, 0, 1]"
16237,1,1,2,0.41768002800924764,"[0, 0, 1, 1, 1, 1, 1, 1, 0, 1]"
16238,1,1,2,0.9589657957173043,"[0, 0, 1, 1, 1, 1, 0, 1, 0, 1]"
16239,1,1,2,0.5719071617135588,"[0, 1, 1, 1, 1, 0, 0, 0, 1, 0]"
16240,1,1,2,0.2468492049851181,"[0, 0, 0, 1, 0, 1, 0, 0, 1, 1]"
16241,1,1,2,0.45471581865840693,"[0, 0, 1, 1, 0, 1, 1, 0, 1, 0]"
16242,1,1,2,0.351457177777431,"[0, 1, 0, 1, 0, 1, 1, 1, 0, 0]"
16243,1,1,2,0.47733204999517,"[0, 0, 1, 0, 1, 0, 1, 1, 1, 0]"
16244,1,1,2,0.1795374718351478,"[0, 1, 1, 1, 1, 0, 0, 0, 0, 0]"
16245,1,1,2,0.40789481931919724,"[1, 0, 0, 0, 1, 1, 0, 1, 0, 0]"
16246,3,3,6,0.7175739181858483,"[1, 1, 0, 1, 0, 1, 0, 0, 1, 0]"
16247,1,1,2,0.2735379632722289,"[1, 1, 1, 0, 0, 1, 1, 0, 1, 0]"
16248,1,1,2,0.02760629598637121,"[0, 1, 0, 0, 1, 1, 1, 1, 0, 0]"
16249,1,1,2,0.22239605364560067,"[0, 0, 0, 1, 1, 1, 0, 1, 1, 1]"
16250,1,1,2,0.6137445671399699,"[0, 1, 0, 1, 1, 1, 1, 0, 0, 0]"
16251,1,1,2,0.238069469697736,"[0, 1, 1, 0, 1, 0, 1, 1, 1, 1]"
16252,1,1,2,0.4462533077759131,"[1, 0, 1, 0, 1, 0, 0, 0, 1, 1]"
16253,1,1,2,0.2592081697729258,"[1, 0, 0, 0, 1, 1, 1, 0, 1, 0]"
16254,1,1,2,0.8584255456381769,"[0, 1, 1, 1, 0, 1, 1, 0, 1, 0]"
16255,1,1,2,0.946960655692299,"[1, 0, 1, 1, 0, 1, 1, 1, 1, 0]"
16256,1,1,2,0.39291527908290236,"[0, 0, 1, 0, 1, 0, 1, 0, 0, 1]"
16257,1,1,2,0.5010568459102618,"[0, 1, 1, 0, 1, 0, 0, 0, 1, 0]"
16258,1,1,2,0.3083351614268186,"[1, 0, 1, 1, 1, 1, 1, 1, 0, 1]"
16259,1,1,2,0.20541215319426476,"[1, 0, 0, 0, 1, 0, 0, 0, 0, 0]"
16260,1,1,2,0.129333709329858,"[0, 1, 0, 0, 0, 0, 1, 1, 0, 0]"
16261,1,1,2,0.23862329552084027,"[0, 0, 1, 0, 0, 0, 1, 0, 0, 1]"
16262,1,1,2,0.7819525030377681,"[1, 1, 0, 0, 1, 1, 0, 1, 0, 0]"
16263,1,1,2,0.960101726142812,"[0, 0, 0, 1, 0, 0, 1, 1, 1, 0]"
16264,1,1,2,0.124357927335085,"[0, 0, 0, 1, 1, 0, 0, 1, 0, 0]"
16265,1,1,2,0.2854737425749915,"[0, 1, 0, 0, 0, 1, 1, 1, 0, 0]"
16266,1,1,2,0.6481589603522461,"[1, 1, 1, 0, 0, 1, 0, 0, 0, 0]"
16267,1,1,2,0.5545413933814644,"[1, 0, 1, 1, 0, 0, 0, 0, 0, 0]"
16268,1,1,2,0.9997330010134281,"[1, 1, 1, 1, 0, 1, 1, 1, 1, 0]"
16269,1,1,2,0.9445494182407637,"[1, 1, 0, 1, 0, 0, 1, 0, 1, 0]"
16270,1,1,2,0.9570439873318854,"[0, 0, 0, 0, 1, 0, 0, 0, 1, 1]"
16271,2,2,4,0.8346697527921318,"[1, 0, 1, 0, 1, 1, 0, 1, 0, 1]"
16272,1,1,2,0.3726939477638619,"[0, 1, 1, 1, 1, 0, 0, 1, 1, 1]"
16273,2,2,4,0.4111058107444153,"[0, 0, 1, 1, 0, 0, 0, 1, 0, 0]"
16274,1,1,2,0.6223488910665866,"[0, 1, 0, 0, 0, 1, 0, 1, 1, 1]"
16275,1,1,2,0.6665889390943095,"[1, 1, 0, 1, 1, 0, 0, 0, 1, 1]"
16276,1,1,2,0.4898324318641578,"[0, 0, 0, 1, 0, 0, 0, 1, 0, 1]"
16277,1,1,2,0.1835635822177849,"[0, 1, 0, 0, 0, 1, 0, 0, 1, 0]"
16278,1,1,2,0.24047003255396027,"[0, 1, 1, 0, 0, 1, 0, 0, 0, 0]"
16279,1,1,2,0.9057433104678614,"[0, 1, 1, 1, 1, 0, 1, 1, 0, 1]"
16280,1,1,2,0.8704406684596796,"[1, 0, 1, 0, 0, 1, 1, 0, 1, 1]"
16281,1,1,2,0.9515251237679948,"[1, 0, 0, 0, 0, 0, 1, 1, 1, 0]"
16282,1,1,2,0.41408071080848785,"[1, 1, 1, 1, 1, 1, 0, 1, 1, 0]"
16283,1,1,2,0.05044746064758232,"[1, 1, 1, 1, 0, 1, 0, 0, 0, 1]"
16284,1,1,2,0.7827379362668558,"[0, 0, 0, 1, 1, 1, 1, 0, 1, 0]"
16285,1,1,2,0.9338893734211496,"[1, 1, 1, 1, 1, 0, 1, 0, 1, 0]"
16286,1,1,2,0.40224828855115724,"[1, 0, 0, 0, 1, 0, 0, 0, 1, 0]"
16287,1,1,2,0.3541100340719121,"[1, 1, 1, 0, 0, 0, 0, 1, 0, 1]"
16288,1,1,2,0.44382315425039465,"[0, 1, 1, 1, 0, 0, 1, 1, 1, 0]"
16289,1,1,2,0.23264731444397446,"[0, 0, 1, 1, 0, 1, 1, 0, 1, 1]"
16290,1,1,2,0.24354048398767902,"[0, 1, 1, 0, 0, 1, 0, 0, 0, 1]"
16291,1,1,2,0.1877182361230767,"[1, 1, 1, 1, 0, 0, 0, 0, 0, 0]"
16292,1,1,2,0.11620151785760546,"[1, 0, 0, 1, 1, 0, 0, 1, 1, 1]"
16293,1,1,2,0.32039231302172033,"[0, 0, 1, 1, 1, 1, 0, 1, 0, 0]"
16294,1,1,2,0.21844837482220025,"[0, 1, 1, 1, 0, 0, 0, 0, 1, 0]"
16295,1,1,2,0.2548099275447835,"[1, 1, 0, 1, 1, 1, 1, 1, 0, 0]"
16296,1,1,2,0.8781274479965192,"[0, 1, 0, 1, 0, 0, 1, 0, 0, 0]"
16297,1,1,2,0.8957816016112136,"[1, 1, 1, 1, 1, 1, 0, 0, 0, 1]"
16298,1,1,2,0.2947431385717323,"[1, 0, 1, 1, 0, 1, 0, 1, 0, 1]"
16299,1,1,2,0.46418174492119224,"[1, 1, 0, 1, 0, 1, 0, 0, 0, 0]"
16300,1,1,2,0.7985389250305444,"[0, 0, 0, 0, 1, 1, 1, 1, 1, 0]"
16301,1,1,2,0.2392356544367803,"[1, 1, 0, 0, 0, 1, 0, 0, 1, 0]"
16302,1,1,2,0.235756499975998,"[0, 1, 0, 0, 0, 0, 0, 1, 0, 1]"
16303,1,1,2,0.4952869612180334,"[0, 1, 0, 0, 0, 0, 1, 0, 0, 0]"
16304,1,1,2,0.13556650808792625,"[0, 1, 0, 0, 1, 1, 1, 0, 1, 0]"
16305,1,1,2,0.24838761177521418,"[1, 1, 1, 0, 1, 0, 0, 0, 1, 1]"
16306,2,2,4,0.8269173043440079,"[1, 1, 1, 0, 1, 0, 1, 0, 0, 1]"
16307,1,1,2,0.9633582090525774,"[1, 0, 0, 1, 0, 1, 1, 0, 0, 1]"
16308,1,1,2,0.13079859347852918,"[1, 1, 1, 0, 0, 0, 1, 1, 1, 0]"
16309,1,1,2,0.7025354531466471,"[0, 0, 1, 0, 1, 0, 0, 1, 0, 1]"
16310,1,1,2,0.5095418456012459,"[1, 1, 0, 0, 1, 0, 1, 1, 0, 0]"
16311,1,1,2,0.8013272124654688,"[0, 0, 1, 1, 0, 1, 0, 1, 1, 1]"
16312,1,1,2,0.20446787333053806,"[1, 0, 0, 1, 1, 1, 1, 1, 1, 1]"
16313,2,2,4,0.6281157638581613,"[1, 1, 0, 1, 0, 1, 1, 1, 1, 1]"
16314,2,2,4,0.2485935355658121,"[0, 0, 1, 1, 1, 0, 1, 0, 0, 0]"
16315,1,1,2,0.18836632811863796,"[1, 1, 0, 0, 0, 1, 1, 0, 1, 1]"
16316,1,1,2,0.43073583896123213,"[0, 1, 1, 0, 0, 0, 0, 0, 0, 1]"
16317,3,3,6,0.2928616380299762,"[1, 0, 1, 0, 0, 0, 1, 0, 1, 1]"
16318,1,1,2,0.7790583479233839,"[0, 0, 0, 1, 1, 1, 0, 0, 1, 1]"
16319,1,1,2,0.4328012678644688,"[0, 0, 1, 1, 0, 1, 1, 0, 0, 0]"
16320,1,1,2,0.3647556243875254,"[0, 0, 1, 0, 0, 1, 1, 1, 0, 1]"
16321,2,2,4,0.9663447700700498,"[0, 1, 1, 0, 1, 0, 0, 1, 1, 1]"
16322,1,1,2,0.08407022172003964,"[1, 1, 1, 0, 0, 1, 0, 1, 1, 1]"
16323,1,1,2,0.8137746994626947,"[0, 1, 0, 1, 0, 1, 0, 1, 0, 0]"
16324,1,1,2,0.9277728373254188,"[0, 0, 0, 1, 0, 1, 1, 1, 0, 1]"
16325,1,1,2,0.3839645588033572,"[1, 0, 0, 1, 0, 0, 0, 1, 1, 1]"
16326,2,2,4,0.5536174706131033,"[0, 1, 0, 1, 0, 0, 0, 1, 0, 1]"
16327,1,1,2,0.1618336175444658,"[0, 0, 0, 0, 1, 0, 1, 0, 0, 1]"
16328,1,1,2,0.3077000990137426,"[0, 0, 0, 0, 0, 1, 0, 1, 0, 0]"
16329,1,1,2,0.7978632029105805,"[1, 1, 1, 0, 1, 0, 0, 1, 1, 1]"
16330,1,1,2,0.8854513716013719,"[0, 0, 1, 1, 1, 1, 1, 0, 1, 0]"
16331,1,1,2,0.9631137293449535,"[0, 0, 0, 1, 1, 0, 0, 1, 0, 1]"
16332,1,1,2,0.6590461341799235,"[0, 0, 0, 0, 0, 0, 0, 0, 1, 0]"
16333,1,1,2,0.6541350093584946,"[1, 1, 0, 1, 1, 0, 1, 0, 1, 0]"
16334,1,1,2,0.6292116517423584,"[1, 0, 0, 0, 0, 1, 0, 1, 1, 0]"
16335,1,1,2,0.25773470566600865,"[0, 1, 1, 1, 1, 0, 0, 0, 1, 1]"
16336,1,1,2,0.04102725302159094,"[0, 0, 1, 1, 1, 1, 1, 1, 0, 1]"
16337,1,1,2,0.2152481179533342,"[0, 0, 1, 1, 0, 0, 0, 0, 1, 1]"
16338,1,1,2,0.48715827714437054,"[1, 0, 0, 1, 1, 0, 1, 0, 0, 0]"
16339,2,2,4,0.8416305761136458,"[1, 1, 0, 0, 0, 0, 1, 1, 1, 1]"
16340,1,1,2,0.2866335036459592,"[1, 1, 0, 1, 1, 0, 0, 0, 1, 0]"
16341,1,1,2,0.0415108069908392,"[0, 1, 1, 0, 1, 0, 1, 0, 0, 0]"
16342,1,1,2,0.10101802433781093,"[0, 0, 1, 0, 1, 1, 1, 1, 1, 1]"
16343,1,1,2,0.35314310763952617,"[1, 1, 1, 0, 1, 1, 0, 1, 1, 1]"
16344,1,1,2,0.019441070926936588,"[0, 1, 1, 1, 1, 1, 1, 1, 1, 0]"
16345,1,1,2,0.27092164593220003,"[1, 1, 1, 1, 1, 0, 1, 1, 1, 0]"
16346,1,1,2,0.02453309039421292,"[1, 1, 0, 1, 0, 1, 1, 1, 0, 1]"
16347,1,1,2,0.241718692179672,"[1, 1, 1, 0, 1, 0, 0, 1, 1, 1]"
16348,1,1,2,0.9461641788230127,"[0, 1, 0, 0, 1, 0, 1, 1, 1, 1]"
16349,1,1,2,0.779500428323317,"[0, 1, 1, 1, 0, 0, 1, 0, 1, 1]"
16350,1,1,2,0.15823779157423246,"[1, 0, 0, 1, 1, 1, 0, 0, 0, 0]"
16351,1,1,2,0.1574173679083989,"[0, 1, 1, 1, 0, 1, 0, 0, 1, 0]"
16352,1,1,2,0.5969234996146552,"[1, 0, 1, 1, 0, 1, 1, 0, 0, 0]"
16353,1,1,2,0.6043070880161581,"[1, 1, 1, 1, 1, 1, 1, 0, 0, 0]"
16354,1,1,2,0.3283676076941875,"[0, 1, 0, 0, 0, 1, 1, 1, 1, 0]"
16355,1,1,2,0.7285053833432762,"[0, 0, 0, 0, 1, 1, 0, 1, 1, 0]"
16356,1,1,2,0.9205348521708984,"[0, 1, 1, 0, 0, 1, 0, 0, 1, 0]"
16357,1,1,2,0.028636945470418063,"[0, 1, 1, 0, 0, 1, 0, 1, 0, 0]"
16358,1,1,2,0.641099248403879,"[1, 1, 0, 1, 0, 1, 1, 0, 0, 0]"
16359,1,1,2,0.05783248621890269,"[0, 1, 0, 1, 0, 1, 1, 1, 0, 1]"
16360,1,1,2,0.5669195496198254,"[1, 1, 1, 1, 0, 0, 0, 1, 0, 0]"
16361,1,1,2,0.6239011306148717,"[1, 1, 1, 0, 1, 0, 1, 1, 1, 1]"
16362,2,2,4,0.10177289175590787,"[1, 0, 1, 0, 1, 1, 0, 0, 1, 0]"
16363,1,1,2,0.46782276769521813,"[1, 0, 1, 1, 0, 1, 0, 0, 1, 0]"
16364,1,1,2,0.9449569656354088,"[1, 0, 1, 0, 0, 1, 1, 1, 1, 0]"
16365,1,1,2,0.19821982486071377,"[0, 1, 1, 0, 1, 1, 1, 1, 0, 0]"
16366,1,1,2,0.6079719520310429,"[1, 0, 0, 0, 1, 0, 0, 0, 0, 0]"
16367,1,1,2,0.29161828835851356,"[0, 1, 1, 1, 1, 1, 0, 1, 1, 1]"
16368,1,1,2,0.7635386638536212,"[0, 1, 1, 1, 1, 0, 1, 0, 0, 0]"
16369,1,1,2,0.8338342987971129,"[1, 1, 0, 0, 0, 1, 0, 0, 1, 0]"
16370,1,1,2,0.286051732438372,"[0, 0, 1, 1, 0, 0, 0, 1, 1, 1]"
16371,2,2,4,0.5015527977696459,"[1, 0, 1, 1, 1, 1, 0, 1, 1, 0]"
16372,1,1,2,0.12286687096300697,"[0, 1, 0, 0, 0, 0, 1, 0, 1, 0]"
16373,1,1,2,0.5434496948171333,"[1, 0, 1, 1, 1, 1, 0, 1, 1, 0]"
16374,1,1,2,0.7143758538373572,"[0, 0, 1, 1, 1, 1, 1, 1, 1, 1]"
16375,1,1,2,0.2599267764210247,"[1, 1, 1, 1, 0, 0, 1, 0, 0, 1]"
16376,1,1,2,0.0034027297761146658,"[0, 1, 1, 1, 0, 0, 1, 1, 0, 1]"
16377,1,1,2,0.4146308393853777,"[0, 1, 1, 1, 1, 0, 0, 0, 0, 1]"
16378,1,1,2,0.09374785037793076,"[0, 1, 1, 0, 1, 1, 1, 1, 1, 0]"
16379,1,1,2,0.7138178893756448,"[1, 0, 1, 1, 1, 0, 0, 1, 0, 0]"
16380,1,1,2,0.510813851214522,"[0, 1, 0, 1, 0, 1, 1, 0, 1, 0]"
16381,1,1,2,0.013680201129012137,"[0, 0, 0, 1, 0, 1, 1, 1, 0, 1]"
16382,1,1,2,0.9237789046823979,"[1, 1, 1, 0, 0, 1, 1, 1, 0, 1]"
16383,1,1,2,0.2670196757135762,"[1, 1, 0, 1, 1, 1, 0, 0, 1, 0]"
16384,1,1,2,0.6620231307563987,"[1, 1, 0, 1, 1, 1, 0, 0, 0, 1]"
16385,1,1,2,0.5496144786368848,"[0, 0, 1, 1, 1, 1, 0, 0, 1, 0]"
16386,1,1,2,0.5763627116117461,"[1, 0, 1, 0, 0, 1, 1, 1, 1, 0]"
16387,1,1,2,0.7739958996786067,"[1, 0, 0, 0, 0, 1, 0, 0, 1, 0]"
16388,1,1,2,0.8581050493461472,"[0, 1, 1, 1, 0, 1, 1, 1, 0, 0]"
16389,1,1,2,0.12571591266531812,"[1, 1, 1, 0, 1, 1, 1, 1, 1, 0]"
16390,2,2,4,0.6457827965913493,"[1, 1, 1, 0, 1, 0, 1, 0, 1, 0]"
16391,1,1,2,0.059227055010355634,"[1, 1, 1, 1, 0, 0, 1, 1, 1, 0]"
16392,1,1,2,0.47446705636523256,"[1, 0, 0, 1, 0, 1, 0, 0, 0, 0]"
16393,1,1,2,0.5267827492161428,"[0, 0, 1, 0, 1, 1, 0, 1, 0, 0]"
16394,1,1,2,0.34379700449288975,"[1, 1, 0, 1, 0, 0, 0, 0, 0, 1]"
16395,1,1,2,0.27385267748941433,"[0, 0, 1, 0, 1, 0, 0, 0, 0, 0]"
16396,1,1,2,0.7934974128210088,"[1, 1, 0, 1, 0, 0, 1, 1, 0, 0]"
16397,1,1,2,0.6181967718681675,"[1, 0, 1, 0, 1, 0, 0, 1, 1, 0]"
16398,1,1,2,0.735866837777585,"[0, 1, 0, 0, 1, 1, 0, 0, 0, 1]"
16399,1,1,2,0.7513307416373123,"[0, 1, 0, 0, 1, 0, 0, 1, 1, 0]"
16400,1,1,2,0.6827927345381957,"[0, 1, 1, 1, 0, 0, 0, 0, 1, 0]"
16401,1,1,2,0.010416602033881617,"[1, 0, 0, 1, 0, 0, 0, 1, 0, 1]"
16402,1,1,2,0.3733082608539037,"[0, 1, 1, 0, 0, 0, 0, 0, 0, 0]"
16403,1,1,2,0.5163296283937223,"[0, 1, 1, 0, 0, 0, 0, 0, 1, 1]"
16404,1,1,2,0.39020932476780357,"[1, 0, 1, 0, 1, 0, 0, 1, 0, 1]"
16405,2,2,4,0.48705459394130535,"[0, 1, 1, 1, 1, 0, 1, 0, 0, 1]"
16406,1,1,2,0.0100151509245765,"[0, 0, 1, 1, 0, 1, 1, 1, 0, 0]"
16407,1,1,2,0.456044195264693,"[0, 0, 0, 0, 0, 0, 0, 1, 0, 1]"
16408,1,1,2,0.6052074949602556,"[0, 1, 1, 1, 1, 0, 1, 0, 1, 0]"
16409,1,1,2,0.5303695752016032,"[0, 0, 1, 0, 1, 0, 0, 1, 1, 1]"
16410,3,3,6,0.8300941035204836,"[0, 1, 1, 0, 0, 1, 0, 1, 1, 1]"
16411,1,1,2,0.35624846802550614,"[0, 1, 1, 1, 1, 1, 1, 1, 0, 0]"
16412,1,1,2,0.690478104949064,"[1, 1, 1, 1, 1, 1, 0, 0, 1, 0]"
16413,1,1,2,0.23228584694901488,"[1, 1, 1, 0, 1, 1, 0, 1, 1, 0]"
16414,1,1,2,0.9385553164360936,"[0, 0, 0, 1, 0, 1, 0, 1, 1, 0]"
16415,1,1,2,0.07386916762208584,"[0, 0, 0, 0, 1, 0, 0, 0, 0, 1]"
16416,2,2,4,0.24138437167535642,"[0, 0, 0, 1, 0, 0, 1, 1, 0, 1]"
16417,1,1,2,0.9554134398058128,"[0, 1, 1, 1, 1, 0, 0, 1, 0, 0]"
16418,1,1,2,0.4636342976214167,"[0, 0, 0, 0, 0, 0, 1, 0, 0, 1]"
16419,1,1,2,0.46801366292494684,"[1, 0, 0, 1, 1, 1, 1, 1, 1, 0]"
16420,1,1,2,0.07330443328211722,"[1, 1, 0, 0, 1, 0, 0, 1, 1, 1]"
16421,1,1,2,0.3067715899176564,"[1, 0, 0, 0, 1, 1, 1, 1, 1, 0]"
16422,1,1,2,0.816671208603422,"[1, 1, 1, 1, 1, 1, 0, 0, 1, 0]"
16423,1,1,2,0.8574413414173923,"[0, 1, 1, 0, 0, 1, 0, 0, 0, 1]"
16424,1,1,2,0.9446060018423755,"[1, 1, 0, 0, 1, 0, 0, 1, 0, 1]"
16425,1,1,2,0.994640712657653,"[0, 0, 0, 0, 0, 1, 0, 0, 0, 0]"
16426,1,1,2,0.33466969443853045,"[0, 1, 1, 1, 1, 1, 1, 0, 1, 0]"
16427,1,1,2,0.4096283031748199,"[1, 1, 1, 1, 0, 0, 0, 0, 0, 0]"
16428,1,1,2,0.8563015696457397,"[0, 1, 1, 1, 0, 0, 0, 1, 1, 0]"
16429,3,3,6,0.7213646620050581,"[0, 1, 0, 1, 0, 1, 1, 0, 1, 1]"
16430,1,1,2,0.6650717145132177,"[0, 1, 0, 0, 0, 1, 1, 0, 1, 1]"
16431,2,2,4,0.3674041852707639,"[0, 0, 1, 1, 1, 1, 1, 0, 1, 0]"
16432,1,1,2,0.6390019348562826,"[1, 0, 0, 1, 1, 1, 0, 0, 0, 0]"
16433,1,1,2,0.28002304782691834,"[0, 1, 1, 0, 1, 0, 1, 0, 1, 0]"
16434,2,2,4,0.5018988492882557,"[1, 1, 0, 1, 0, 1, 1, 1, 1, 1]"
16435,1,1,2,0.19689826963737456,"[0, 1, 0, 1, 1, 0, 0, 0, 1, 0]"
16436,1,1,2,0.9203149798175183,"[0, 1, 1, 1, 0, 1, 1, 1, 0, 1]"
16437,1,1,2,0.541407344034549,"[0, 0, 0, 1, 1, 0, 0, 1, 1, 0]"
16438,1,1,2,0.8328999135305085,"[0, 0, 1, 0, 1, 0, 1, 1, 1, 1]"
16439,1,1,2,0.23286935393883657,"[1, 0, 0, 1, 0, 1, 0, 1, 1, 1]"
16440,1,1,2,0.13842001464929943,"[1, 0, 0, 0, 1, 1, 1, 0, 1, 1]"
16441,1,1,2,0.6566678250150074,"[1, 1, 1, 0, 0, 1, 0, 0, 1, 0]"
16442,1,1,2,0.3631816372325719,"[0, 1, 0, 1, 1, 1, 0, 1, 0, 1]"
16443,1,1,2,0.21339540040685312,"[1, 0, 0, 1, 1, 1, 1, 0, 1, 0]"
16444,1,1,2,0.37989329830694996,"[1, 1, 1, 1, 0, 0, 1, 0, 0, 1]"
16445,1,1,2,0.3632843008271227,"[0, 0, 1, 0, 1, 1, 1, 0, 1, 1]"
16446,1,1,2,0.32142642109950403,"[0, 0, 0, 1, 1, 0, 0, 0, 1, 1]"
16447,1,1,2,0.7528925460628377,"[1, 1, 0, 0, 1, 1, 0, 0, 1, 1]"
16448,1,1,2,0.478017153944737,"[1, 0, 0, 1, 0, 1, 0, 1, 0, 0]"
16449,1,1,2,0.24289216228763222,"[1, 0, 1, 1, 1, 1, 1, 0, 0, 0]"
16450,1,1,2,0.43378667456781095,"[1, 0, 1, 1, 0, 1, 1, 1, 1, 1]"
16451,1,1,2,0.026580709402530878,"[1, 1, 0, 1, 1, 1, 0, 0, 1, 0]"
16452,1,1,2,0.4579849091495134,"[0, 0, 0, 1, 0, 0, 0, 1, 1, 1]"
16453,1,1,2,0.4969018364227824,"[0, 0, 1, 1, 1, 0, 1, 1, 0, 0]"
16454,1,1,2,0.39535196642596215,"[1, 1, 1, 0, 1, 0, 0, 1, 0, 1]"
16455,1,1,2,0.13477152139120652,"[0, 1, 1, 1, 1, 1, 1, 1, 0, 1]"
16456,1,1,2,0.1926535741298544,"[1, 0, 0, 0, 0, 1, 0, 0, 0, 1]"
16457,1,1,2,0.962677165981683,"[1, 0, 1, 0, 1, 1, 0, 0, 1, 1]"
16458,1,1,2,0.26996746989039067,"[1, 0, 0, 0, 0, 1, 0, 0, 1, 1]"
16459,2,2,4,0.8171075363237977,"[1, 1, 0, 1, 1, 1, 1, 0, 1, 0]"
16460,1,1,2,0.40231131922747765,"[0, 0, 0, 1, 0, 0, 1, 1, 1, 0]"
16461,1,1,2,0.13626341843708312,"[1, 1, 1, 0, 0, 1, 1, 1, 1, 1]"
16462,1,1,2,0.967714934499004,"[1, 0, 0, 1, 1, 0, 1, 1, 0, 0]"
16463,1,1,2,0.6850435181974538,"[0, 0, 1, 0, 0, 1, 0, 1, 1, 1]"
16464,1,1,2,0.24402251760527616,"[0, 1, 0, 1, 1, 1, 0, 1, 1, 1]"
16465,2,2,4,0.4063600434557224,"[0, 1, 0, 1, 0, 1, 0, 0, 0, 1]"
16466,1,1,2,0.43572582316099107,"[0, 1, 0, 0, 1, 1, 0, 0, 0, 0]"
16467,1,1,2,0.08053935805785084,"[1, 0, 1, 0, 1, 1, 1, 1, 1, 1]"
16468,1,1,2,0.323718120864232,"[0, 0, 0, 1, 1, 1, 0, 1, 1, 0]"
16469,1,1,2,0.5369516043941831,"[1, 1, 0, 1, 0, 1, 1, 1, 1, 1]"
16470,1,1,2,0.7583494122900045,"[0, 1, 0, 1, 1, 1, 0, 1, 1, 1]"
16471,1,1,2,0.9055469336055332,"[1, 0, 1, 0, 0, 0, 0, 0, 1, 0]"
16472,1,1,2,0.26151283958818206,"[0, 0, 1, 0, 1, 1, 1, 1, 0, 0]"
16473,1,1,2,0.5591373050878208,"[0, 1, 0, 1, 0, 0, 0, 0, 1, 0]"
16474,1,1,2,0.7728292726206594,"[1, 0, 1, 1, 0, 1, 1, 0, 0, 0]"
16475,1,1,2,0.3922718330444075,"[1, 1, 1, 1, 1, 1, 1, 0, 1, 0]"
16476,1,1,2,0.6804554346156441,"[1, 0, 1, 1, 0, 0, 0, 1, 0, 1]"
16477,1,1,2,0.8717574544682078,"[1, 0, 0, 1, 0, 1, 1, 0, 1, 1]"
16478,1,1,2,0.26580716352983,"[0, 0, 0, 1, 1, 1, 1, 1, 1, 0]"
16479,1,1,2,0.2791722389891471,"[1, 0, 0, 0, 1, 1, 0, 1, 1, 0]"
16480,1,1,2,0.12786543659602978,"[1, 1, 0, 0, 0, 1, 0, 0, 0, 0]"
16481,2,2,4,0.1331746622278226,"[0, 1, 0, 0, 0, 0, 0, 0, 1, 1]"
16482,1,1,2,0.5566010444571428,"[1, 1, 1, 0, 0, 1, 1, 1, 0, 0]"
16483,1,1,2,0.16175246612954308,"[1, 0, 1, 1, 1, 0, 0, 1, 1, 1]"
16484,1,1,2,0.7422150753963347,"[1, 0, 0, 0, 1, 0, 1, 1, 1, 0]"
16485,1,1,2,0.8373205434757933,"[0, 0, 0, 1, 1, 0, 0, 1, 1, 1]"
16486,1,1,2,0.787593792404684,"[1, 1, 1, 1, 1, 1, 1, 1, 0, 1]"
16487,1,1,2,0.7850692842950513,"[1, 1, 0, 0, 0, 1, 1, 0, 0, 0]"
16488,1,1,2,0.18712272887224657,"[1, 1, 0, 1, 1, 0, 0, 0, 0, 1]"
16489,1,1,2,0.14188756459630836,"[0, 0, 0, 1, 1, 0, 0, 1, 0, 0]"
16490,1,1,2,0.1561439397660036,"[1, 1, 0, 1, 0, 1, 1, 1, 0, 1]"
16491,2,2,4,0.7199810701185364,"[1, 0, 1, 0, 1, 0, 1, 1, 1, 0]"
16492,2,2,4,0.5718461624748152,"[0, 0, 1, 0, 1, 0, 1, 0, 0, 1]"
16493,1,1,2,0.04300808708560533,"[1, 0, 1, 0, 1, 0, 1, 1, 0, 0]"
16494,1,1,2,0.14695910058974915,"[0, 1, 1, 0, 1, 1, 1, 0, 0, 0]"
16495,1,1,2,0.13149782111540687,"[0, 1, 1, 0, 0, 1, 0, 0, 1, 0]"
16496,1,1,2,0.4853624186339518,"[0, 0, 1, 0, 0, 1, 0, 0, 1, 0]"
16497,1,1,2,0.8733810334897425,"[1, 1, 0, 0, 1, 0, 1, 0, 0, 0]"
16498,1,1,2,0.1964788408335295,"[1, 1, 0, 0, 1, 0, 0, 0, 0, 0]"
16499,1,1,2,0.10293889075513141,"[1, 1, 0, 0, 1, 1, 1, 0, 0, 1]"
16500,2,2,4,0.6216658961077033,"[1, 0, 1, 1, 0, 1, 0, 1, 0, 1]"
16501,1,1,2,0.6182918100839995,"[0, 0, 0, 0, 0, 0, 0, 0, 0, 0]"
16502,1,1,2,0.2844328849101837,"[0, 1, 0, 0, 1, 0, 1, 1, 0, 1]"
16503,1,1,2,0.4351872829571978,"[1, 0, 1, 1, 0, 0, 0, 1, 0, 0]"
16504,1,1,2,0.38008831512474817,"[1, 1, 0, 1, 0, 1, 1, 0, 0, 0]"
16505,1,1,2,0.7231469861346169,"[0, 1, 0, 1, 1, 1, 0, 0, 1, 1]"
16506,1,1,2,0.7078688907891343,"[0, 1, 0, 0, 1, 1, 0, 1, 0, 1]"
16507,1,1,2,0.9182691958886593,"[0, 0, 0, 1, 0, 0, 1, 1, 1, 1]"
16508,1,1,2,0.3671738738855961,"[0, 1, 1, 1, 1, 0, 0, 0, 0, 0]"
16509,1,1,2,0.059740204324033264,"[0, 1, 0, 1, 0, 1, 0, 0, 0, 0]"
16510,1,1,2,0.48318380791701054,"[1, 0, 1, 1, 1, 1, 0, 0, 1, 0]"
16511,1,1,2,0.8345622224692577,"[1, 1, 0, 1, 0, 1, 1, 0, 0, 1]"
16512,1,1,2,0.2344177125779482,"[0, 1, 1, 1, 0, 1, 0, 0, 1, 1]"
16513,1,1,2,0.14324035705454607,"[1, 0, 1, 1, 1, 0, 1, 0, 1, 1]"
16514,1,1,2,0.5207635313446428,"[0, 0, 1, 1, 0, 1, 0, 0, 0, 1]"
16515,1,1,2,0.6914281492495509,"[1, 1, 0, 0, 0, 1, 1, 1, 0, 1]"
16516,1,1,2,0.5316488385513646,"[1, 0, 0, 0, 0, 0, 0, 0, 1, 1]"
16517,1,1,2,0.4645800709935147,"[0, 0, 0, 0, 0, 0, 0, 0, 0, 0]"
16518,1,1,2,0.6548044151938541,"[0, 1, 0, 0, 0, 0, 0, 0, 1, 0]"
16519,1,1,2,0.47952267238693225,"[1, 1, 1, 0, 1, 1, 1, 0, 0, 0]"
16520,1,1,2,0.635975379768593,"[1, 0, 0, 1, 0, 0, 0, 0, 1, 1]"
16521,1,1,2,0.332779988457268,"[1, 1, 0, 0, 0, 1, 1, 0, 0, 0]"
16522,1,1,2,0.09968007347361152,"[0, 0, 1, 0, 1, 1, 0, 0, 1, 0]"
16523,1,1,2,0.18092172819799013,"[1, 1, 1, 0, 0, 1, 1, 1, 0, 1]"
16524,1,1,2,0.6341479237386036,"[1, 1, 0, 0, 0, 0, 0, 0, 0, 0]"
16525,2,2,4,0.2379600264335393,"[0, 0, 0, 0, 1, 1, 0, 0, 1, 1]"
16526,1,1,2,0.7448462401085166,"[0, 1, 0, 0, 0, 0, 1, 0, 1, 0]"
16527,1,1,2,0.3722700736880885,"[0, 1, 0, 0, 1, 0, 0, 1, 0, 1]"
16528,1,1,2,0.08545834805646924,"[0, 0, 1, 1, 0, 1, 0, 0, 1, 1]"
16529,1,1,2,0.6379939113750366,"[0, 0, 1, 0, 1, 1, 1, 1, 1, 1]"
16530,1,1,2,0.9378902929557574,"[1, 1, 1, 0, 1, 1, 0, 0, 0, 1]"
16531,1,1,2,0.8320936780786278,"[1, 0, 1, 1, 1, 1, 0, 1, 0, 0]"
16532,1,1,2,0.4219947250443893,"[1, 0, 0, 0, 1, 0, 1, 1, 0, 0]"
16533,1,1,2,0.1934940875015424,"[1, 1, 0, 1, 1, 1, 0, 0, 1, 0]"
16534,1,1,2,0.6542955165813009,"[1, 1, 0, 0, 1, 0, 1, 1, 0, 0]"
16535,1,1,2,0.48384802090761914,"[0, 1, 1, 1, 0, 0, 1, 0, 0, 1]"
16536,1,1,2,0.6835827909665128,"[1, 0, 0, 0, 0, 0, 0, 1, 1, 1]"
16537,1,1,2,0.6946326988677093,"[1, 1, 1, 1, 1, 0, 0, 1, 1, 1]"
16538,1,1,2,0.38024705264669745,"[0, 1, 0, 0, 0, 1, 0, 0, 1, 1]"
16539,1,1,2,0.3110536596263378,"[1, 0, 1, 1, 1, 1, 1, 1, 1, 0]"
16540,1,1,2,0.8176127724752714,"[1, 0, 0, 1, 0, 1, 0, 0, 1, 0]"
16541,1,1,2,0.7396036999082132,"[0, 0, 1, 0, 1, 1, 1, 1, 0, 0]"
16542,1,1,2,0.18941510095304237,"[1, 0, 0, 1, 0, 0, 0, 0, 1, 1]"
16543,1,1,2,0.8578784044011806,"[1, 0, 0, 0, 1, 0, 1, 1, 1, 0]"
16544,1,1,2,0.5241789259169833,"[0, 0, 1, 1, 1, 0, 0, 0, 0, 1]"
16545,1,1,2,0.9409805187963641,"[0, 0, 0, 1, 1, 1, 1, 0, 0, 0]"
16546,1,1,2,0.9280529167686676,"[1, 1, 1, 0, 0, 0, 0, 1, 0, 0]"
16547,1,1,2,0.11041830252820073,"[1, 0, 1, 0, 1, 1, 1, 1, 1, 0]"
16548,1,1,2,0.424640468434751,"[0, 0, 0, 1, 0, 0, 0, 1, 0, 0]"
16549,1,1,2,0.7890438486234254,"[0, 0, 0, 0, 0, 1, 0, 1, 0, 1]"
16550,1,1,2,0.6640165214668624,"[1, 0, 1, 0, 0, 0, 1, 1, 0, 1]"
16551,1,1,2,0.4630004591882678,"[0, 1, 0, 0, 1, 0, 1, 1, 0, 0]"
16552,1,1,2,0.21124992723306713,"[0, 0, 0, 0, 1, 1, 0, 0, 0, 0]"
16553,1,1,2,0.9737717124556757,"[0, 0, 1, 1, 0, 1, 0, 1, 0, 1]"
16554,1,1,2,0.8924976412256893,"[0, 0, 1, 1, 0, 1, 1, 0, 1, 1]"
16555,1,1,2,0.6874112447490017,"[1, 1, 1, 1, 1, 1, 1, 1, 0, 1]"
16556,1,1,2,0.19493156994862304,"[1, 1, 0, 1, 1, 1, 1, 0, 1, 1]"
16557,1,1,2,0.573351298464848,"[1, 1, 1, 0, 0, 1, 0, 1, 1, 1]"
16558,1,1,2,0.5088741563795053,"[0, 0, 1, 1, 0, 1, 1, 1, 0, 1]"
16559,1,1,2,0.25005172314238555,"[0, 1, 0, 1, 1, 0, 0, 1, 1, 0]"
16560,1,1,2,0.4276257309279585,"[0, 0, 1, 1, 0, 0, 0, 0, 0, 0]"
16561,1,1,2,0.4370604740784697,"[0, 0, 0, 0, 1, 1, 1, 1, 1, 0]"
16562,1,1,2,0.4165994040105476,"[1, 0, 1, 1, 0, 1, 0, 1, 1, 0]"
16563,1,1,2,0.06987575451671546,"[0, 0, 0, 1, 0, 0, 0, 0, 1, 0]"
16564,1,1,2,0.7143034400238917,"[0, 1, 1, 1, 1, 1, 1, 1, 1, 0]"
16565,1,1,2,0.8592828125771367,"[0, 1, 1, 0, 1, 0, 0, 1, 0, 1]"
16566,1,1,2,0.27127869772008684,"[1, 0, 0, 1, 1, 0, 0, 0, 1, 1]"
16567,1,1,2,0.17857190432156822,"[0, 0, 0, 0, 0, 1, 0, 1, 1, 1]"
16568,1,1,2,0.971573800051043,"[1, 0, 1, 0, 0, 1, 0, 1, 1, 1]"
16569,1,1,2,0.5093704388192205,"[1, 1, 0, 0, 1, 1, 0, 0, 0, 0]"
16570,1,1,2,0.2396887117282248,"[0, 1, 0, 0, 0, 1, 0, 0, 1, 1]"
16571,3,3,6,0.6316129949249922,"[1, 1, 1, 0, 1, 1, 1, 0, 0, 0]"
16572,1,1,2,0.1213488692067557,"[0, 1, 1, 0, 0, 0, 0, 0, 0, 0]"
16573,1,1,2,0.39968849677874996,"[1, 0, 0, 0, 0, 0, 0, 1, 1, 1]"
16574,1,1,2,0.7893191010487047,"[1, 1, 1, 0, 1, 0, 0, 1, 1, 1]"
16575,1,1,2,0.8300484236756019,"[0, 0, 0, 0, 0, 1, 0, 1, 0, 0]"
16576,1,1,2,0.06749641139575813,"[0, 0, 1, 1, 0, 0, 0, 1, 0, 0]"
16577,1,1,2,0.2570549254761353,"[0, 1, 1, 0, 1, 0, 0, 0, 1, 0]"
16578,1,1,2,0.22766766813594586,"[1, 0, 0, 1, 0, 1, 1, 1, 1, 1]"
16579,1,1,2,0.08295894740253851,"[1, 1, 1, 1, 0, 0, 0, 0, 1, 0]"
16580,1,1,2,0.5345742406346758,"[1, 0, 1, 1, 0, 1, 1, 0, 1, 0]"
16581,1,1,2,0.2447887822341891,"[1, 0, 0, 0, 0, 0, 0, 1, 0, 1]"
16582,1,1,2,0.10522948932620457,"[1, 1, 0, 0, 0, 1, 1, 0, 1, 0]"
16583,1,1,2,0.5578422524948485,"[1, 0, 1, 0, 1, 1, 1, 1, 1, 0]"
16584,1,1,2,0.8283563422909064,"[0, 1, 0, 0, 0, 1, 1, 0, 1, 1]"
16585,1,1,2,0.11660650412725393,"[1, 0, 1, 0, 1, 0, 1, 0, 0, 0]"
16586,1,1,2,0.24895883119114115,"[1, 1, 1, 0, 1, 1, 1, 0, 1, 1]"
16587,1,1,2,0.5261733757255705,"[0, 1, 1, 1, 0, 1, 1, 0, 1, 0]"
16588,1,1,2,0.922197556032182,"[1, 1, 0, 1, 1, 0, 1, 1, 1, 1]"
16589,2,2,4,0.04340172804618292,"[1, 0, 1, 1, 1, 0, 1, 1, 1, 0]"
16590,1,1,2,0.4247538414073736,"[0, 1, 0, 1, 1, 0, 1, 1, 0, 0]"
16591,1,1,2,0.002020806454652857,"[0, 0, 0, 0, 0, 0, 0, 1, 1, 0]"
16592,1,1,2,0.9614128337451852,"[0, 0, 1, 1, 0, 1, 1, 0, 0, 1]"
16593,1,1,2,0.6590299830508571,"[0, 1, 1, 0, 1, 1, 0, 0, 1, 1]"
16594,1,1,2,0.000771729188872472,"[0, 1, 0, 1, 1, 1, 0, 0, 1, 0]"
16595,1,1,2,0.09067289625408514,"[1, 0, 1, 1, 0, 1, 1, 1, 1, 1]"
16596,1,1,2,0.1425892123116378,"[1, 0, 1, 0, 0, 0, 0, 1, 0, 0]"
16597,1,1,2,0.2768432193150786,"[1, 1, 0, 1, 1, 1, 0, 0, 1, 1]"
16598,1,1,2,0.03999033389625495,"[0, 0, 0, 0, 0, 0, 1, 0, 1, 0]"
16599,1,1,2,0.6356463315500116,"[0, 1, 0, 0, 1, 1, 0, 0, 1, 1]"
16600,1,1,2,0.16940042610953654,"[0, 1, 1, 1, 1, 1, 0, 1, 0, 1]"
16601,1,1,2,0.513722172571007,"[0, 0, 1, 0, 0, 0, 1, 0, 1, 0]"
16602,1,1,2,0.433251166892338,"[0, 1, 0, 0, 0, 1, 1, 0, 0, 0]"
16603,1,1,2,0.4734646691132479,"[0, 1, 1, 1, 1, 1, 1, 0, 1, 1]"
16604,1,1,2,0.9313130790894244,"[0, 1, 1, 0, 1, 1, 0, 0, 0, 0]"
16605,1,1,2,0.8054062035647432,"[0, 0, 1, 0, 0, 1, 0, 1, 0, 1]"
16606,1,1,2,0.7429132511602946,"[1, 0, 1, 0, 1, 0, 1, 0, 0, 1]"
16607,1,1,2,0.550901113730807,"[0, 1, 1, 1, 1, 0, 0, 1, 1, 0]"
16608,2,2,4,0.8546475377951873,"[1, 0, 1, 1, 0, 1, 0, 0, 0, 1]"
16609,2,2,4,0.19031979093256146,"[0, 0, 1, 1, 0, 1, 0, 1, 0, 1]"
16610,1,1,2,0.40012113771357494,"[1, 1, 1, 0, 0, 1, 0, 0, 0, 1]"
16611,1,1,2,0.2372392361553337,"[0, 1, 0, 0, 0, 0, 0, 1, 0, 0]"
16612,1,1,2,0.22213464076143807,"[0, 1, 1, 0, 0, 1, 0, 0, 0, 1]"
16613,1,1,2,0.4772499104670944,"[1, 1, 0, 0, 0, 0, 0, 0, 1, 1]"
16614,1,1,2,0.14049209942896557,"[0, 1, 1, 1, 0, 1, 0, 1, 0, 1]"
16615,1,1,2,0.8612448603329483,"[0, 1, 1, 1, 1, 1, 1, 1, 1, 0]"
16616,1,1,2,0.5764377597398096,"[0, 1, 1, 1, 0, 1, 1, 1, 1, 0]"
16617,1,1,2,0.5402614155970521,"[1, 0, 0, 0, 1, 0, 0, 0, 0, 0]"
16618,1,1,2,0.5440955594772013,"[1, 1, 0, 0, 0, 0, 0, 1, 0, 1]"
16619,1,1,2,0.41197321014158705,"[0, 1, 1, 1, 0, 0, 1, 0, 0, 0]"
16620,1,1,2,0.3967756133114694,"[0, 0, 1, 0, 0, 1, 1, 1, 0, 0]"
16621,1,1,2,0.37193516939510385,"[0, 0, 1, 1, 0, 0, 1, 1, 1, 0]"
16622,1,1,2,0.49749181437716194,"[0, 1, 0, 1, 1, 1, 0, 1, 0, 0]"
16623,2,2,4,0.25361189796247796,"[0, 1, 1, 0, 1, 1, 1, 0, 1, 1]"
16624,2,2,4,0.5470092144851991,"[1, 1, 0, 0, 0, 0, 0, 1, 0, 1]"
16625,2,2,4,0.00509989499730179,"[1, 1, 0, 0, 0, 1, 1, 0, 1, 0]"
16626,1,1,2,0.7042768132828924,"[0, 1, 1, 0, 1, 0, 0, 1, 0, 0]"
16627,1,1,2,0.8794401959171049,"[0, 0, 1, 1, 0, 0, 1, 1, 1, 0]"
16628,1,1,2,0.16769828133424858,"[0, 0, 0, 0, 0, 1, 0, 0, 0, 1]"
16629,1,1,2,0.7944555807903443,"[1, 0, 0, 0, 1, 0, 1, 0, 1, 1]"
16630,1,1,2,0.460770667919999,"[1, 0, 1, 0, 0, 1, 1, 0, 1, 0]"
16631,1,1,2,0.6326782047258771,"[0, 0, 0, 0, 0, 0, 1, 0, 1, 1]"
16632,1,1,2,0.2856309638383717,"[0, 0, 1, 0, 0, 1, 0, 0, 1, 1]"
16633,1,1,2,0.45334210161835353,"[0, 0, 0, 1, 1, 1, 1, 0, 1, 0]"
16634,1,1,2,0.5513347128164127,"[0, 1, 1, 0, 0, 1, 0, 0, 1, 1]"
16635,1,1,2,0.48288396247105936,"[0, 0, 1, 0, 1, 0, 1, 0, 0, 1]"
16636,1,1,2,0.6532185597703433,"[1, 0, 0, 1, 0, 1, 0, 0, 1, 0]"
16637,1,1,2,0.32987507684229667,"[1, 0, 0, 0, 1, 1, 0, 0, 1, 1]"
16638,1,1,2,0.32346508824765574,"[1, 0, 0, 1, 0, 0, 1, 0, 1, 1]"
16639,1,1,2,0.2519297414866365,"[1, 1, 1, 1, 1, 0, 0, 0, 0, 1]"
16640,1,1,2,0.09767956070080297,"[1, 0, 1, 0, 0, 0, 1, 1, 1, 1]"
16641,1,1,2,0.6825974005228893,"[1, 1, 1, 0, 0, 1, 0, 1, 1, 1]"
16642,1,1,2,0.7310801712270968,"[0, 0, 0, 0, 0, 1, 1, 1, 1, 0]"
16643,1,1,2,0.4521965731611399,"[0, 1, 1, 0, 1, 1, 1, 0, 0, 0]"
16644,1,1,2,0.5291885241069768,"[1, 1, 1, 1, 0, 0, 0, 1, 0, 1]"
16645,1,1,2,0.16733421638321422,"[0, 1, 1, 1, 0, 0, 0, 1, 0, 0]"
16646,1,1,2,0.5394445117379797,"[1, 1, 0, 0, 0, 0, 0, 0, 0, 0]"
16647,1,1,2,0.5802260865561933,"[1, 0, 1, 0, 1, 1, 0, 1, 0, 0]"
16648,1,1,2,0.8170614817289171,"[0, 0, 0, 0, 1, 1, 1, 1, 1, 0]"
16649,1,1,2,0.38214434645323925,"[0, 0, 1, 0, 1, 1, 0, 1, 1, 1]"
16650,1,1,2,0.38827569449294996,"[1, 0, 1, 1, 0, 1, 0, 1, 0, 0]"
16651,1,1,2,0.5187195633069113,"[0, 0, 1, 0, 1, 1, 0, 1, 0, 1]"
16652,1,1,2,0.6702222836452497,"[1, 1, 0, 1, 1, 0, 0, 1, 1, 1]"
16653,1,1,2,0.9254753616257964,"[1, 0, 0, 0, 0, 0, 1, 0, 1, 1]"
16654,1,1,2,0.4097109954739868,"[0, 1, 1, 0, 0, 1, 0, 1, 1, 0]"
16655,1,1,2,0.4054973271518856,"[1, 0, 0, 1, 0, 0, 0, 0, 1, 1]"
16656,1,1,2,0.615261850282701,"[0, 1, 1, 1, 0, 1, 1, 0, 1, 1]"
16657,1,1,2,0.45275010810237615,"[1, 0, 1, 1, 1, 1, 1, 1, 1, 0]"
16658,1,1,2,0.3208675005379489,"[0, 1, 0, 0, 0, 1, 0, 1, 1, 0]"
16659,1,1,2,0.069020133567534,"[0, 0, 1, 1, 1, 0, 1, 0, 0, 0]"
16660,1,1,2,0.8373819959238323,"[1, 1, 1, 1, 0, 1, 0, 1, 0, 0]"
16661,1,1,2,0.7372328867408725,"[0, 0, 0, 1, 1, 0, 1, 0, 0, 0]"
16662,1,1,2,0.3399814657383272,"[1, 0, 0, 0, 0, 0, 1, 0, 0, 0]"
16663,1,1,2,0.09864729740964884,"[0, 0, 1, 1, 0, 0, 1, 0, 1, 0]"
16664,1,1,2,0.2942250793604565,"[0, 0, 1, 1, 1, 0, 0, 0, 0, 1]"
16665,1,1,2,0.03517226724075895,"[0, 0, 1, 0, 1, 1, 0, 0, 1, 1]"
16666,1,1,2,0.1634900580141777,"[0, 1, 0, 0, 1, 1, 1, 1, 1, 0]"
16667,2,2,4,0.8335383401808122,"[1, 0, 0, 1, 0, 1, 0, 1, 1, 1]"
16668,1,1,2,0.48427286313751317,"[1, 0, 0, 1, 1, 1, 0, 1, 0, 0]"
16669,1,1,2,0.8961528857597907,"[0, 0, 1, 0, 0, 0, 1, 0, 1, 0]"
16670,1,1,2,0.7908970988841824,"[0, 0, 0, 0, 0, 1, 1, 0, 0, 0]"
16671,1,1,2,0.4088198215616978,"[0, 1, 0, 0, 1, 1, 1, 0, 0, 1]"
16672,1,1,2,0.7384367939106543,"[1, 1, 0, 1, 1, 1, 1, 0, 0, 0]"
16673,1,1,2,0.417224059638434,"[1, 0, 1, 0, 1, 1, 0, 0, 1, 1]"
16674,1,1,2,0.9688665851431489,"[0, 0, 1, 1, 0, 0, 1, 1, 0, 0]"
16675,2,2,4,0.4279134375676188,"[0, 0, 0, 1, 0, 0, 0, 1, 1, 0]"
16676,1,1,2,0.23625646321477423,"[0, 1, 1, 0, 0, 0, 1, 0, 0, 0]"
16677,1,1,2,0.17660311736250367,"[0, 1, 1, 1, 0, 0, 1, 0, 1, 0]"
16678,1,1,2,0.3668560324779676,"[1, 0, 0, 1, 0, 1, 0, 1, 0, 0]"
16679,1,1,2,0.5775490423501016,"[1, 0, 0, 1, 0, 0, 1, 1, 1, 1]"
16680,1,1,2,0.39273131494192803,"[0, 1, 0, 0, 1, 1, 0, 1, 1, 0]"
16681,1,1,2,0.7521625758213835,"[0, 1, 1, 1, 0, 0, 0, 0, 1, 1]"
16682,1,1,2,0.5283944613020495,"[0, 0, 1, 0, 1, 1, 1, 1, 0, 1]"
16683,1,1,2,0.6110297134443123,"[0, 1, 0, 0, 0, 0, 0, 1, 1, 1]"
16684,1,1,2,0.9111559569374201,"[0, 0, 0, 0, 0, 1, 1, 0, 0, 1]"
16685,1,1,2,0.19254201019440098,"[1, 1, 0, 1, 1, 0, 1, 0, 1, 0]"
16686,1,1,2,0.019982909310962915,"[0, 1, 0, 0, 0, 1, 0, 0, 1, 0]"
16687,1,1,2,0.631926700107008,"[1, 1, 0, 0, 1, 1, 1, 1, 1, 1]"
16688,1,1,2,0.5341783393898786,"[1, 0, 1, 1, 1, 1, 0, 1, 0, 0]"
16689,2,2,4,0.424539552404396,"[0, 1, 0, 0, 1, 0, 1, 0, 1, 1]"
16690,1,1,2,0.022411175011426088,"[0, 1, 0, 0, 0, 0, 0, 0, 0, 1]"
16691,1,1,2,0.3385184499965749,"[1, 1, 0, 0, 1, 1, 0, 0, 0, 1]"
16692,1,1,2,0.5110887067875645,"[0, 1, 0, 0, 0, 0, 0, 0, 0, 1]"
16693,1,1,2,0.6336006404845729,"[0, 0, 1, 0, 1, 0, 0, 0, 0, 0]"
16694,1,1,2,0.5818100433216293,"[0, 0, 1, 0, 0, 0, 1, 1, 1, 0]"
16695,1,1,2,0.6293814399153467,"[0, 0, 0, 0, 1, 0, 1, 1, 1, 0]"
16696,1,1,2,0.9794755165580639,"[0, 0, 0, 1, 0, 0, 1, 0, 1, 1]"
16697,1,1,2,0.9411901031274672,"[1, 1, 0, 1, 1, 0, 1, 0, 1, 0]"
16698,1,1,2,0.5610369389140104,"[0, 0, 1, 1, 1, 0, 0, 1, 0, 1]"
16699,1,1,2,0.7430833985968466,"[0, 0, 0, 1, 1, 0, 0, 0, 1, 1]"
16700,1,1,2,0.4052073338942279,"[0, 0, 0, 1, 0, 0, 1, 0, 1, 1]"
16701,1,1,2,0.6949750971360891,"[0, 0, 0, 1, 1, 0, 1, 0, 1, 0]"
16702,1,1,2,0.02556631074239768,"[0, 1, 0, 0, 1, 0, 0, 0, 1, 0]"
16703,1,1,2,0.06253466137027675,"[0, 0, 1, 1, 0, 1, 1, 1, 0, 1]"
16704,1,1,2,0.6333704452043186,"[0, 0, 0, 0, 1, 0, 1, 0, 0, 1]"
16705,1,1,2,0.5905752128316035,"[0, 1, 1, 1, 0, 1, 1, 1, 0, 0]"
16706,1,1,2,0.1238557224545419,"[1, 0, 0, 1, 1, 0, 1, 0, 1, 0]"
16707,1,1,2,0.5208597747634705,"[0, 1, 1, 1, 0, 0, 1, 1, 1, 1]"
16708,1,1,2,0.19130482313108255,"[1, 1, 0, 1, 1, 0, 1, 0, 0, 0]"
16709,1,1,2,0.09010543562908013,"[1, 1, 1, 1, 0, 0, 0, 1, 0, 1]"
16710,1,1,2,0.4265408941169613,"[1, 0, 0, 1, 0, 1, 0, 0, 1, 1]"
16711,1,1,2,0.7335666947132417,"[1, 0, 0, 1, 0, 0, 0, 0, 1, 1]"
16712,1,1,2,0.05118230017924019,"[1, 0, 0, 0, 0, 1, 0, 0, 1, 0]"
16713,1,1,2,0.1671288097705732,"[0, 1, 1, 1, 0, 1, 0, 1, 1, 0]"
16714,1,1,2,0.36247347982290723,"[0, 1, 0, 0, 1, 1, 1, 1, 0, 1]"
16715,1,1,2,0.16959617462435672,"[1, 0, 0, 1, 1, 1, 1, 0, 1, 1]"
16716,1,1,2,0.5948831505883242,"[0, 1, 1, 1, 0, 1, 0, 1, 1, 0]"
16717,1,1,2,0.8944149577525832,"[0, 0, 0, 0, 0, 1, 0, 0, 1, 0]"
16718,1,1,2,0.40781325518101175,"[0, 1, 0, 1, 1, 1, 1, 0, 1, 0]"
16719,1,1,2,0.32428695845308997,"[0, 0, 0, 1, 1, 1, 0, 0, 0, 1]"
16720,1,1,2,0.8875588920186694,"[0, 0, 0, 0, 1, 0, 0, 0, 1, 0]"
16721,1,1,2,0.40181216130530917,"[1, 1, 0, 1, 1, 1, 1, 0, 0, 1]"
16722,1,1,2,0.20399798002190872,"[0, 1, 1, 0, 1, 0, 1, 1, 0, 0]"
16723,1,1,2,0.6409933663027659,"[1, 0, 1, 0, 1, 0, 1, 1, 0, 0]"
16724,1,1,2,0.9046509857199315,"[1, 1, 1, 0, 0, 0, 1, 1, 1, 0]"
16725,1,1,2,0.7274287090337939,"[0, 0, 0, 0, 0, 1, 0, 1, 0, 0]"
16726,1,1,2,0.19761594313731956,"[1, 0, 0, 1, 0, 1, 1, 1, 1, 1]"
16727,1,1,2,0.4783793989258164,"[1, 1, 1, 0, 0, 0, 0, 0, 0, 1]"
16728,1,1,2,0.9960603993658841,"[1, 1, 1, 0, 0, 1, 1, 1, 1, 0]"
16729,1,1,2,0.8097816818222514,"[0, 0, 0, 0, 0, 0, 0, 0, 1, 0]"
16730,1,1,2,0.8550726255719007,"[1, 0, 1, 0, 1, 0, 0, 0, 0, 1]"
16731,1,1,2,0.469756156058884,"[1, 0, 0, 0, 0, 1, 1, 1, 0, 0]"
16732,2,2,4,0.3505011544745079,"[1, 1, 1, 1, 1, 1, 0, 0, 0, 1]"
16733,1,1,2,0.3653002404711393,"[1, 0, 1, 1, 0, 0, 1, 1, 1, 0]"
16734,1,1,2,0.3111102840617854,"[0, 1, 1, 1, 1, 1, 1, 1, 0, 0]"
16735,1,1,2,0.9566246503587302,"[0, 1, 0, 0, 1, 0, 1, 0, 1, 1]"
16736,1,1,2,0.5908487295871334,"[0, 0, 1, 1, 0, 1, 0, 1, 0, 1]"
16737,1,1,2,0.5281774515162609,"[0, 1, 0, 1, 0, 0, 1, 1, 0, 0]"
16738,1,1,2,0.8823158319052312,"[1, 0, 1, 0, 0, 0, 0, 0, 0, 1]"
16739,1,1,2,0.28192501659036406,"[1, 0, 1, 0, 0, 0, 1, 1, 0, 0]"
16740,1,1,2,0.8139644654145416,"[0, 0, 1, 0, 0, 1, 1, 0, 1, 1]"
16741,1,1,2,0.35050882883034784,"[0, 0, 1, 0, 1, 1, 1, 0, 0, 1]"
16742,1,1,2,0.9348402307492795,"[1, 0, 0, 0, 0, 0, 1, 0, 0, 1]"
16743,1,1,2,0.9664816193376663,"[1, 0, 1, 0, 1, 0, 1, 1, 1, 1]"
16744,1,1,2,0.9631088909912994,"[1, 1, 1, 0, 1, 1, 1, 0, 0, 1]"
16745,1,1,2,0.515086457012247,"[1, 0, 1, 0, 0, 0, 0, 1, 1, 1]"
16746,2,2,4,0.21576368616180297,"[0, 1, 0, 1, 0, 0, 1, 1, 0, 1]"
16747,1,1,2,0.01965820602754642,"[0, 1, 1, 0, 0, 1, 1, 1, 0, 1]"
16748,1,1,2,0.26069651598878063,"[1, 0, 1, 0, 0, 0, 0, 1, 0, 0]"
16749,2,2,4,0.5784598036474969,"[1, 0, 0, 1, 1, 1, 0, 0, 1, 1]"
16750,1,1,2,0.5757251811575554,"[1, 1, 0, 0, 0, 0, 0, 1, 1, 0]"
16751,1,1,2,0.49445358861466027,"[0, 1, 0, 1, 0, 1, 0, 1, 0, 0]"
16752,1,1,2,0.5258096879378716,"[1, 1, 1, 1, 0, 1, 1, 0, 0, 0]"
16753,2,2,4,0.31355257814738924,"[1, 0, 0, 0, 1, 0, 1, 1, 1, 0]"
16754,1,1,2,0.4954300866592185,"[1, 0, 0, 0, 0, 1, 0, 0, 0, 1]"
16755,1,1,2,0.34805829840354696,"[1, 0, 0, 1, 0, 0, 1, 1, 0, 0]"
16756,1,1,2,0.4065290809918406,"[0, 1, 1, 0, 0, 1, 1, 1, 0, 0]"
16757,1,1,2,0.08261908083668723,"[1, 1, 1, 0, 0, 0, 0, 1, 0, 0]"
16758,1,1,2,0.8303916194198474,"[1, 0, 1, 1, 0, 0, 0, 0, 0, 0]"
16759,1,1,2,0.3646598048500579,"[0, 1, 1, 0, 1, 1, 1, 0, 0, 0]"
16760,1,1,2,0.41338291618319445,"[0, 1, 1, 1, 1, 1, 0, 1, 1, 1]"
16761,1,1,2,0.4977729700649438,"[0, 0, 0, 0, 1, 0, 0, 1, 0, 1]"
16762,1,1,2,0.4832066532904412,"[1, 0, 0, 0, 1, 1, 0, 0, 1, 0]"
16763,1,1,2,0.09681227061141906,"[0, 0, 0, 1, 0, 0, 1, 0, 0, 1]"
16764,1,1,2,0.07443220571720721,"[1, 0, 0, 1, 1, 1, 1, 0, 1, 0]"
16765,1,1,2,0.900256894855943,"[0, 1, 0, 1, 1, 0, 0, 0, 0, 1]"
16766,1,1,2,0.024741437222539298,"[1, 0, 0, 1, 1, 1, 0, 1, 1, 0]"
16767,1,1,2,0.37639195917659085,"[0, 0, 0, 0, 1, 0, 0, 1, 1, 1]"
16768,1,1,2,0.943407890454249,"[1, 1, 1, 0, 0, 1, 1, 1, 1, 0]"
16769,1,1,2,0.7031090155108273,"[0, 0, 0, 0, 1, 0, 1, 1, 1, 1]"
16770,1,1,2,0.07451701253430221,"[1, 1, 1, 1, 1, 1, 1, 1, 0, 1]"
16771,1,1,2,0.7982251732436964,"[0, 1, 0, 1, 1, 0, 1, 0, 0, 0]"
16772,1,1,2,0.2612367363159397,"[0, 1, 1, 1, 0, 1, 1, 1, 0, 1]"
16773,1,1,2,0.5822392345363135,"[1, 1, 1, 0, 0, 0, 1, 0, 0, 1]"
16774,1,1,2,0.7639208695379337,"[1, 0, 1, 1, 0, 0, 0, 0, 1, 0]"
16775,1,1,2,0.638163111455584,"[0, 1, 0, 1, 1, 0, 1, 0, 1, 0]"
16776,1,1,2,0.46131029481300034,"[0, 0, 1, 1, 0, 1, 1, 1, 1, 0]"
16777,1,1,2,0.3102909358552184,"[0, 1, 0, 1, 0, 0, 0, 1, 1, 0]"
16778,1,1,2,0.20936880649910772,"[0, 1, 1, 0, 1, 0, 0, 0, 0, 1]"
16779,1,1,2,0.4610700784889332,"[0, 0, 1, 0, 1, 1, 1, 1, 1, 1]"
16780,1,1,2,0.3892083170098022,"[0, 1, 0, 1, 0, 0, 0, 1, 0, 1]"
16781,1,1,2,0.26125972697926025,"[0, 1, 1, 1, 1, 0, 1, 1, 0, 0]"
16782,1,1,2,0.017327602953978283,"[1, 1, 1, 1, 0, 0, 0, 0, 0, 0]"
16783,1,1,2,0.35704702441253444,"[1, 0, 0, 0, 0, 0, 0, 1, 1, 1]"
16784,1,1,2,0.9697800986567946,"[0, 1, 1, 1, 0, 0, 1, 1, 1, 1]"
16785,1,1,2,0.3478962255286713,"[0, 0, 1, 0, 1, 0, 0, 1, 1, 0]"
16786,1,1,2,0.7547009186645897,"[1, 0, 0, 1, 0, 1, 1, 1, 0, 1]"
16787,1,1,2,0.6743495350117052,"[1, 0, 0, 1, 1, 0, 1, 1, 1, 1]"
16788,1,1,2,0.5738889206918928,"[0, 1, 1, 0, 0, 0, 1, 0, 0, 0]"
16789,1,1,2,0.039811692631522955,"[0, 0, 1, 1, 0, 0, 0, 0, 1, 1]"
16790,1,1,2,0.5573902615723634,"[1, 0, 1, 1, 0, 0, 1, 0, 1, 1]"
16791,1,1,2,0.7802902846071998,"[0, 0, 0, 1, 0, 0, 0, 1, 0, 0]"
16792,2,2,4,0.6219285534061236,"[0, 1, 0, 0, 1, 1, 0, 1, 0, 1]"
16793,1,1,2,0.9594575227310628,"[0, 0, 0, 1, 1, 0, 1, 0, 1, 0]"
16794,2,2,4,0.599435491001016,"[1, 0, 0, 1, 1, 0, 1, 0, 1, 1]"
16795,1,1,2,0.012751846972630099,"[0, 1, 1, 1, 0, 1, 1, 0, 0, 0]"
16796,1,1,2,0.7327637378702769,"[0, 0, 0, 1, 0, 1, 1, 0, 1, 1]"
16797,1,1,2,0.22362417245406485,"[0, 0, 1, 0, 1, 1, 0, 0, 1, 0]"
16798,2,2,4,0.26850808430075057,"[1, 1, 1, 1, 1, 1, 1, 1, 1, 0]"
16799,1,1,2,0.5014844528652721,"[0, 0, 1, 1, 0, 1, 1, 0, 0, 0]"
16800,2,2,4,0.2563490777014843,"[0, 1, 0, 0, 1, 0, 0, 0, 1, 1]"
16801,1,1,2,0.5989430759560797,"[1, 0, 1, 0, 0, 0, 1, 1, 0, 0]"
16802,1,1,2,0.92037276633647,"[1, 1, 0, 1, 0, 0, 1, 1, 0, 1]"
16803,1,1,2,0.476527755736475,"[0, 0, 0, 0, 1, 1, 1, 1, 0, 0]"
16804,1,1,2,0.8886768334514611,"[0, 1, 1, 0, 1, 0, 1, 0, 0, 1]"
16805,1,1,2,0.5030956569616957,"[1, 1, 1, 1, 1, 0, 0, 1, 0, 0]"
16806,1,1,2,0.8667959821717965,"[1, 1, 1, 1, 0, 0, 1, 1, 0, 1]"
16807,1,1,2,0.4792685920345995,"[0, 1, 0, 0, 1, 0, 0, 0, 0, 1]"
16808,1,1,2,0.11444920646898626,"[0, 0, 1, 1, 1, 0, 0, 1, 0, 1]"
16809,1,1,2,0.47529681610717966,"[1, 0, 1, 0, 1, 0, 1, 1, 0, 0]"
16810,1,1,2,0.3052102814692087,"[0, 1, 1, 1, 0, 0, 0, 1, 1, 0]"
16811,1,1,2,0.49367195347484316,"[0, 0, 1, 1, 1, 0, 1, 0, 0, 0]"
16812,1,1,2,0.8920298885766094,"[1, 1, 0, 1, 0, 0, 1, 0, 0, 0]"
16813,1,1,2,0.31367071701316196,"[1, 0, 0, 0, 1, 1, 0, 0, 0, 0]"
16814,1,1,2,0.37135919161908415,"[0, 0, 1, 1, 1, 1, 1, 1, 1, 1]"
16815,1,1,2,0.45531506208796924,"[0, 1, 0, 0, 1, 1, 0, 0, 1, 0]"
16816,1,1,2,0.8179474417708833,"[1, 1, 0, 0, 1, 0, 0, 0, 1, 1]"
16817,1,1,2,0.5393161520735154,"[0, 0, 1, 0, 1, 0, 1, 1, 1, 1]"
16818,2,2,4,0.25607199023062455,"[0, 0, 1, 1, 0, 0, 1, 1, 1, 0]"
16819,1,1,2,0.9721700831454733,"[0, 0, 1, 0, 1, 1, 1, 0, 0, 1]"
16820,1,1,2,0.9928498641235198,"[0, 1, 0, 0, 1, 0, 1, 1, 0, 0]"
16821,1,1,2,0.4421101352229172,"[1, 1, 0, 1, 1, 1, 0, 1, 1, 0]"
16822,1,1,2,0.7771249928176847,"[0, 0, 1, 0, 0, 1, 1, 0, 0, 0]"
16823,1,1,2,0.7045958052393659,"[1, 1, 0, 1, 0, 1, 1, 0, 1, 1]"
16824,1,1,2,0.9196811797117261,"[1, 1, 1, 1, 1, 1, 1, 0, 1, 0]"
16825,1,1,2,0.9868717353826829,"[1, 0, 0, 0, 1, 1, 1, 1, 0, 0]"
16826,1,1,2,0.6309208658487689,"[1, 1, 0, 1, 1, 0, 1, 1, 1, 0]"
16827,1,1,2,0.5444008414175532,"[1, 0, 0, 1, 0, 1, 1, 0, 0, 1]"
16828,1,1,2,0.06024699816125256,"[0, 0, 1, 0, 1, 0, 1, 1, 0, 1]"
16829,1,1,2,0.11622990406478384,"[1, 1, 0, 0, 1, 0, 0, 1, 0, 1]"
16830,1,1,2,0.6709430680081339,"[0, 1, 1, 0, 1, 1, 0, 1, 1, 1]"
16831,1,1,2,0.2667770934667739,"[0, 1, 1, 1, 0, 1, 0, 1, 0, 1]"
16832,1,1,2,0.935194492577851,"[0, 0, 1, 1, 1, 1, 1, 1, 0, 1]"
16833,1,1,2,0.08632950197139777,"[1, 1, 1, 1, 0, 0, 1, 0, 0, 0]"
16834,1,1,2,0.3325239010435813,"[0, 0, 1, 0, 0, 0, 1, 0, 1, 0]"
16835,1,1,2,0.43965624585788876,"[1, 0, 0, 1, 1, 0, 1, 0, 0, 1]"
16836,1,1,2,0.9715426069366356,"[1, 0, 0, 1, 1, 1, 1, 0, 0, 0]"
16837,1,1,2,0.8259811719891136,"[0, 1, 0, 1, 1, 1, 0, 0, 1, 1]"
16838,1,1,2,0.2935426427680655,"[0, 0, 0, 0, 0, 0, 1, 1, 0, 1]"
16839,1,1,2,0.5401010322885527,"[1, 0, 0, 1, 1, 1, 0, 1, 1, 1]"
16840,1,1,2,0.9750478173082066,"[1, 0, 0, 0, 1, 0, 0, 1, 0, 0]"
16841,1,1,2,0.6309396141083632,"[1, 1, 0, 0, 1, 1, 1, 0, 1, 0]"
16842,1,1,2,0.7491105222629254,"[0, 0, 1, 0, 0, 0, 1, 1, 0, 1]"
16843,1,1,2,0.6247619553749822,"[1, 1, 0, 1, 0, 1, 1, 0, 0, 0]"
16844,1,1,2,0.16903653897514348,"[1, 1, 0, 1, 1, 0, 0, 1, 0, 0]"
16845,1,1,2,0.28549444276160707,"[0, 0, 1, 0, 1, 1, 0, 0, 0, 0]"
16846,1,1,2,0.6248400590029783,"[1, 0, 1, 1, 1, 1, 0, 0, 0, 0]"
16847,1,1,2,0.8875660302723865,"[1, 1, 1, 1, 0, 0, 0, 1, 1, 0]"
16848,1,1,2,0.9676075747427159,"[1, 1, 1, 1, 1, 0, 0, 1, 1, 1]"
16849,2,2,4,0.6562205361936025,"[0, 0, 1, 0, 1, 1, 1, 0, 1, 1]"
16850,1,1,2,0.15011593704628856,"[0, 1, 0, 0, 1, 1, 0, 1, 1, 1]"
16851,1,1,2,0.22395803997103525,"[0, 1, 1, 1, 0, 1, 1, 1, 1, 1]"
16852,1,1,2,0.18433345627284414,"[0, 0, 1, 0, 1, 1, 1, 0, 1, 0]"
16853,1,1,2,0.9141677791215773,"[0, 0, 0, 1, 1, 1, 1, 0, 1, 0]"
16854,2,2,4,0.39578179331717434,"[0, 0, 1, 0, 0, 1, 1, 1, 1, 0]"
16855,1,1,2,0.1615198858569138,"[0, 0, 1, 0, 0, 1, 0, 0, 1, 1]"
16856,1,1,2,0.1873006087642649,"[1, 1, 1, 1, 0, 1, 0, 1, 0, 1]"
16857,1,1,2,0.2990466502150294,"[1, 0, 1, 0, 0, 0, 0, 0, 1, 0]"
16858,1,1,2,0.5253111511320628,"[0, 1, 0, 1, 1, 0, 1, 1, 0, 0]"
16859,1,1,2,0.6620501901309042,"[1, 0, 0, 1, 0, 0, 1, 0, 0, 1]"
16860,1,1,2,0.00504726285966095,"[1, 1, 0, 0, 0, 1, 0, 1, 1, 1]"
16861,1,1,2,0.5921713047692908,"[1, 0, 0, 1, 1, 0, 1, 0, 1, 0]"
16862,1,1,2,0.894180129941575,"[0, 1, 1, 1, 1, 0, 1, 0, 0, 1]"
16863,1,1,2,0.48676527984016726,"[0, 0, 0, 0, 0, 1, 0, 0, 1, 1]"
16864,1,1,2,0.3687233777948318,"[0, 0, 0, 1, 0, 0, 1, 1, 1, 1]"
16865,1,1,2,0.4754731042159436,"[1, 0, 1, 0, 0, 1, 0, 1, 0, 1]"
16866,1,1,2,0.3506661552360355,"[1, 1, 1, 0, 1, 0, 1, 0, 1, 1]"
16867,1,1,2,0.4228478108059124,"[1, 0, 1, 1, 0, 0, 0, 0, 1, 1]"
16868,1,1,2,0.06450327356320529,"[1, 0, 0, 1, 1, 1, 1, 1, 1, 0]"
16869,1,1,2,0.4163242533237854,"[0, 1, 0, 0, 0, 0, 0, 1, 1, 0]"
16870,1,1,2,0.8690533566109643,"[0, 0, 0, 0, 1, 1, 1, 0, 0, 0]"
16871,1,1,2,0.41371051004009096,"[1, 0, 0, 1, 0, 0, 1, 1, 1, 0]"
16872,1,1,2,0.38747261963749624,"[0, 1, 1, 1, 1, 1, 1, 0, 1, 0]"
16873,1,1,2,0.053999305964747446,"[0, 0, 1, 1, 0, 1, 0, 1, 0, 1]"
16874,1,1,2,0.2503474927198803,"[1, 0, 0, 0, 1, 1, 0, 1, 1, 1]"
16875,1,1,2,0.5321842531093368,"[1, 0, 1, 1, 0, 1, 0, 0, 0, 0]"
16876,2,2,4,0.55792453944607,"[0, 1, 0, 1, 1, 0, 0, 1, 0, 1]"
16877,1,1,2,0.6690862650938779,"[1, 1, 1, 0, 0, 0, 1, 1, 1, 0]"
16878,1,1,2,0.21258773214467952,"[0, 1, 0, 1, 1, 1, 0, 0, 1, 0]"
16879,1,1,2,0.4756442949404821,"[1, 1, 1, 0, 1, 0, 1, 1, 0, 1]"
16880,1,1,2,0.3630938940748517,"[1, 0, 0, 1, 0, 1, 1, 0, 0, 0]"
16881,1,1,2,0.16422541627091425,"[0, 1, 0, 0, 1, 1, 0, 0, 0, 1]"
16882,1,1,2,0.05400989334925288,"[1, 1, 0, 1, 1, 0, 1, 1, 1, 0]"
16883,1,1,2,0.10243937730848551,"[1, 0, 0, 1, 1, 0, 1, 0, 1, 1]"
16884,1,1,2,0.5995836280803284,"[0, 0, 1, 1, 0, 0, 0, 1, 0, 1]"
16885,2,2,4,0.6565394934717039,"[0, 1, 0, 1, 1, 1, 0, 0, 1, 1]"
16886,2,2,4,0.68548031805774,"[0, 0, 1, 0, 1, 0, 1, 0, 1, 0]"
16887,1,1,2,0.04297517755396718,"[0, 1, 0, 0, 0, 0, 1, 1, 1, 0]"
16888,1,1,2,0.10859616120837468,"[1, 1, 0, 1, 0, 1, 0, 1, 0, 0]"
16889,1,1,2,0.8979916806846933,"[0, 0, 0, 1, 0, 0, 1, 1, 1, 1]"
16890,1,1,2,0.47694646127297713,"[1, 1, 0, 1, 1, 0, 1, 0, 0, 0]"
16891,1,1,2,0.7981629546908576,"[0, 1, 1, 0, 1, 0, 0, 0, 1, 0]"
16892,3,3,6,0.2859366804781761,"[1, 0, 1, 0, 0, 1, 0, 1, 0, 1]"
16893,1,1,2,0.178015159148754,"[0, 0, 0, 1, 0, 1, 1, 0, 0, 0]"
16894,2,2,4,0.6393999662812272,"[0, 1, 0, 1, 0, 1, 0, 1, 1, 1]"
16895,1,1,2,0.38818742513213933,"[0, 1, 0, 0, 0, 0, 0, 0, 1, 0]"
16896,1,1,2,0.6975221626037577,"[1, 1, 1, 1, 0, 0, 0, 1, 1, 0]"
16897,1,1,2,0.7184204323889598,"[1, 0, 1, 1, 1, 1, 0, 0, 0, 1]"
16898,1,1,2,0.970726748562014,"[1, 1, 1, 0, 0, 1, 1, 1, 1, 1]"
16899,1,1,2,0.2756208858577701,"[0, 0, 1, 0, 0, 0, 0, 0, 1, 1]"
16900,1,1,2,0.6813383561001267,"[0, 1, 0, 1, 0, 0, 1, 0, 1, 0]"
16901,1,1,2,0.42535091466623676,"[1, 1, 1, 1, 0, 1, 0, 0, 0, 1]"
16902,1,1,2,0.07085981475141268,"[1, 0, 0, 1, 0, 0, 0, 0, 1, 0]"
16903,1,1,2,0.6404503801500304,"[0, 0, 0, 1, 0, 0, 0, 0, 0, 0]"
16904,1,1,2,0.8621335650309547,"[1, 1, 0, 0, 1, 0, 0, 1, 0, 1]"
16905,3,3,6,0.3753156375454543,"[1, 1, 1, 1, 0, 0, 0, 1, 1, 1]"
16906,1,1,2,0.5227458805818047,"[1, 0, 0, 1, 0, 1, 0, 0, 1, 1]"
16907,1,1,2,0.22326385392812487,"[0, 0, 0, 0, 1, 0, 0, 0, 0, 0]"
16908,1,1,2,0.060068249120095674,"[1, 0, 1, 0, 1, 1, 1, 0, 0, 0]"
16909,1,1,2,0.35087011051198547,"[0, 0, 0, 1, 1, 1, 1, 0, 0, 0]"
16910,1,1,2,0.6499707649181321,"[1, 1, 0, 1, 1, 0, 0, 1, 0, 1]"
16911,1,1,2,0.7995076945381031,"[0, 1, 0, 0, 0, 0, 1, 0, 0, 1]"
16912,1,1,2,0.9748726297048895,"[1, 0, 0, 1, 0, 1, 0, 1, 1, 0]"
16913,1,1,2,0.4243575715450838,"[0, 0, 0, 0, 0, 1, 1, 1, 0, 1]"
16914,1,1,2,0.5566793672657723,"[0, 1, 0, 0, 1, 1, 0, 0, 1, 0]"
16915,1,1,2,0.6604520846834061,"[1, 1, 0, 0, 1, 1, 1, 1, 0, 1]"
16916,1,1,2,0.46487451638283017,"[1, 1, 1, 1, 0, 0, 0, 0, 1, 0]"
16917,1,1,2,0.0051595149428177445,"[1, 0, 0, 0, 1, 1, 1, 1, 1, 1]"
16918,1,1,2,0.4558337902095485,"[1, 0, 1, 0, 0, 0, 1, 1, 1, 1]"
16919,1,1,2,0.9851193459294593,"[0, 1, 0, 0, 0, 0, 0, 1, 1, 1]"
16920,1,1,2,0.6724685373381841,"[1, 1, 1, 0, 1, 1, 0, 1, 1, 0]"
16921,1,1,2,0.9824339471628685,"[1, 1, 0, 0, 0, 0, 0, 0, 1, 0]"
16922,1,1,2,0.03751572451643015,"[1, 0, 0, 1, 1, 1, 1, 1, 1, 1]"
16923,1,1,2,0.9852586400233133,"[1, 1, 0, 0, 0, 1, 1, 1, 0, 0]"
16924,1,1,2,0.1473050894218062,"[0, 0, 1, 1, 0, 0, 0, 0, 0, 1]"
16925,1,1,2,0.19618533243279934,"[0, 0, 0, 1, 0, 0, 0, 0, 0, 1]"
16926,1,1,2,0.40868860719095823,"[0, 1, 1, 1, 0, 0, 0, 1, 1, 1]"
16927,1,1,2,0.6471422373393197,"[1, 0, 0, 1, 1, 1, 1, 1, 0, 1]"
16928,1,1,2,0.8836618710159206,"[1, 1, 0, 0, 0, 0, 0, 1, 1, 0]"
16929,1,1,2,0.6045648614479555,"[0, 1, 0, 1, 1, 1, 1, 0, 0, 0]"
16930,1,1,2,0.6725972392860871,"[0, 1, 1, 0, 0, 0, 0, 1, 1, 1]"
16931,1,1,2,0.08161282803340575,"[0, 1, 0, 0, 0, 0, 1, 1, 0, 0]"
16932,1,1,2,0.15404830209605969,"[1, 1, 0, 1, 0, 0, 1, 0, 1, 1]"
16933,1,1,2,0.11268743191940322,"[1, 1, 1, 0, 0, 1, 0, 0, 0, 1]"
16934,1,1,2,0.9765288279510679,"[1, 0, 0, 1, 1, 1, 0, 1, 0, 1]"
16935,1,1,2,0.5912117982777522,"[1, 1, 0, 1, 1, 0, 1, 1, 0, 1]"
16936,1,1,2,0.6489443527210651,"[1, 1, 0, 0, 0, 0, 0, 0, 1, 1]"
16937,1,1,2,0.12069902685332778,"[0, 0, 1, 1, 1, 0, 1, 0, 0, 0]"
16938,1,1,2,0.5239903566430117,"[1, 1, 0, 1, 1, 1, 0, 0, 1, 1]"
16939,1,1,2,0.35574874001980583,"[1, 1, 1, 0, 0, 1, 0, 0, 0, 0]"
16940,1,1,2,0.13452944172762127,"[1, 0, 1, 0, 1, 1, 0, 1, 0, 0]"
16941,2,2,4,0.17124870782714485,"[1, 1, 1, 1, 1, 0, 0, 1, 1, 1]"
16942,1,1,2,0.0703974027833848,"[1, 0, 1, 0, 1, 0, 1, 1, 1, 1]"
16943,2,2,4,0.014827205397785814,"[1, 0, 0, 1, 0, 1, 1, 1, 1, 1]"
16944,1,1,2,0.9790189727254082,"[1, 1, 0, 0, 1, 0, 1, 0, 1, 1]"
16945,1,1,2,0.9370475107412524,"[1, 1, 0, 0, 1, 0, 1, 0, 0, 0]"
16946,1,1,2,0.8110615928233799,"[1, 1, 0, 1, 1, 0, 1, 0, 1, 1]"
16947,1,1,2,0.5319240307158561,"[1, 0, 0, 1, 1, 0, 1, 0, 0, 1]"
16948,1,1,2,0.5189731717717052,"[1, 1, 0, 1, 0, 1, 0, 0, 1, 1]"
16949,2,2,4,0.11451612501338326,"[0, 1, 0, 0, 1, 1, 1, 0, 1, 1]"
16950,1,1,2,0.9558400199640026,"[0, 1, 0, 0, 0, 1, 1, 1, 1, 0]"
16951,1,1,2,0.15703476339029843,"[1, 0, 0, 0, 0, 1, 0, 0, 1, 1]"
16952,1,1,2,0.0556755846159821,"[0, 1, 1, 1, 0, 1, 0, 0, 1, 0]"
16953,1,1,2,0.3801692403829593,"[1, 0, 0, 1, 0, 1, 1, 1, 0, 0]"
16954,1,1,2,0.3432503825226727,"[1, 0, 0, 1, 0, 1, 1, 1, 1, 0]"
16955,2,2,4,0.6410998085716227,"[0, 1, 0, 1, 1, 1, 0, 1, 0, 0]"
16956,1,1,2,0.6795262631760356,"[1, 0, 1, 1, 1, 1, 0, 1, 0, 1]"
16957,2,2,4,0.029006535558628088,"[0, 1, 1, 1, 0, 1, 0, 1, 0, 0]"
16958,1,1,2,0.11215976465216082,"[1, 0, 0, 0, 0, 0, 0, 0, 1, 1]"
16959,2,2,4,0.2170608677031285,"[0, 1, 0, 1, 0, 1, 1, 0, 0, 1]"
16960,2,2,4,0.471004933028651,"[1, 0, 1, 0, 0, 0, 1, 0, 1, 0]"
16961,1,1,2,0.37646585580928416,"[0, 0, 1, 0, 0, 0, 0, 0, 0, 0]"
16962,1,1,2,0.7171846859685921,"[1, 0, 1, 1, 1, 1, 0, 0, 0, 1]"
16963,1,1,2,0.29716941892563364,"[0, 0, 0, 0, 0, 1, 0, 1, 1, 0]"
16964,1,1,2,0.20837120752505256,"[1, 1, 0, 0, 0, 1, 0, 1, 0, 1]"
16965,1,1,2,0.9904230101071799,"[0, 0, 0, 1, 1, 1, 0, 0, 1, 0]"
16966,1,1,2,0.32723670413167827,"[1, 1, 1, 1, 0, 0, 1, 0, 0, 1]"
16967,1,1,2,0.6626287775972711,"[1, 1, 0, 1, 0, 1, 0, 1, 0, 0]"
16968,1,1,2,0.7112001741063548,"[1, 1, 0, 1, 1, 0, 0, 0, 0, 0]"
16969,1,1,2,0.9571383654796953,"[0, 0, 0, 1, 0, 0, 0, 0, 1, 1]"
16970,1,1,2,0.45231939356888096,"[1, 1, 0, 1, 0, 0, 1, 1, 0, 1]"
16971,1,1,2,0.41895002580155716,"[1, 0, 0, 0, 0, 1, 1, 1, 1, 1]"
16972,1,1,2,0.8348340815415114,"[1, 0, 0, 0, 0, 1, 0, 0, 0, 0]"
16973,1,1,2,0.005830281121205649,"[1, 0, 1, 0, 1, 0, 0, 1, 1, 1]"
16974,1,1,2,0.6726193674201276,"[1, 1, 0, 1, 1, 1, 1, 1, 0, 1]"
16975,1,1,2,0.5386289338264718,"[0, 0, 1, 1, 0, 1, 0, 0, 0, 1]"
16976,1,1,2,0.6407340606798337,"[1, 1, 1, 1, 0, 1, 1, 1, 1, 1]"
16977,1,1,2,0.3582546491263333,"[1, 0, 0, 1, 1, 0, 0, 0, 1, 0]"
16978,1,1,2,0.7485481039559052,"[0, 0, 1, 1, 0, 1, 1, 0, 0, 1]"
16979,1,1,2,0.7842366971965873,"[1, 0, 1, 0, 0, 0, 0, 0, 1, 1]"
16980,1,1,2,0.027545003205419083,"[0, 1, 1, 0, 0, 1, 1, 1, 0, 0]"
16981,1,1,2,0.9667181098409556,"[1, 1, 1, 1, 1, 0, 1, 1, 0, 1]"
16982,1,1,2,0.9878844349600584,"[0, 0, 1, 1, 0, 1, 1, 1, 1, 1]"
16983,1,1,2,0.6318165462571468,"[1, 0, 1, 0, 1, 1, 1, 1, 1, 1]"
16984,1,1,2,0.8218721142225164,"[0, 1, 0, 1, 1, 0, 1, 1, 0, 0]"
16985,1,1,2,0.7527176996374615,"[1, 1, 0, 0, 0, 1, 0, 0, 1, 1]"
16986,1,1,2,0.6976424652277207,"[1, 0, 0, 1, 1, 0, 1, 1, 0, 0]"
16987,1,1,2,0.42712994663840453,"[1, 0, 0, 1, 1, 1, 0, 1, 0, 1]"
16988,2,2,4,0.9840629017536406,"[0, 1, 1, 0, 1, 1, 1, 1, 1, 0]"
16989,1,1,2,0.418536065473865,"[0, 1, 1, 1, 0, 0, 0, 1, 0, 0]"
16990,1,1,2,0.8033418215844013,"[1, 0, 1, 1, 1, 1, 0, 1, 0, 0]"
16991,1,1,2,0.9168587847644988,"[1, 1, 0, 0, 1, 0, 0, 0, 1, 1]"
16992,1,1,2,0.9475076555998849,"[0, 1, 1, 0, 0, 1, 0, 0, 0, 1]"
16993,1,1,2,0.9021949674487381,"[1, 0, 0, 1, 0, 1, 1, 0, 0, 0]"
16994,2,2,4,0.4569282070344629,"[1, 1, 0, 0, 1, 0, 1, 1, 0, 0]"
16995,1,1,2,0.8950137289064634,"[0, 1, 0, 0, 0, 0, 0, 0, 0, 0]"
16996,1,1,2,0.4649201506130475,"[0, 1, 0, 0, 1, 0, 1, 0, 0, 0]"
16997,1,1,2,0.6922926364953512,"[0, 1, 1, 0, 1, 0, 1, 0, 1, 1]"
16998,1,1,2,0.9967534904813841,"[1, 0, 1, 0, 1, 1, 1, 0, 0, 0]"
16999,2,2,4,0.42181868211558937,"[0, 1, 0, 0, 1, 0, 1, 1, 0, 1]"
17000,1,1,2,0.12306650886311843,"[1, 0, 0, 0, 0, 1, 0, 0, 1, 0]"
17001,1,1,2,0.08193422177515985,"[0, 1, 1, 0, 1, 1, 0, 0, 0, 1]"
17002,1,1,2,0.7420490396324049,"[1, 0, 1, 0, 0, 1, 0, 0, 1, 1]"
17003,1,1,2,0.1515968848538034,"[1, 0, 1, 1, 1, 0, 0, 1, 0, 0]"
17004,1,1,2,0.9472849821110416,"[1, 1, 0, 1, 0, 0, 1, 1, 1, 0]"
17005,1,1,2,0.8237090785977397,"[0, 1, 0, 0, 0, 0, 1, 0, 0, 0]"
17006,1,1,2,0.6176661399236442,"[0, 0, 1, 1, 0, 1, 1, 0, 0, 1]"
17007,1,1,2,0.5805780972200146,"[0, 0, 1, 0, 1, 1, 1, 0, 0, 1]"
17008,1,1,2,0.9818518174318756,"[1, 1, 1, 0, 0, 0, 1, 1, 1, 1]"
17009,1,1,2,0.09394497935752544,"[0, 0, 1, 0, 1, 1, 0, 0, 0, 0]"
17010,1,1,2,0.9902569793443623,"[0, 0, 1, 1, 1, 0, 0, 1, 1, 0]"
17011,1,1,2,0.505896305298481,"[0, 0, 0, 1, 1, 1, 0, 1, 0, 1]"
17012,1,1,2,0.648970465798406,"[0, 1, 1, 0, 0, 0, 1, 1, 1, 0]"
17013,1,1,2,0.5806646210122554,"[0, 0, 0, 1, 1, 1, 0, 1, 0, 1]"
17014,1,1,2,0.10072220787558328,"[1, 0, 1, 1, 0, 0, 0, 1, 1, 0]"
17015,1,1,2,0.07786351381387102,"[1, 0, 1, 1, 1, 1, 1, 1, 1, 1]"
17016,1,1,2,0.45638986264763337,"[1, 0, 0, 1, 0, 1, 0, 0, 0, 0]"
17017,1,1,2,0.1674480655203272,"[0, 1, 1, 1, 0, 0, 1, 1, 0, 0]"
17018,1,1,2,0.438285753486214,"[0, 1, 0, 1, 1, 0, 0, 0, 1, 1]"
17019,1,1,2,0.918763444266427,"[1, 1, 1, 0, 1, 1, 0, 0, 0, 0]"
17020,2,2,4,0.4117806213158941,"[1, 0, 1, 1, 0, 1, 0, 0, 1, 0]"
17021,1,1,2,0.8538849914824879,"[0, 1, 1, 1, 1, 0, 1, 0, 0, 0]"
17022,1,1,2,0.019841035798604523,"[0, 1, 0, 1, 1, 0, 0, 1, 1, 1]"
17023,1,1,2,0.8426930604344586,"[1, 1, 0, 0, 0, 1, 0, 1, 1, 1]"
17024,1,1,2,0.7777145993914304,"[0, 1, 0, 0, 0, 1, 1, 0, 0, 1]"
17025,1,1,2,0.42323477652844,"[1, 1, 1, 1, 1, 0, 1, 1, 0, 0]"
17026,2,2,4,0.0748366399827709,"[0, 0, 0, 1, 0, 0, 1, 0, 0, 1]"
17027,1,1,2,0.973961556704169,"[0, 1, 0, 0, 0, 0, 1, 1, 1, 1]"
17028,1,1,2,0.8933408881771294,"[0, 1, 1, 0, 0, 0, 0, 0, 0, 0]"
17029,2,2,4,0.5668213224817847,"[1, 1, 1, 1, 1, 0, 1, 0, 0, 1]"
17030,1,1,2,0.11363584290204409,"[0, 0, 1, 1, 0, 1, 0, 0, 1, 1]"
17031,1,1,2,0.840283675569427,"[1, 1, 0, 1, 1, 0, 0, 1, 1, 1]"
17032,1,1,2,0.2667138265642224,"[0, 1, 0, 1, 0, 0, 0, 0, 1, 0]"
17033,1,1,2,0.22201136709431557,"[0, 1, 1, 0, 0, 0, 0, 0, 1, 1]"
17034,1,1,2,0.6406074882176156,"[0, 0, 1, 1, 0, 1, 1, 1, 0, 1]"
17035,1,1,2,0.8841087198592504,"[1, 1, 1, 0, 1, 0, 0, 1, 0, 0]"
17036,1,1,2,0.16437471716110308,"[0, 1, 0, 1, 0, 1, 0, 1, 0, 1]"
17037,1,1,2,0.6467382643282301,"[1, 1, 1, 1, 0, 0, 0, 0, 1, 0]"
17038,1,1,2,0.9368722156264986,"[1, 0, 1, 0, 0, 1, 0, 1, 0, 0]"
17039,1,1,2,0.6979885730668752,"[0, 0, 0, 0, 1, 0, 0, 1, 1, 1]"
17040,1,1,2,0.7215453817497921,"[1, 1, 1, 1, 0, 1, 1, 0, 0, 0]"
17041,1,1,2,0.3214052223509364,"[1, 1, 1, 1, 0, 0, 0, 1, 0, 1]"
17042,1,1,2,0.07782343949062576,"[0, 0, 0, 0, 0, 0, 1, 0, 0, 1]"
17043,1,1,2,0.5592479894009467,"[1, 1, 1, 0, 0, 1, 0, 0, 1, 0]"
17044,1,1,2,0.6869206973174553,"[1, 1, 0, 0, 0, 1, 1, 1, 0, 0]"
17045,2,2,4,0.4552887143861898,"[1, 1, 0, 0, 0, 1, 0, 0, 1, 1]"
17046,1,1,2,0.6586403910031675,"[1, 1, 1, 1, 1, 0, 1, 1, 1, 0]"
17047,1,1,2,0.21487899070755623,"[0, 1, 0, 0, 0, 1, 1, 0, 0, 1]"
17048,1,1,2,0.8951204317245982,"[1, 1, 0, 1, 1, 0, 0, 0, 0, 0]"
17049,1,1,2,0.49882286937526654,"[0, 1, 1, 1, 1, 0, 0, 1, 1, 1]"
17050,1,1,2,0.5577416832664749,"[0, 0, 1, 1, 0, 1, 1, 0, 0, 1]"
17051,1,1,2,0.39804559564004627,"[1, 1, 0, 0, 0, 0, 1, 0, 0, 1]"
17052,1,1,2,0.3804597310529608,"[0, 1, 1, 1, 0, 1, 0, 0, 1, 1]"
17053,1,1,2,0.2895395509793992,"[0, 0, 0, 1, 0, 0, 1, 0, 1, 1]"
17054,1,1,2,0.8395510693029415,"[0, 0, 0, 1, 0, 1, 0, 1, 0, 1]"
17055,1,1,2,0.4388114071547937,"[1, 0, 1, 1, 0, 1, 1, 0, 1, 1]"
17056,2,2,4,0.2794780978182074,"[1, 0, 1, 1, 0, 1, 1, 1, 1, 1]"
17057,1,1,2,0.40444946973783713,"[1, 0, 0, 1, 0, 1, 0, 0, 0, 1]"
17058,1,1,2,0.013902188604872134,"[1, 1, 1, 0, 1, 1, 0, 1, 0, 0]"
17059,1,1,2,0.7991620958067183,"[1, 1, 1, 0, 0, 0, 0, 1, 0, 0]"
17060,1,1,2,0.07725926106965608,"[1, 0, 1, 1, 0, 0, 1, 0, 0, 1]"
17061,1,1,2,0.6161051254747469,"[0, 1, 1, 0, 1, 0, 0, 1, 0, 1]"
17062,1,1,2,0.49106374101424244,"[0, 1, 1, 1, 1, 0, 1, 1, 0, 0]"
17063,1,1,2,0.184112763823866,"[0, 0, 1, 1, 1, 0, 1, 1, 0, 0]"
17064,1,1,2,0.2488799304288627,"[1, 0, 0, 1, 0, 1, 0, 0, 0, 0]"
17065,1,1,2,0.16669649388182417,"[0, 1, 0, 0, 1, 0, 1, 0, 0, 0]"
17066,1,1,2,0.09073498395999091,"[1, 0, 0, 1, 1, 0, 0, 1, 1, 0]"
17067,1,1,2,0.9789758704256812,"[1, 1, 1, 1, 0, 0, 1, 1, 1, 0]"
17068,1,1,2,0.26238067249963926,"[0, 0, 1, 1, 0, 1, 1, 0, 0, 1]"
17069,1,1,2,0.5627057538616785,"[0, 1, 0, 0, 1, 1, 0, 0, 0, 1]"
17070,1,1,2,0.07276968737024825,"[1, 0, 1, 0, 0, 0, 0, 0, 1, 1]"
17071,1,1,2,0.85674805270771,"[0, 0, 0, 1, 1, 1, 1, 0, 0, 1]"
17072,1,1,2,0.18776687916284884,"[0, 1, 0, 0, 1, 0, 0, 1, 0, 1]"
17073,1,1,2,0.6249671934074162,"[0, 1, 1, 1, 1, 0, 0, 0, 1, 1]"
17074,1,1,2,0.20624234323000978,"[1, 1, 1, 0, 1, 0, 0, 0, 1, 0]"
17075,1,1,2,0.13025401302358253,"[0, 1, 0, 0, 0, 1, 0, 0, 0, 0]"
17076,1,1,2,0.7968464635858575,"[0, 0, 1, 1, 1, 0, 1, 1, 0, 1]"
17077,1,1,2,0.014396496450547636,"[0, 0, 0, 0, 1, 1, 1, 0, 0, 1]"
17078,1,1,2,0.7974430707651637,"[0, 1, 1, 1, 1, 1, 0, 1, 0, 0]"
17079,3,3,6,0.4957747045204022,"[0, 1, 1, 1, 0, 0, 0, 0, 1, 1]"
17080,1,1,2,0.3374167881520024,"[0, 1, 0, 0, 0, 1, 1, 1, 1, 0]"
17081,1,1,2,0.14474921564925958,"[1, 0, 1, 1, 1, 1, 1, 1, 1, 0]"
17082,1,1,2,0.9840889563751719,"[0, 0, 1, 0, 0, 1, 0, 0, 1, 1]"
17083,1,1,2,0.7612887752248539,"[1, 1, 1, 1, 1, 1, 1, 0, 0, 0]"
17084,1,1,2,0.12315629191295696,"[0, 0, 1, 0, 0, 0, 1, 0, 0, 0]"
17085,1,1,2,0.09639788734942256,"[0, 1, 1, 1, 0, 1, 1, 0, 1, 1]"
17086,1,1,2,0.5446738831155495,"[1, 1, 1, 0, 1, 1, 1, 0, 1, 0]"
17087,1,1,2,0.33675992932456345,"[0, 0, 1, 1, 1, 0, 0, 1, 1, 1]"
17088,1,1,2,0.9189274667953198,"[1, 1, 0, 0, 0, 1, 1, 0, 0, 0]"
17089,1,1,2,0.9474201979629672,"[0, 1, 0, 0, 1, 1, 0, 1, 1, 0]"
17090,1,1,2,0.1941115272735474,"[0, 0, 1, 0, 1, 1, 0, 1, 1, 0]"
17091,1,1,2,0.214520103559117,"[1, 0, 0, 1, 0, 0, 0, 1, 0, 0]"
17092,1,1,2,0.43916909026525686,"[1, 0, 1, 0, 1, 0, 1, 1, 0, 0]"
17093,2,2,4,0.9678426613578378,"[1, 1, 0, 1, 0, 0, 1, 0, 1, 1]"
17094,1,1,2,0.8457943647858214,"[1, 1, 0, 1, 1, 0, 1, 1, 1, 0]"
17095,1,1,2,0.5878934633839862,"[0, 0, 0, 0, 0, 1, 1, 1, 0, 0]"
17096,1,1,2,0.7962850573756919,"[0, 1, 0, 0, 1, 1, 0, 0, 0, 0]"
17097,1,1,2,0.8792838503926899,"[0, 0, 1, 0, 0, 0, 0, 1, 1, 1]"
17098,1,1,2,0.5373661489663358,"[1, 0, 0, 1, 1, 1, 1, 1, 1, 0]"
17099,1,1,2,0.5787874065155683,"[0, 0, 1, 0, 0, 0, 1, 0, 0, 0]"
17100,1,1,2,0.04712410943148915,"[0, 1, 1, 0, 0, 1, 1, 1, 1, 1]"
17101,2,2,4,0.6817071896826109,"[1, 1, 1, 0, 0, 0, 1, 1, 0, 1]"
17102,1,1,2,0.24722355245414218,"[1, 1, 0, 1, 1, 1, 0, 0, 1, 0]"
17103,1,1,2,0.7301828883790161,"[1, 1, 0, 1, 0, 0, 0, 1, 0, 1]"
17104,1,1,2,0.24794027142728048,"[1, 0, 1, 1, 0, 1, 0, 1, 1, 0]"
17105,1,1,2,0.13715038287217374,"[1, 0, 1, 1, 1, 0, 1, 1, 0, 0]"
17106,1,1,2,0.2459309716749094,"[0, 1, 1, 0, 1, 1, 1, 0, 0, 0]"
17107,1,1,2,0.9878932679900929,"[0, 1, 0, 1, 0, 1, 0, 1, 0, 0]"
17108,1,1,2,0.7457419127666864,"[1, 0, 1, 1, 1, 1, 1, 1, 1, 1]"
17109,1,1,2,0.7221908864819121,"[1, 1, 1, 0, 0, 1, 0, 0, 1, 1]"
17110,1,1,2,0.31891662627624895,"[1, 0, 0, 0, 1, 0, 1, 0, 1, 0]"
17111,1,1,2,0.7514770698857255,"[1, 0, 1, 1, 1, 0, 0, 1, 0, 0]"
17112,1,1,2,0.5223435066240875,"[0, 1, 1, 1, 1, 1, 1, 0, 1, 0]"
17113,1,1,2,0.6642253464785379,"[0, 0, 0, 0, 0, 0, 1, 1, 0, 1]"
17114,1,1,2,0.5428936129720805,"[1, 1, 0, 1, 0, 1, 0, 1, 0, 0]"
17115,1,1,2,0.13168505536105046,"[0, 0, 1, 0, 0, 0, 1, 1, 0, 1]"
17116,1,1,2,0.42188219238090585,"[1, 0, 0, 0, 1, 1, 1, 1, 0, 0]"
17117,1,1,2,0.012061735920097627,"[1, 1, 1, 1, 0, 0, 0, 0, 1, 1]"
17118,1,1,2,0.1385006968629796,"[0, 1, 0, 0, 1, 1, 1, 1, 1, 1]"
17119,1,1,2,0.9646132742448933,"[1, 1, 1, 1, 0, 1, 0, 0, 0, 0]"
17120,1,1,2,0.7135652623205707,"[0, 1, 1, 1, 1, 0, 0, 0, 1, 0]"
17121,1,1,2,0.3097335280214665,"[1, 0, 1, 0, 1, 0, 0, 0, 1, 1]"
17122,1,1,2,0.14448377699829984,"[0, 1, 0, 0, 1, 0, 1, 0, 1, 0]"
17123,1,1,2,0.14201284339800713,"[0, 0, 0, 1, 1, 1, 0, 1, 0, 0]"
17124,1,1,2,0.13333539599650412,"[0, 0, 0, 0, 0, 0, 0, 0, 0, 1]"
17125,1,1,2,0.15343442424432652,"[0, 1, 1, 0, 0, 0, 1, 1, 1, 0]"
17126,1,1,2,0.298274332662415,"[0, 0, 0, 0, 1, 1, 1, 1, 1, 0]"
17127,1,1,2,0.2957878538233051,"[1, 0, 0, 1, 0, 1, 0, 1, 0, 1]"
17128,1,1,2,0.12063653229572024,"[0, 0, 0, 0, 0, 0, 1, 1, 1, 1]"
17129,1,1,2,0.38914843090334206,"[1, 1, 1, 0, 1, 1, 1, 0, 1, 1]"
17130,1,1,2,0.8876695593195771,"[1, 0, 1, 0, 1, 0, 1, 1, 1, 1]"
17131,1,1,2,0.47056564179977134,"[0, 1, 1, 0, 1, 1, 0, 0, 1, 1]"
17132,1,1,2,0.9783743643358899,"[0, 1, 1, 1, 0, 0, 0, 1, 0, 1]"
17133,1,1,2,0.009553268948157556,"[1, 1, 0, 0, 1, 0, 0, 0, 1, 1]"
17134,1,1,2,0.507757311482281,"[0, 0, 0, 1, 0, 0, 1, 0, 0, 1]"
17135,1,1,2,0.18390901587167685,"[0, 1, 1, 1, 1, 0, 0, 1, 1, 0]"
17136,2,2,4,0.3267063244927796,"[1, 1, 1, 1, 1, 1, 0, 0, 1, 0]"
17137,1,1,2,0.7423897990600827,"[1, 0, 0, 0, 1, 1, 0, 0, 1, 1]"
17138,1,1,2,0.6371171272578738,"[0, 1, 1, 1, 1, 0, 1, 0, 1, 1]"
17139,1,1,2,0.7843742560411947,"[1, 0, 1, 0, 0, 0, 1, 1, 1, 0]"
17140,2,2,4,0.1647516020862645,"[1, 1, 1, 0, 0, 1, 1, 1, 1, 0]"
17141,1,1,2,0.61969726172844,"[1, 0, 0, 0, 0, 0, 0, 0, 1, 1]"
17142,1,1,2,0.3823881529273513,"[1, 1, 1, 1, 1, 0, 1, 0, 1, 1]"
17143,1,1,2,0.9728944974845646,"[1, 1, 0, 0, 0, 1, 0, 1, 0, 1]"
17144,1,1,2,0.6024155398389149,"[0, 1, 1, 0, 1, 1, 1, 1, 0, 1]"
17145,1,1,2,0.8448892137865045,"[0, 1, 1, 1, 1, 1, 1, 0, 1, 1]"
17146,1,1,2,0.7596934349301858,"[0, 0, 0, 0, 1, 0, 1, 0, 1, 1]"
17147,1,1,2,0.593603278353323,"[0, 1, 0, 0, 1, 0, 1, 1, 0, 0]"
17148,1,1,2,0.17789810729843958,"[0, 0, 0, 0, 1, 0, 0, 0, 0, 1]"
17149,1,1,2,0.902059077394197,"[1, 0, 0, 1, 1, 0, 0, 1, 0, 1]"
17150,1,1,2,0.1966505922806433,"[0, 1, 1, 1, 1, 0, 1, 1, 0, 0]"
17151,1,1,2,0.6066519098245535,"[1, 1, 1, 1, 1, 1, 1, 1, 0, 1]"
17152,1,1,2,0.4391237574179879,"[0, 0, 0, 0, 1, 0, 1, 0, 0, 1]"
17153,1,1,2,0.3428866967852463,"[0, 1, 0, 1, 0, 1, 0, 1, 0, 0]"
17154,1,1,2,0.2576627395108022,"[1, 1, 0, 1, 1, 0, 0, 1, 1, 1]"
17155,1,1,2,0.7299339294509694,"[0, 0, 0, 1, 1, 1, 0, 1, 1, 0]"
17156,1,1,2,0.9594409988603143,"[0, 0, 0, 1, 1, 1, 1, 0, 0, 1]"
17157,1,1,2,0.8344925976625861,"[0, 0, 1, 1, 0, 0, 0, 0, 0, 0]"
17158,1,1,2,0.5534201049841629,"[1, 1, 1, 0, 1, 0, 0, 0, 0, 1]"
17159,1,1,2,0.7361262054772983,"[0, 0, 0, 1, 0, 1, 0, 0, 0, 1]"
17160,1,1,2,0.3043204889251029,"[0, 0, 1, 1, 0, 1, 1, 0, 1, 0]"
17161,1,1,2,0.10754151972065773,"[0, 1, 1, 0, 1, 1, 0, 0, 1, 0]"
17162,2,2,4,0.4336981159023988,"[0, 0, 0, 1, 1, 0, 1, 1, 1, 1]"
17163,1,1,2,0.5327081691123662,"[0, 1, 1, 1, 0, 0, 1, 1, 1, 1]"
17164,1,1,2,0.004546830691238735,"[0, 0, 0, 0, 0, 0, 0, 0, 0, 1]"
17165,1,1,2,0.6546207947058371,"[1, 1, 1, 0, 0, 0, 0, 0, 1, 0]"
17166,1,1,2,0.21197061561970154,"[0, 0, 0, 1, 0, 0, 1, 1, 1, 0]"
17167,1,1,2,0.17436216857924203,"[1, 1, 1, 1, 1, 0, 0, 0, 1, 0]"
17168,2,2,4,0.5017083394823988,"[1, 0, 1, 0, 0, 1, 1, 0, 1, 1]"
17169,1,1,2,0.8146997496239045,"[0, 0, 1, 1, 1, 1, 1, 1, 1, 0]"
17170,1,1,2,0.5501822394106824,"[1, 0, 0, 0, 1, 1, 1, 0, 0, 0]"
17171,1,1,2,0.5781415152911906,"[0, 0, 1, 1, 1, 0, 1, 0, 0, 0]"
17172,1,1,2,0.17338323953405743,"[0, 0, 1, 1, 0, 0, 1, 0, 0, 1]"
17173,1,1,2,0.1952709510875097,"[0, 1, 0, 0, 0, 0, 0, 0, 0, 1]"
17174,3,3,6,0.4167438412954959,"[1, 0, 1, 1, 1, 0, 1, 0, 1, 1]"
17175,1,1,2,0.6861057476443944,"[1, 1, 1, 0, 0, 0, 0, 0, 1, 1]"
17176,1,1,2,0.6531997788302712,"[1, 0, 1, 0, 1, 1, 0, 1, 1, 1]"
17177,1,1,2,0.33785935403213174,"[1, 0, 1, 1, 0, 0, 0, 1, 1, 0]"
17178,1,1,2,0.5763586502008132,"[1, 0, 1, 0, 1, 0, 0, 1, 0, 1]"
17179,1,1,2,0.736680242705195,"[0, 0, 1, 1, 1, 0, 1, 1, 0, 0]"
17180,1,1,2,0.06120394368968296,"[0, 0, 1, 1, 0, 0, 0, 1, 0, 0]"
17181,1,1,2,0.6223711606806718,"[1, 0, 1, 1, 0, 0, 0, 1, 1, 1]"
17182,1,1,2,0.9822112326549047,"[0, 1, 0, 1, 0, 1, 1, 1, 0, 1]"
17183,1,1,2,0.11457835964690866,"[1, 1, 0, 1, 1, 0, 1, 0, 1, 0]"
17184,1,1,2,0.9749150321222841,"[0, 1, 0, 0, 1, 1, 1, 1, 0, 0]"
17185,1,1,2,0.6541656359548366,"[1, 0, 1, 0, 0, 1, 1, 0, 1, 1]"
17186,1,1,2,0.635374849082895,"[0, 1, 1, 0, 1, 0, 1, 1, 1, 0]"
17187,1,1,2,0.36385647020578815,"[0, 1, 1, 1, 0, 0, 0, 0, 1, 1]"
17188,1,1,2,0.8332760274974677,"[1, 0, 1, 0, 1, 0, 1, 0, 1, 1]"
17189,2,2,4,0.7045421790017224,"[0, 0, 1, 1, 0, 0, 0, 1, 0, 0]"
17190,1,1,2,0.24191370394163458,"[1, 1, 0, 1, 0, 1, 1, 1, 0, 1]"
17191,1,1,2,0.5541599051629175,"[0, 1, 0, 1, 1, 1, 0, 1, 0, 0]"
17192,1,1,2,0.7409822095221067,"[1, 1, 1, 0, 0, 1, 0, 0, 0, 1]"
17193,1,1,2,0.49299507487983696,"[0, 0, 1, 0, 1, 0, 1, 0, 0, 1]"
17194,1,1,2,0.35267823133904963,"[1, 1, 1, 1, 1, 1, 0, 1, 0, 1]"
17195,1,1,2,0.2794961622261408,"[1, 1, 1, 0, 0, 1, 1, 0, 0, 0]"
17196,1,1,2,0.6102721367922272,"[1, 0, 0, 1, 1, 1, 0, 1, 1, 1]"
17197,1,1,2,0.5638604048820344,"[1, 0, 0, 1, 0, 0, 0, 0, 1, 0]"
17198,2,2,4,0.971433107282485,"[1, 0, 1, 1, 0, 1, 1, 0, 1, 1]"
17199,1,1,2,0.22429172618298443,"[0, 0, 1, 1, 1, 0, 1, 1, 0, 0]"
17200,1,1,2,0.8112376398591972,"[0, 0, 1, 1, 0, 1, 1, 1, 1, 0]"
17201,1,1,2,0.18320918789043095,"[1, 1, 0, 1, 1, 0, 1, 1, 1, 1]"
17202,1,1,2,0.7981029509219288,"[1, 1, 1, 0, 0, 0, 0, 0, 0, 1]"
17203,1,1,2,0.0997880477841151,"[0, 0, 1, 1, 0, 1, 1, 0, 0, 0]"
17204,1,1,2,0.6521960750472879,"[0, 0, 1, 0, 1, 1, 0, 1, 0, 0]"
17205,1,1,2,0.6734918334851325,"[0, 1, 1, 1, 1, 0, 0, 0, 0, 0]"
17206,1,1,2,0.39904557441679145,"[0, 1, 1, 0, 1, 1, 1, 1, 1, 1]"
17207,1,1,2,0.12133778017981056,"[1, 0, 1, 1, 0, 1, 0, 1, 1, 0]"
17208,1,1,2,0.463574581579981,"[0, 0, 0, 0, 0, 1, 0, 1, 1, 1]"
17209,1,1,2,0.9512955866591437,"[0, 1, 1, 1, 0, 0, 0, 1, 1, 1]"
17210,1,1,2,0.2357331519743887,"[1, 0, 0, 1, 1, 0, 1, 0, 1, 1]"
17211,1,1,2,0.5857419280015277,"[1, 0, 1, 0, 1, 0, 1, 0, 1, 1]"
17212,1,1,2,0.5323383365335909,"[1, 1, 0, 1, 1, 0, 0, 0, 0, 1]"
17213,1,1,2,0.11692058269393002,"[1, 1, 0, 0, 1, 0, 1, 1, 0, 1]"
17214,1,1,2,0.48872241173339626,"[0, 0, 0, 0, 0, 1, 0, 0, 0, 0]"
17215,2,2,4,0.8669941242138852,"[1, 0, 1, 0, 0, 1, 0, 1, 0, 1]"
17216,1,1,2,0.786783894118895,"[1, 0, 1, 1, 0, 0, 0, 1, 0, 0]"
17217,1,1,2,0.02848890176861485,"[1, 0, 0, 0, 0, 1, 0, 1, 1, 1]"
17218,1,1,2,0.6961450273727812,"[1, 1, 0, 1, 1, 1, 0, 1, 1, 0]"
17219,1,1,2,0.4843017974510806,"[1, 1, 1, 0, 0, 0, 1, 0, 0, 1]"
17220,2,2,4,0.13882634322707288,"[1, 1, 0, 0, 0, 0, 1, 1, 1, 0]"
17221,1,1,2,0.2717707729430744,"[0, 1, 1, 0, 0, 0, 1, 1, 0, 1]"
17222,1,1,2,0.30728593045567243,"[1, 0, 0, 1, 0, 0, 1, 0, 1, 0]"
17223,1,1,2,0.6182439801266072,"[0, 1, 1, 1, 1, 0, 0, 0, 0, 0]"
17224,1,1,2,0.6876163639222811,"[1, 1, 0, 1, 1, 0, 1, 0, 1, 0]"
17225,1,1,2,0.9306546487372698,"[0, 1, 1, 0, 0, 1, 0, 0, 0, 1]"
17226,2,2,4,0.3945188838184466,"[0, 1, 1, 0, 0, 0, 1, 1, 1, 1]"
17227,1,1,2,0.3489648471432478,"[1, 0, 1, 1, 0, 1, 1, 1, 1, 1]"
17228,3,3,6,0.9486390003814467,"[1, 1, 1, 0, 1, 0, 1, 0, 1, 0]"
17229,1,1,2,0.1424632929762063,"[1, 0, 0, 0, 1, 1, 1, 0, 1, 0]"
17230,1,1,2,0.8040204157993055,"[1, 1, 1, 0, 1, 1, 1, 0, 1, 0]"
17231,2,2,4,0.6982891402617128,"[0, 1, 0, 1, 1, 1, 1, 0, 0, 0]"
17232,1,1,2,0.8872391005058922,"[1, 0, 0, 0, 0, 0, 0, 0, 1, 0]"
17233,1,1,2,0.9610836806168455,"[1, 0, 0, 0, 0, 0, 1, 1, 0, 1]"
17234,1,1,2,0.849030233377583,"[1, 1, 0, 1, 1, 1, 1, 1, 1, 0]"
17235,1,1,2,0.5380824303117292,"[0, 1, 1, 0, 0, 1, 1, 0, 0, 0]"
17236,1,1,2,0.3017919677377021,"[0, 1, 1, 0, 1, 0, 1, 1, 1, 0]"
17237,1,1,2,0.49672313468919005,"[1, 0, 1, 0, 0, 1, 0, 0, 1, 0]"
17238,1,1,2,0.6020359377755861,"[1, 1, 0, 1, 0, 0, 1, 1, 1, 1]"
17239,1,1,2,0.8769238491709129,"[0, 1, 1, 0, 0, 1, 0, 1, 1, 1]"
17240,1,1,2,0.9915447410129552,"[0, 1, 1, 0, 1, 1, 0, 0, 0, 0]"
17241,1,1,2,0.09979477600398023,"[0, 0, 0, 0, 0, 1, 0, 0, 1, 1]"
17242,1,1,2,0.7066259996697459,"[1, 1, 1, 1, 1, 1, 0, 1, 0, 0]"
17243,1,1,2,0.5488368217329807,"[1, 1, 0, 1, 0, 0, 0, 0, 1, 0]"
17244,1,1,2,0.07774046435078108,"[1, 1, 1, 1, 1, 1, 0, 0, 1, 1]"
17245,2,2,4,0.7238133356603647,"[0, 1, 0, 0, 1, 1, 1, 0, 1, 0]"
17246,1,1,2,0.616593130421233,"[1, 0, 1, 1, 1, 0, 0, 0, 1, 0]"
17247,1,1,2,0.4497859961575923,"[1, 0, 1, 1, 1, 0, 1, 0, 1, 0]"
17248,1,1,2,0.9739292056580907,"[1, 1, 0, 0, 0, 1, 1, 0, 1, 0]"
17249,1,1,2,0.27145904549606636,"[1, 0, 1, 1, 1, 1, 1, 1, 1, 0]"
17250,1,1,2,0.8294436080817414,"[0, 0, 0, 0, 0, 1, 1, 1, 0, 0]"
17251,1,1,2,0.4418263759039337,"[0, 0, 0, 0, 0, 0, 1, 0, 1, 0]"
17252,1,1,2,0.09838703223921508,"[1, 1, 0, 1, 0, 0, 0, 1, 1, 1]"
17253,1,1,2,0.787572288201828,"[1, 1, 1, 1, 0, 0, 1, 1, 0, 0]"
17254,2,2,4,0.12984784710483066,"[0, 1, 0, 1, 0, 1, 1, 0, 0, 1]"
17255,2,2,4,0.06496946343744536,"[1, 0, 0, 1, 0, 0, 1, 1, 0, 1]"
17256,1,1,2,0.34126067003483607,"[1, 1, 1, 1, 1, 1, 0, 0, 0, 1]"
17257,1,1,2,0.6070559055564162,"[1, 1, 1, 0, 0, 1, 1, 0, 1, 1]"
17258,1,1,2,0.47315506175116007,"[0, 0, 1, 0, 1, 1, 0, 1, 0, 1]"
17259,1,1,2,0.529475061384105,"[0, 1, 1, 0, 0, 1, 1, 1, 1, 1]"
17260,1,1,2,0.6444678187359636,"[1, 0, 0, 0, 0, 1, 0, 1, 0, 0]"
17261,1,1,2,0.9155895854354766,"[1, 0, 0, 0, 1, 0, 0, 0, 0, 1]"
17262,1,1,2,0.7221542078860513,"[0, 0, 0, 1, 1, 1, 0, 1, 0, 0]"
17263,1,1,2,0.9755148789509946,"[1, 0, 0, 0, 1, 0, 1, 0, 0, 0]"
17264,1,1,2,0.9813876739606912,"[0, 0, 0, 0, 1, 1, 0, 0, 0, 1]"
17265,1,1,2,0.517456942320702,"[1, 0, 0, 1, 0, 1, 0, 1, 0, 0]"
17266,1,1,2,0.1384195484084656,"[0, 1, 1, 1, 0, 1, 0, 0, 1, 0]"
17267,1,1,2,0.035157218788389066,"[0, 0, 1, 0, 1, 0, 0, 0, 1, 1]"
17268,1,1,2,0.30119189255892187,"[0, 0, 0, 1, 1, 0, 1, 1, 0, 0]"
17269,1,1,2,0.833199598000851,"[1, 1, 0, 0, 0, 1, 1, 0, 1, 1]"
17270,1,1,2,0.5446245992517824,"[1, 1, 1, 1, 0, 1, 0, 1, 0, 0]"
17271,1,1,2,0.13773547950579546,"[0, 0, 1, 1, 1, 1, 1, 1, 0, 1]"
17272,1,1,2,0.9325613243930132,"[1, 0, 1, 1, 0, 0, 1, 1, 1, 0]"
17273,1,1,2,0.8992876300262019,"[1, 1, 0, 1, 1, 1, 0, 0, 1, 1]"
17274,1,1,2,0.9017379040448833,"[1, 1, 1, 0, 1, 1, 0, 1, 1, 0]"
17275,1,1,2,0.5745416148820663,"[0, 0, 1, 0, 1, 0, 1, 0, 1, 0]"
17276,1,1,2,0.10276375973365837,"[0, 0, 1, 0, 1, 0, 0, 1, 1, 0]"
17277,1,1,2,0.6309452499566145,"[0, 1, 0, 1, 1, 0, 0, 0, 1, 1]"
17278,1,1,2,0.16244552300018256,"[0, 1, 0, 0, 0, 1, 0, 0, 1, 1]"
17279,1,1,2,0.9270139718192657,"[1, 1, 1, 0, 1, 0, 1, 0, 1, 0]"
17280,1,1,2,0.4744033577916352,"[0, 0, 0, 0, 0, 0, 1, 1, 1, 0]"
17281,1,1,2,0.31067478819836136,"[0, 0, 0, 1, 0, 0, 1, 1, 0, 1]"
17282,1,1,2,0.5687560442211683,"[1, 0, 0, 0, 0, 1, 1, 0, 0, 0]"
17283,1,1,2,0.7928621170823154,"[0, 0, 1, 0, 1, 0, 0, 0, 0, 0]"
17284,2,2,4,0.466154683368881,"[0, 0, 0, 0, 0, 1, 0, 0, 1, 1]"
17285,1,1,2,0.7546288254585077,"[1, 0, 0, 0, 0, 0, 0, 0, 0, 1]"
17286,1,1,2,0.06137270433442532,"[0, 0, 1, 0, 0, 1, 1, 1, 0, 0]"
17287,1,1,2,0.6500769176007112,"[1, 0, 1, 1, 0, 1, 1, 1, 1, 0]"
17288,1,1,2,0.9121262051991208,"[0, 0, 0, 1, 1, 1, 0, 1, 0, 0]"
17289,1,1,2,0.12782212686337668,"[0, 1, 0, 0, 0, 1, 1, 1, 1, 0]"
17290,1,1,2,0.37165754739586354,"[1, 1, 1, 0, 1, 1, 0, 1, 0, 1]"
17291,1,1,2,0.787221933269877,"[0, 0, 0, 1, 0, 1, 1, 1, 1, 1]"
17292,1,1,2,0.999912811006797,"[1, 1, 0, 0, 1, 0, 0, 1, 0, 1]"
17293,1,1,2,0.08666978836277717,"[1, 0, 1, 0, 0, 0, 0, 1, 1, 1]"
17294,1,1,2,0.4178658418957314,"[0, 0, 0, 0, 0, 0, 0, 1, 1, 0]"
17295,1,1,2,0.11616778347576195,"[1, 1, 0, 1, 1, 1, 1, 1, 1, 0]"
17296,1,1,2,0.07306012843175447,"[1, 1, 0, 0, 0, 1, 0, 0, 0, 0]"
17297,1,1,2,0.35899181830777604,"[0, 1, 1, 0, 0, 0, 0, 1, 1, 0]"
17298,1,1,2,0.8046163961310453,"[0, 1, 0, 1, 0, 0, 0, 0, 1, 0]"
17299,1,1,2,0.07120526167607322,"[1, 0, 1, 0, 0, 1, 0, 1, 1, 0]"
17300,1,1,2,0.8901999206609031,"[1, 1, 1, 1, 1, 0, 0, 0, 0, 1]"
17301,1,1,2,0.6541614004593346,"[0, 1, 1, 1, 1, 0, 1, 0, 1, 0]"
17302,1,1,2,0.8457200465822463,"[0, 0, 1, 0, 1, 1, 1, 1, 0, 0]"
17303,1,1,2,0.5912500307440884,"[1, 1, 0, 1, 1, 0, 0, 0, 0, 0]"
17304,1,1,2,0.6163792371176248,"[0, 1, 0, 1, 0, 1, 1, 1, 1, 1]"
17305,1,1,2,0.5299606293800924,"[1, 0, 1, 1, 0, 1, 1, 1, 0, 1]"
17306,1,1,2,0.16489405579048477,"[1, 1, 1, 1, 1, 0, 1, 1, 1, 0]"
17307,1,1,2,0.38875079673618507,"[0, 1, 0, 1, 1, 0, 0, 1, 0, 1]"
17308,1,1,2,0.08363763336032881,"[0, 0, 0, 0, 0, 1, 1, 1, 1, 0]"
17309,1,1,2,0.504747263767651,"[0, 0, 1, 1, 0, 0, 0, 1, 0, 1]"
17310,1,1,2,0.5647989740816273,"[1, 1, 0, 0, 1, 1, 1, 0, 0, 1]"
17311,1,1,2,0.8362916812228194,"[1, 1, 1, 1, 1, 0, 0, 1, 1, 0]"
17312,1,1,2,0.7708738980007193,"[0, 1, 0, 1, 1, 1, 1, 0, 0, 0]"
17313,1,1,2,0.2796320769001427,"[1, 1, 0, 1, 1, 0, 0, 0, 1, 0]"
17314,1,1,2,0.15650209373772006,"[1, 0, 0, 0, 0, 1, 1, 0, 0, 0]"
17315,1,1,2,0.3764373359774683,"[1, 1, 1, 0, 0, 0, 1, 0, 1, 0]"
17316,1,1,2,0.9132483743106852,"[1, 1, 0, 0, 0, 1, 0, 1, 1, 1]"
17317,1,1,2,0.7486445218049803,"[0, 0, 1, 1, 1, 0, 0, 0, 1, 0]"
17318,1,1,2,0.9202834244520695,"[1, 1, 0, 1, 1, 1, 1, 0, 0, 1]"
17319,1,1,2,0.22756273994650233,"[0, 0, 0, 0, 0, 1, 0, 0, 1, 0]"
17320,1,1,2,0.05094304916476855,"[1, 1, 1, 1, 0, 1, 1, 0, 0, 1]"
17321,1,1,2,0.5375181402615328,"[0, 1, 0, 0, 0, 1, 0, 1, 1, 0]"
17322,1,1,2,0.9048000866861158,"[0, 1, 0, 0, 1, 1, 1, 1, 1, 1]"
17323,1,1,2,0.2097428989594946,"[1, 1, 0, 1, 1, 0, 0, 1, 0, 0]"
17324,1,1,2,0.9885985290445201,"[1, 1, 0, 0, 1, 1, 0, 1, 0, 0]"
17325,1,1,2,0.6734556643495595,"[0, 0, 0, 0, 1, 0, 0, 1, 0, 0]"
17326,1,1,2,0.660029628612927,"[1, 0, 1, 1, 1, 1, 0, 1, 1, 1]"
17327,1,1,2,0.24219001758675174,"[1, 0, 1, 0, 0, 0, 0, 1, 1, 0]"
17328,1,1,2,0.3902945317853205,"[1, 0, 0, 1, 0, 0, 0, 0, 0, 0]"
17329,1,1,2,0.9157264408859287,"[0, 0, 1, 0, 1, 0, 1, 1, 0, 0]"
17330,1,1,2,0.8459275623555952,"[1, 0, 0, 1, 0, 0, 1, 0, 1, 1]"
17331,1,1,2,0.8728072387664482,"[0, 0, 0, 0, 0, 0, 0, 0, 0, 1]"
17332,1,1,2,0.777313141162505,"[0, 0, 0, 0, 1, 1, 1, 1, 1, 1]"
17333,1,1,2,0.19795673266031355,"[1, 1, 0, 1, 0, 0, 0, 1, 0, 1]"
17334,1,1,2,0.45169196239257625,"[1, 0, 0, 0, 1, 0, 0, 0, 0, 0]"
17335,1,1,2,0.23316065049437118,"[0, 1, 1, 0, 0, 0, 1, 0, 0, 1]"
17336,1,1,2,0.482790825613332,"[0, 1, 0, 0, 1, 0, 0, 0, 0, 1]"
17337,1,1,2,0.6633307377143565,"[0, 0, 1, 1, 1, 1, 1, 1, 0, 0]"
17338,1,1,2,0.6252240650251599,"[0, 0, 0, 1, 0, 0, 1, 0, 0, 1]"
17339,1,1,2,0.8021742706068511,"[0, 1, 1, 1, 0, 1, 0, 0, 0, 1]"
17340,1,1,2,0.1282090715565991,"[0, 1, 1, 0, 1, 1, 0, 1, 1, 1]"
17341,1,1,2,0.8480610446429743,"[1, 1, 1, 0, 1, 1, 0, 1, 0, 1]"
17342,1,1,2,0.25875295324213565,"[0, 0, 1, 0, 1, 1, 0, 0, 0, 1]"
17343,1,1,2,0.1983662076765077,"[0, 0, 1, 1, 0, 0, 1, 0, 1, 0]"
17344,1,1,2,0.9578872684734431,"[0, 1, 0, 0, 0, 0, 1, 1, 0, 1]"
17345,1,1,2,0.05338852163287533,"[1, 0, 0, 0, 1, 1, 1, 1, 1, 0]"
17346,1,1,2,0.7886467250448246,"[0, 1, 0, 1, 1, 0, 0, 1, 1, 1]"
17347,1,1,2,0.2097563701335725,"[1, 1, 0, 0, 0, 0, 0, 0, 1, 0]"
17348,1,1,2,0.08022453716937195,"[1, 1, 0, 0, 0, 1, 1, 1, 1, 0]"
17349,1,1,2,0.7320162132774047,"[0, 0, 1, 1, 0, 0, 0, 0, 1, 0]"
17350,2,2,4,0.20837770516256704,"[0, 0, 1, 1, 1, 0, 1, 1, 1, 1]"
17351,1,1,2,0.9354326967054231,"[1, 0, 1, 0, 0, 0, 1, 0, 1, 0]"
17352,2,2,4,0.7477389266779124,"[1, 1, 0, 1, 1, 0, 1, 0, 1, 0]"
17353,1,1,2,0.3856559657918306,"[0, 0, 1, 0, 0, 1, 0, 1, 0, 0]"
17354,1,1,2,0.25056275383471316,"[0, 1, 1, 1, 1, 1, 1, 1, 0, 0]"
17355,1,1,2,0.5053861390204943,"[1, 1, 0, 0, 0, 0, 0, 1, 1, 1]"
17356,1,1,2,0.6950830458610161,"[0, 1, 1, 0, 0, 0, 1, 1, 0, 0]"
17357,1,1,2,0.9297444385311666,"[1, 0, 0, 0, 1, 1, 1, 0, 1, 1]"
17358,1,1,2,0.6462572435237999,"[1, 1, 0, 1, 1, 0, 0, 1, 1, 1]"
17359,1,1,2,0.9577024460613794,"[0, 0, 0, 0, 0, 1, 0, 0, 0, 0]"
17360,1,1,2,0.8116857492442995,"[1, 1, 0, 0, 1, 0, 1, 1, 1, 1]"
17361,1,1,2,0.23023687781867064,"[0, 0, 1, 1, 1, 1, 1, 0, 0, 0]"
17362,1,1,2,0.11116906406184535,"[0, 0, 1, 1, 1, 0, 0, 0, 1, 1]"
17363,1,1,2,0.6398487342807629,"[1, 0, 0, 0, 0, 1, 1, 1, 0, 0]"
17364,1,1,2,0.6232929494995235,"[1, 1, 1, 1, 0, 1, 1, 0, 1, 0]"
17365,1,1,2,0.2601506245130385,"[1, 0, 1, 1, 1, 0, 1, 1, 0, 0]"
17366,1,1,2,0.9555376174967113,"[0, 1, 0, 1, 0, 1, 1, 0, 0, 0]"
17367,1,1,2,0.29139014309041755,"[1, 0, 1, 1, 0, 1, 1, 1, 0, 1]"
17368,1,1,2,0.015405853231512223,"[0, 0, 1, 1, 1, 0, 1, 0, 1, 0]"
17369,1,1,2,0.4062005235440832,"[0, 1, 0, 1, 0, 1, 1, 1, 1, 0]"
17370,1,1,2,0.25843562321399405,"[1, 1, 0, 0, 0, 0, 1, 1, 0, 0]"
17371,1,1,2,0.20937621858367172,"[1, 1, 0, 0, 1, 0, 1, 1, 0, 1]"
17372,1,1,2,0.10833120809033592,"[0, 0, 1, 0, 0, 0, 1, 0, 1, 0]"
17373,1,1,2,0.4781212264792165,"[1, 0, 0, 0, 0, 0, 0, 0, 0, 1]"
17374,1,1,2,0.15012810343176786,"[1, 0, 0, 1, 1, 0, 0, 0, 1, 0]"
17375,1,1,2,0.38033327069982314,"[0, 0, 1, 0, 0, 1, 0, 0, 0, 1]"
17376,1,1,2,0.9710661188798023,"[0, 0, 0, 0, 1, 1, 1, 0, 0, 0]"
17377,1,1,2,0.45909069306441264,"[1, 0, 0, 0, 0, 0, 0, 0, 1, 1]"
17378,1,1,2,0.45099774817973537,"[1, 1, 1, 1, 0, 1, 1, 1, 1, 1]"
17379,1,1,2,0.939191451118657,"[0, 0, 0, 0, 0, 0, 1, 0, 0, 0]"
17380,1,1,2,0.1365472222401981,"[0, 1, 1, 1, 0, 0, 1, 1, 1, 0]"
17381,1,1,2,0.9447054915646836,"[1, 1, 1, 0, 1, 1, 0, 0, 1, 1]"
17382,1,1,2,0.2316613444640051,"[0, 0, 1, 1, 1, 1, 1, 1, 1, 1]"
17383,1,1,2,0.5947000678752726,"[0, 0, 0, 0, 0, 1, 0, 1, 0, 1]"
17384,1,1,2,0.5882376960581308,"[0, 1, 1, 0, 0, 0, 0, 1, 0, 0]"
17385,1,1,2,0.9859360176665346,"[1, 0, 0, 0, 0, 1, 0, 0, 1, 1]"
17386,1,1,2,0.9956394973242578,"[1, 0, 0, 0, 1, 0, 0, 1, 0, 1]"
17387,1,1,2,0.6255268185027528,"[0, 1, 1, 1, 0, 0, 1, 1, 0, 1]"
17388,1,1,2,0.8622030883423357,"[1, 1, 0, 1, 0, 1, 0, 0, 0, 1]"
17389,1,1,2,0.6073840004042118,"[1, 1, 1, 1, 1, 1, 0, 0, 1, 1]"
17390,1,1,2,0.008857506006017313,"[0, 0, 0, 1, 1, 0, 1, 0, 0, 0]"
17391,1,1,2,0.32319461485183476,"[0, 1, 1, 0, 0, 1, 0, 1, 0, 0]"
17392,1,1,2,0.22096726332685646,"[1, 0, 1, 0, 1, 1, 1, 0, 1, 0]"
17393,1,1,2,0.3626421292119454,"[1, 1, 0, 0, 0, 1, 0, 1, 1, 0]"
17394,1,1,2,0.023309158488892368,"[1, 1, 1, 1, 0, 1, 1, 1, 0, 0]"
17395,1,1,2,0.14733123791630087,"[0, 1, 0, 1, 0, 0, 1, 0, 1, 0]"
17396,1,1,2,0.20766112554733407,"[1, 1, 1, 0, 0, 0, 1, 1, 1, 0]"
17397,1,1,2,0.2757635791025431,"[0, 0, 0, 1, 0, 1, 1, 0, 1, 0]"
17398,1,1,2,0.4567769896965067,"[0, 1, 1, 0, 1, 1, 1, 1, 1, 1]"
17399,1,1,2,0.28425606332452713,"[0, 1, 0, 1, 0, 1, 1, 0, 1, 0]"
17400,1,1,2,0.3231326092520308,"[0, 1, 1, 0, 1, 0, 1, 1, 1, 0]"
17401,1,1,2,0.7995838989518973,"[0, 0, 0, 0, 1, 1, 1, 1, 1, 0]"
17402,1,1,2,0.1318071856633145,"[1, 0, 1, 0, 1, 0, 0, 0, 1, 1]"
17403,1,1,2,0.47145353658517397,"[0, 1, 0, 1, 0, 1, 0, 1, 0, 0]"
17404,1,1,2,0.23099456790402284,"[0, 1, 1, 1, 0, 0, 1, 1, 1, 1]"
17405,1,1,2,0.49455670334335144,"[0, 1, 1, 0, 0, 1, 1, 1, 0, 1]"
17406,1,1,2,0.6851731290038185,"[1, 1, 0, 1, 0, 1, 1, 1, 1, 1]"
17407,1,1,2,0.01982290174488832,"[1, 0, 0, 1, 0, 0, 0, 1, 1, 0]"
17408,1,1,2,0.7920052693593715,"[1, 1, 1, 1, 1, 1, 0, 1, 1, 0]"
17409,1,1,2,0.42064248348842437,"[0, 1, 0, 0, 0, 0, 1, 1, 0, 1]"
17410,1,1,2,0.17236241948812492,"[1, 0, 0, 1, 0, 0, 1, 1, 0, 1]"
17411,1,1,2,0.31877061563980746,"[1, 1, 1, 0, 1, 1, 0, 0, 1, 1]"
17412,1,1,2,0.05007579470524315,"[0, 1, 1, 0, 0, 1, 0, 0, 0, 0]"
17413,1,1,2,0.3893560515094039,"[1, 0, 1, 1, 0, 0, 1, 0, 0, 1]"
17414,1,1,2,0.0032242280029163295,"[1, 0, 0, 0, 1, 1, 1, 0, 1, 1]"
17415,1,1,2,0.9694239889970686,"[0, 1, 1, 0, 0, 1, 1, 0, 0, 0]"
17416,1,1,2,0.17304037512204684,"[1, 0, 0, 1, 1, 1, 0, 0, 1, 1]"
17417,1,1,2,0.24994463568376224,"[0, 1, 0, 1, 1, 0, 0, 1, 0, 1]"
17418,1,1,2,0.24168135375500444,"[1, 1, 1, 1, 0, 0, 1, 1, 0, 0]"
17419,1,1,2,0.452002239991282,"[0, 0, 1, 1, 1, 1, 0, 0, 0, 1]"
17420,1,1,2,0.5562292659959337,"[0, 0, 0, 1, 1, 1, 1, 0, 0, 0]"
17421,1,1,2,0.5783690932526946,"[0, 1, 1, 0, 0, 0, 0, 0, 1, 0]"
17422,1,1,2,0.675028089272662,"[0, 0, 0, 0, 1, 1, 1, 0, 0, 0]"
17423,1,1,2,0.8936815807806596,"[1, 0, 1, 1, 0, 1, 1, 0, 1, 1]"
17424,1,1,2,0.5432765853739089,"[1, 0, 1, 1, 0, 0, 0, 1, 0, 1]"
17425,1,1,2,0.6572614620294134,"[0, 1, 0, 0, 0, 1, 1, 1, 0, 0]"
17426,1,1,2,0.5830573040402908,"[0, 0, 1, 0, 0, 1, 0, 1, 1, 1]"
17427,1,1,2,0.7234375480351731,"[0, 0, 1, 0, 0, 1, 1, 0, 0, 0]"
17428,1,1,2,0.6286595934411235,"[1, 1, 1, 1, 1, 0, 1, 1, 0, 0]"
17429,1,1,2,0.615303103819982,"[1, 1, 1, 1, 0, 1, 1, 0, 0, 0]"
17430,1,1,2,0.6847066837428617,"[0, 0, 0, 0, 0, 1, 0, 0, 1, 0]"
17431,1,1,2,0.4606324097058606,"[0, 0, 1, 1, 0, 1, 0, 1, 0, 0]"
17432,2,2,4,0.7311143602092446,"[1, 0, 1, 0, 1, 1, 0, 1, 1, 1]"
17433,1,1,2,0.09446053641376395,"[0, 1, 1, 1, 1, 0, 0, 1, 1, 1]"
17434,1,1,2,0.9854097179371741,"[1, 0, 0, 0, 1, 1, 1, 0, 1, 1]"
17435,1,1,2,0.015845961987339896,"[0, 0, 0, 1, 1, 1, 1, 1, 1, 0]"
17436,3,3,6,0.810860931661817,"[1, 1, 1, 0, 1, 1, 1, 1, 1, 0]"
17437,1,1,2,0.47368461798341,"[0, 1, 0, 0, 0, 0, 1, 1, 1, 1]"
17438,1,1,2,0.4671521680102172,"[1, 0, 0, 0, 0, 1, 1, 0, 1, 0]"
17439,1,1,2,0.7673132280034253,"[1, 1, 1, 1, 0, 0, 1, 0, 1, 0]"
17440,1,1,2,0.8834732253744942,"[1, 1, 0, 0, 0, 0, 0, 1, 1, 0]"
17441,1,1,2,0.9130784230066916,"[1, 0, 0, 0, 0, 1, 0, 0, 0, 1]"
17442,1,1,2,0.32773088045181975,"[0, 1, 1, 0, 1, 1, 0, 1, 1, 1]"
17443,1,1,2,0.44260024107343965,"[1, 1, 1, 0, 1, 1, 0, 0, 1, 0]"
17444,1,1,2,0.5889444131026216,"[1, 1, 1, 1, 0, 1, 0, 0, 0, 0]"
17445,1,1,2,0.20376850345145747,"[0, 0, 0, 0, 0, 0, 1, 1, 0, 1]"
17446,1,1,2,0.13975420326830668,"[0, 0, 1, 0, 0, 1, 0, 1, 0, 0]"
17447,1,1,2,0.1045464921580086,"[1, 1, 0, 0, 0, 0, 0, 1, 0, 0]"
17448,1,1,2,0.43309027653347476,"[0, 0, 1, 0, 1, 1, 0, 1, 0, 1]"
17449,1,1,2,0.8195773757428271,"[1, 0, 0, 1, 0, 0, 1, 0, 0, 0]"
17450,1,1,2,0.41929845172224267,"[0, 0, 1, 0, 1, 0, 1, 0, 1, 0]"
17451,1,1,2,0.26588752764832513,"[0, 0, 0, 0, 0, 0, 0, 0, 1, 0]"
17452,1,1,2,0.8658552181198557,"[1, 1, 0, 1, 1, 0, 0, 0, 1, 0]"
17453,1,1,2,0.31612125984872164,"[1, 0, 1, 0, 0, 1, 0, 1, 0, 0]"
17454,1,1,2,0.4743949382490801,"[0, 1, 0, 0, 0, 0, 1, 0, 0, 1]"
17455,1,1,2,0.9336473283487645,"[0, 1, 1, 0, 1, 0, 1, 1, 1, 0]"
17456,1,1,2,0.17911993834580608,"[0, 0, 0, 1, 1, 1, 1, 1, 0, 0]"
17457,1,1,2,0.9430258506148411,"[1, 0, 0, 1, 1, 0, 0, 0, 1, 1]"
17458,1,1,2,0.30580022697876375,"[0, 0, 1, 0, 1, 1, 0, 1, 1, 1]"
17459,1,1,2,0.7070373309820147,"[0, 1, 1, 1, 0, 0, 1, 0, 0, 0]"
17460,1,1,2,0.9918930632687251,"[1, 1, 0, 1, 0, 1, 1, 0, 0, 0]"
17461,1,1,2,0.8120588916611328,"[0, 1, 1, 0, 1, 1, 1, 0, 1, 0]"
17462,1,1,2,0.10741529481312084,"[0, 1, 1, 1, 1, 0, 0, 1, 0, 1]"
17463,1,1,2,0.9936063399049988,"[1, 0, 1, 1, 1, 1, 1, 0, 1, 1]"
17464,1,1,2,0.844167745256494,"[1, 0, 0, 1, 1, 0, 0, 0, 0, 1]"
17465,1,1,2,0.4511381383219919,"[0, 1, 1, 0, 0, 0, 0, 1, 0, 0]"
17466,2,2,4,0.7806989663585826,"[1, 1, 0, 1, 1, 1, 1, 1, 1, 0]"
17467,1,1,2,0.6469489090814963,"[0, 1, 0, 1, 0, 0, 0, 1, 0, 0]"
17468,1,1,2,0.6955769872961972,"[1, 0, 1, 0, 0, 1, 1, 1, 0, 1]"
17469,1,1,2,0.5562966532294837,"[0, 1, 1, 0, 0, 0, 0, 1, 0, 1]"
17470,1,1,2,0.5434683453571426,"[0, 0, 1, 1, 1, 1, 1, 0, 1, 0]"
17471,1,1,2,0.6977238694032797,"[1, 0, 0, 1, 0, 0, 1, 0, 1, 1]"
17472,1,1,2,0.5694110211922438,"[0, 0, 0, 1, 1, 1, 1, 0, 0, 1]"
17473,1,1,2,0.8493745885677836,"[1, 1, 1, 0, 1, 1, 1, 0, 1, 1]"
17474,1,1,2,0.9420528269517223,"[1, 0, 0, 0, 0, 1, 0, 0, 0, 0]"
17475,1,1,2,0.6949709307007005,"[0, 1, 1, 0, 0, 1, 1, 1, 0, 1]"
17476,1,1,2,0.3325421968940321,"[1, 1, 0, 0, 1, 1, 0, 1, 1, 1]"
17477,1,1,2,0.8313866574131136,"[1, 0, 1, 1, 1, 1, 1, 1, 0, 0]"
17478,1,1,2,0.8922004692845977,"[1, 0, 1, 0, 1, 0, 0, 1, 1, 1]"
17479,1,1,2,0.616605587788615,"[0, 0, 1, 1, 1, 1, 1, 1, 0, 1]"
17480,1,1,2,0.03826537151993592,"[1, 0, 0, 0, 1, 1, 1, 1, 0, 1]"
17481,1,1,2,0.4632485327717696,"[0, 0, 0, 0, 1, 0, 1, 1, 0, 1]"
17482,1,1,2,0.47514420680255975,"[1, 0, 1, 0, 1, 1, 1, 0, 0, 1]"
17483,1,1,2,0.5221175910637704,"[0, 0, 1, 0, 1, 1, 1, 1, 1, 1]"
17484,1,1,2,0.07766718117735849,"[0, 0, 0, 1, 0, 0, 1, 0, 0, 1]"
17485,1,1,2,0.5565342393001164,"[0, 1, 0, 0, 0, 0, 1, 0, 0, 0]"
17486,1,1,2,0.7799918314176063,"[1, 0, 0, 0, 0, 0, 1, 0, 0, 1]"
17487,1,1,2,0.5024400096610206,"[0, 1, 0, 0, 1, 0, 1, 1, 1, 0]"
17488,1,1,2,0.10886295019952397,"[1, 0, 0, 0, 0, 1, 1, 0, 0, 1]"
17489,2,2,4,0.9672686887726616,"[0, 0, 0, 0, 0, 1, 1, 1, 0, 0]"
17490,1,1,2,0.7752499628982052,"[0, 0, 0, 0, 1, 0, 0, 0, 0, 0]"
17491,1,1,2,0.13279192488789548,"[0, 0, 0, 0, 0, 0, 0, 0, 0, 1]"
17492,1,1,2,0.3027673176371143,"[0, 1, 1, 1, 1, 1, 0, 0, 1, 1]"
17493,1,1,2,0.9162667262633241,"[0, 1, 1, 1, 0, 1, 1, 1, 1, 1]"
17494,1,1,2,0.4058229207292444,"[0, 0, 0, 0, 1, 1, 1, 1, 1, 0]"
17495,1,1,2,0.8527113420458511,"[1, 1, 0, 0, 1, 1, 0, 0, 0, 0]"
17496,1,1,2,0.7034391383644595,"[0, 1, 0, 1, 1, 1, 1, 0, 1, 0]"
17497,1,1,2,0.37626559429232453,"[1, 1, 0, 0, 1, 1, 1, 0, 0, 1]"
17498,1,1,2,0.3931542139199655,"[1, 0, 0, 0, 1, 1, 0, 1, 0, 1]"
17499,1,1,2,0.010868420392375788,"[0, 1, 0, 0, 0, 0, 0, 1, 1, 0]"
17500,1,1,2,0.8456391979334942,"[0, 1, 1, 1, 1, 0, 1, 1, 0, 0]"
17501,1,1,2,0.7966396612453086,"[1, 1, 1, 1, 0, 0, 0, 1, 0, 1]"
17502,1,1,2,0.7535300284897916,"[1, 0, 1, 0, 1, 1, 1, 1, 1, 0]"
17503,1,1,2,0.3745177532741807,"[0, 0, 0, 0, 0, 0, 1, 1, 1, 0]"
17504,1,1,2,0.484202748256771,"[1, 0, 0, 0, 0, 1, 1, 0, 1, 0]"
17505,1,1,2,0.31404198475067857,"[0, 1, 1, 1, 1, 1, 1, 1, 0, 0]"
17506,2,2,4,0.7672225602465473,"[0, 1, 0, 1, 1, 1, 1, 1, 0, 0]"
17507,1,1,2,0.00466910970854284,"[1, 1, 0, 1, 1, 0, 0, 0, 0, 1]"
17508,1,1,2,0.9129675906185657,"[1, 1, 0, 0, 0, 0, 0, 0, 1, 0]"
17509,1,1,2,0.23970885312469048,"[0, 0, 0, 0, 1, 0, 1, 1, 1, 1]"
17510,1,1,2,0.9533556705193247,"[0, 1, 1, 1, 1, 0, 0, 1, 1, 1]"
17511,1,1,2,0.8676351601328393,"[1, 1, 0, 0, 1, 0, 0, 0, 0, 1]"
17512,1,1,2,0.9241445210305385,"[0, 0, 0, 1, 0, 0, 1, 1, 0, 0]"
17513,1,1,2,0.13435701586350612,"[0, 1, 0, 0, 1, 0, 1, 0, 0, 1]"
17514,1,1,2,0.3914217206455165,"[1, 0, 0, 1, 0, 0, 1, 0, 0, 0]"
17515,1,1,2,0.5244218820310385,"[0, 1, 1, 0, 0, 0, 1, 1, 0, 0]"
17516,3,3,6,0.6777248448281947,"[0, 1, 0, 1, 1, 1, 0, 0, 1, 0]"
17517,1,1,2,0.6434135783049815,"[1, 1, 0, 0, 0, 1, 1, 1, 1, 1]"
17518,1,1,2,0.5626761593168184,"[1, 0, 1, 1, 1, 0, 0, 1, 1, 1]"
17519,1,1,2,0.5364311675994614,"[1, 0, 0, 0, 1, 0, 0, 0, 0, 1]"
17520,1,1,2,0.1270331623777753,"[1, 1, 0, 1, 0, 1, 0, 1, 1, 1]"
17521,1,1,2,0.2210338430268518,"[0, 1, 1, 1, 1, 0, 1, 0, 0, 0]"
17522,1,1,2,0.6356904174903437,"[0, 1, 0, 0, 1, 0, 0, 0, 0, 1]"
17523,1,1,2,0.6915842993532113,"[1, 1, 1, 1, 1, 0, 1, 1, 0, 1]"
17524,1,1,2,0.22700943807916174,"[1, 1, 1, 0, 0, 1, 0, 1, 0, 0]"
17525,1,1,2,0.6563736499242945,"[0, 1, 0, 0, 0, 0, 0, 0, 0, 0]"
17526,1,1,2,0.036433697367562856,"[0, 0, 0, 1, 0, 1, 1, 0, 0, 1]"
17527,1,1,2,0.8835486741933022,"[1, 0, 0, 1, 1, 1, 0, 1, 1, 0]"
17528,1,1,2,0.019073495602883517,"[1, 0, 1, 1, 1, 0, 1, 0, 1, 1]"
17529,1,1,2,0.3766044582070621,"[0, 0, 0, 0, 0, 0, 1, 1, 0, 1]"
17530,2,2,4,0.05270101728171073,"[0, 0, 1, 1, 0, 1, 1, 1, 1, 0]"
17531,1,1,2,0.38299988422208475,"[1, 1, 1, 1, 1, 0, 0, 0, 1, 1]"
17532,1,1,2,0.49690539566360237,"[0, 1, 0, 0, 0, 1, 0, 1, 0, 0]"
17533,1,1,2,0.1508606115300778,"[0, 0, 1, 1, 1, 1, 0, 0, 1, 1]"
17534,1,1,2,0.1759764895428677,"[0, 0, 1, 0, 1, 0, 1, 0, 0, 0]"
17535,1,1,2,0.08596654075279142,"[0, 0, 1, 0, 0, 0, 0, 0, 1, 1]"
17536,1,1,2,0.3527740505766034,"[1, 1, 0, 0, 1, 0, 0, 1, 0, 1]"
17537,1,1,2,0.17860589932340576,"[1, 1, 0, 0, 1, 0, 0, 0, 0, 1]"
17538,1,1,2,0.1833938086110105,"[0, 1, 1, 1, 0, 0, 1, 0, 1, 0]"
17539,1,1,2,0.2517779037365785,"[0, 1, 0, 1, 0, 1, 1, 0, 0, 1]"
17540,1,1,2,0.6707353556231728,"[1, 0, 1, 0, 0, 1, 0, 1, 1, 0]"
17541,1,1,2,0.9631462043918345,"[1, 1, 1, 0, 1, 0, 1, 1, 1, 0]"
17542,1,1,2,0.5472384710870312,"[1, 0, 0, 1, 1, 1, 0, 0, 0, 1]"
17543,1,1,2,0.5746479806638638,"[1, 1, 0, 0, 1, 0, 0, 1, 0, 0]"
17544,1,1,2,0.41640175399210877,"[0, 0, 0, 1, 0, 1, 1, 0, 1, 0]"
17545,1,1,2,0.7763055800264085,"[0, 1, 1, 0, 1, 0, 0, 0, 0, 1]"
17546,1,1,2,0.7022626894225119,"[1, 0, 1, 1, 0, 1, 0, 1, 0, 1]"
17547,1,1,2,0.25953496550008504,"[1, 0, 0, 0, 1, 1, 0, 0, 0, 0]"
17548,1,1,2,0.2618645947456365,"[1, 0, 0, 0, 0, 1, 1, 1, 0, 0]"
17549,1,1,2,0.7724718022967854,"[0, 1, 1, 0, 0, 0, 0, 0, 0, 0]"
17550,1,1,2,0.22809730483621116,"[1, 1, 1, 1, 1, 1, 1, 0, 0, 1]"
17551,1,1,2,0.4630440896862109,"[1, 0, 1, 0, 0, 0, 1, 1, 0, 0]"
17552,1,1,2,0.04449268365548853,"[1, 0, 0, 0, 0, 0, 0, 0, 0, 0]"
17553,1,1,2,0.8770282011783153,"[0, 1, 1, 0, 0, 1, 0, 1, 1, 0]"
17554,1,1,2,0.954187036468371,"[1, 0, 0, 0, 1, 1, 1, 0, 1, 0]"
17555,1,1,2,0.9161617631713437,"[0, 1, 0, 0, 1, 0, 0, 1, 0, 1]"
17556,1,1,2,0.8912008406937254,"[0, 0, 0, 0, 1, 1, 1, 0, 1, 0]"
17557,1,1,2,0.933941802101164,"[1, 0, 0, 0, 0, 0, 0, 1, 0, 1]"
17558,1,1,2,0.18819049022151801,"[0, 1, 0, 1, 0, 1, 1, 1, 0, 1]"
17559,1,1,2,0.15573825001180597,"[1, 1, 1, 0, 1, 0, 0, 0, 1, 0]"
17560,1,1,2,0.5229269564617609,"[1, 0, 0, 1, 0, 1, 1, 0, 1, 1]"
17561,1,1,2,0.014126882304227872,"[0, 0, 1, 0, 0, 1, 0, 0, 0, 0]"
17562,1,1,2,0.8005013844575244,"[1, 0, 1, 1, 0, 1, 0, 1, 1, 1]"
17563,1,1,2,0.4463226943157862,"[0, 0, 0, 1, 0, 0, 0, 0, 1, 0]"
17564,1,1,2,0.7491865440046281,"[1, 0, 0, 0, 1, 0, 1, 1, 0, 1]"
17565,1,1,2,0.6350302845052193,"[0, 0, 0, 0, 1, 1, 1, 0, 0, 0]"
17566,1,1,2,0.9660871688921289,"[1, 1, 0, 1, 1, 1, 0, 1, 0, 1]"
17567,1,1,2,0.7798385970294647,"[1, 1, 0, 1, 1, 1, 0, 1, 1, 1]"
17568,1,1,2,0.41070808119301716,"[0, 0, 0, 1, 1, 0, 0, 1, 0, 1]"
17569,2,2,4,0.6496613172973312,"[0, 1, 1, 1, 1, 0, 1, 0, 1, 0]"
17570,1,1,2,0.9420008349428539,"[0, 1, 0, 1, 1, 1, 1, 0, 0, 1]"
17571,1,1,2,0.9358803565639626,"[1, 0, 1, 0, 1, 1, 1, 0, 1, 1]"
17572,1,1,2,0.6053038505155431,"[1, 0, 1, 1, 1, 1, 0, 0, 1, 0]"
17573,1,1,2,0.29722576296349634,"[0, 1, 0, 1, 0, 0, 0, 0, 1, 1]"
17574,1,1,2,0.6397857100026332,"[1, 1, 0, 1, 0, 0, 1, 0, 1, 1]"
17575,1,1,2,0.508961054181624,"[1, 1, 1, 0, 1, 0, 1, 0, 1, 1]"
17576,1,1,2,0.4850670022482061,"[0, 1, 1, 1, 0, 1, 1, 1, 1, 0]"
17577,1,1,2,0.23645040888934477,"[1, 0, 1, 1, 1, 1, 0, 1, 1, 1]"
17578,1,1,2,0.6460727951083073,"[1, 1, 1, 1, 1, 0, 1, 1, 1, 0]"
17579,1,1,2,0.25117134569307764,"[0, 0, 1, 0, 0, 0, 1, 0, 0, 0]"
17580,2,2,4,0.4423289423790042,"[0, 1, 0, 0, 1, 1, 1, 1, 0, 1]"
17581,1,1,2,0.19480579257385033,"[1, 0, 0, 1, 0, 0, 1, 0, 1, 1]"
17582,1,1,2,0.21584619913006053,"[1, 1, 0, 1, 1, 0, 0, 0, 1, 0]"
17583,1,1,2,0.11134609107979831,"[0, 0, 0, 1, 0, 0, 1, 0, 0, 1]"
17584,1,1,2,0.3823665536448375,"[0, 1, 0, 1, 1, 0, 0, 1, 1, 1]"
17585,1,1,2,0.8731095617458712,"[0, 1, 0, 0, 1, 1, 1, 1, 1, 1]"
17586,1,1,2,0.7816252634397227,"[0, 1, 0, 0, 0, 0, 1, 1, 0, 1]"
17587,1,1,2,0.48079420602866074,"[0, 1, 1, 0, 1, 1, 1, 0, 0, 0]"
17588,1,1,2,0.3989772762204725,"[1, 0, 1, 0, 0, 1, 1, 0, 1, 0]"
17589,1,1,2,0.14308712860665396,"[1, 1, 1, 0, 1, 1, 0, 1, 1, 1]"
17590,1,1,2,0.030929949849044847,"[0, 0, 0, 1, 0, 0, 1, 0, 1, 0]"
17591,1,1,2,0.9771397558814962,"[0, 0, 0, 0, 0, 1, 1, 1, 0, 0]"
17592,1,1,2,0.024033461240326903,"[0, 0, 1, 1, 1, 0, 1, 0, 1, 1]"
17593,1,1,2,0.7608220524356863,"[0, 0, 1, 0, 0, 1, 0, 0, 0, 0]"
17594,1,1,2,0.3659849544455418,"[1, 0, 1, 1, 0, 0, 0, 1, 0, 1]"
17595,1,1,2,0.5398629734312016,"[1, 1, 0, 0, 0, 1, 0, 1, 0, 1]"
17596,1,1,2,0.3180978614477826,"[1, 1, 0, 1, 0, 1, 1, 0, 1, 0]"
17597,1,1,2,0.9507472754296564,"[0, 0, 0, 0, 1, 0, 0, 0, 1, 1]"
17598,1,1,2,0.5942823994645551,"[0, 0, 1, 1, 0, 0, 1, 0, 0, 0]"
17599,1,1,2,0.7020378308834716,"[1, 0, 0, 1, 0, 1, 1, 1, 0, 1]"
17600,1,1,2,0.3447410775228844,"[0, 1, 1, 0, 1, 0, 0, 0, 1, 0]"
17601,1,1,2,0.6938981249113408,"[1, 1, 1, 1, 0, 1, 1, 1, 0, 0]"
17602,1,1,2,0.24713560753447028,"[1, 1, 1, 1, 1, 1, 1, 0, 0, 0]"
17603,1,1,2,0.16870727998529633,"[0, 1, 1, 1, 1, 1, 1, 0, 1, 1]"
17604,1,1,2,0.57381050281011,"[1, 0, 1, 0, 0, 1, 1, 1, 0, 1]"
17605,2,2,4,0.06381446296572435,"[1, 1, 1, 1, 0, 0, 0, 1, 1, 0]"
17606,1,1,2,0.7724632947569016,"[1, 0, 0, 1, 0, 0, 1, 0, 0, 1]"
17607,1,1,2,0.6950231441742873,"[1, 1, 0, 1, 1, 0, 1, 1, 1, 1]"
17608,1,1,2,0.7195362484108176,"[0, 0, 1, 1, 0, 0, 1, 0, 1, 0]"
17609,1,1,2,0.23733210355593537,"[1, 1, 0, 1, 1, 1, 0, 1, 1, 1]"
17610,1,1,2,0.439981999971951,"[0, 1, 1, 1, 0, 0, 0, 0, 1, 0]"
17611,1,1,2,0.8241571300117437,"[0, 1, 1, 0, 1, 1, 0, 1, 1, 0]"
17612,1,1,2,0.06347832906704509,"[1, 1, 1, 0, 0, 1, 1, 1, 0, 1]"
17613,1,1,2,0.5960579046650339,"[1, 1, 0, 1, 1, 0, 1, 1, 0, 0]"
17614,1,1,2,0.6914330647040414,"[1, 1, 0, 1, 1, 0, 1, 0, 1, 0]"
17615,1,1,2,0.9449160989999144,"[1, 1, 0, 0, 0, 0, 0, 1, 0, 1]"
17616,1,1,2,0.08793613538040168,"[0, 1, 0, 1, 1, 1, 1, 0, 0, 0]"
17617,1,1,2,0.13930301107876508,"[0, 1, 1, 0, 0, 0, 0, 1, 0, 1]"
17618,1,1,2,0.16245105032310725,"[1, 0, 0, 1, 0, 0, 0, 0, 1, 0]"
17619,1,1,2,0.05616808044403154,"[1, 1, 1, 1, 0, 0, 0, 0, 1, 0]"
17620,2,2,4,0.45944877987979726,"[0, 1, 0, 0, 0, 1, 1, 1, 1, 1]"
17621,1,1,2,0.007135085749226944,"[0, 1, 1, 1, 1, 0, 1, 1, 0, 1]"
17622,1,1,2,0.4257150558126126,"[1, 0, 1, 0, 0, 1, 0, 1, 1, 0]"
17623,1,1,2,0.9289508882121322,"[1, 0, 0, 1, 1, 0, 1, 1, 1, 1]"
17624,1,1,2,0.0905581850569217,"[0, 0, 0, 0, 1, 0, 0, 0, 1, 1]"
17625,1,1,2,0.7008758974916937,"[0, 1, 1, 1, 0, 1, 0, 1, 0, 1]"
17626,1,1,2,0.3969150059768686,"[0, 0, 0, 0, 0, 1, 0, 0, 1, 0]"
17627,1,1,2,0.5703582214420765,"[1, 1, 0, 0, 1, 1, 1, 1, 0, 1]"
17628,1,1,2,0.4826570872836333,"[1, 0, 1, 1, 1, 0, 0, 0, 1, 0]"
17629,1,1,2,0.9657712038092734,"[0, 0, 0, 0, 0, 1, 0, 0, 0, 0]"
17630,2,2,4,0.6316802094293952,"[1, 0, 0, 1, 0, 1, 1, 0, 0, 0]"
17631,1,1,2,0.7051542194279609,"[1, 1, 0, 1, 0, 1, 0, 1, 1, 1]"
17632,3,3,6,0.3800468997701951,"[1, 0, 1, 1, 1, 1, 1, 1, 1, 1]"
17633,1,1,2,0.11522394732001717,"[1, 0, 1, 1, 1, 0, 0, 0, 1, 1]"
17634,1,1,2,0.23272564853890398,"[1, 1, 1, 1, 0, 1, 0, 0, 1, 1]"
17635,1,1,2,0.9538196936204427,"[1, 0, 0, 0, 0, 1, 1, 1, 1, 1]"
17636,2,2,4,0.24790459060097958,"[1, 1, 0, 0, 0, 1, 0, 1, 1, 1]"
17637,1,1,2,0.6563628747904401,"[1, 0, 0, 1, 1, 1, 0, 1, 0, 0]"
17638,1,1,2,0.8329928663756941,"[0, 0, 0, 0, 1, 1, 1, 0, 1, 0]"
17639,1,1,2,0.22184678742893504,"[0, 0, 1, 1, 1, 1, 0, 1, 0, 1]"
17640,1,1,2,0.48472431239314173,"[0, 1, 0, 0, 1, 1, 1, 1, 0, 0]"
17641,1,1,2,0.05784100545778248,"[0, 0, 0, 1, 0, 0, 1, 1, 0, 1]"
17642,2,2,4,0.659899413533624,"[1, 0, 1, 1, 0, 1, 0, 0, 1, 0]"
17643,1,1,2,0.11342648411039402,"[0, 0, 0, 0, 0, 0, 1, 0, 0, 0]"
17644,1,1,2,0.17281128678581903,"[0, 1, 0, 1, 1, 0, 0, 0, 0, 0]"
17645,1,1,2,0.22422746818498063,"[1, 1, 0, 0, 0, 0, 0, 0, 0, 0]"
17646,2,2,4,0.7239901776044645,"[0, 0, 0, 0, 1, 1, 0, 0, 0, 0]"
17647,1,1,2,0.9665230831123357,"[0, 0, 0, 1, 1, 1, 1, 0, 0, 1]"
17648,1,1,2,0.6771183228161816,"[0, 1, 0, 0, 0, 1, 0, 0, 0, 1]"
17649,1,1,2,0.2084477768265518,"[0, 0, 0, 0, 1, 0, 0, 1, 1, 1]"
17650,1,1,2,0.11090083779992377,"[1, 1, 1, 0, 1, 1, 1, 1, 1, 1]"
17651,1,1,2,0.02951384144978275,"[0, 1, 0, 1, 1, 0, 1, 1, 1, 1]"
17652,1,1,2,0.18228153833734306,"[1, 0, 1, 0, 0, 0, 0, 0, 1, 1]"
17653,1,1,2,0.6919565055993581,"[0, 0, 0, 0, 1, 0, 0, 1, 1, 1]"
17654,1,1,2,0.9492267996804833,"[0, 0, 0, 0, 1, 1, 1, 1, 1, 1]"
17655,1,1,2,0.3771298145715002,"[1, 0, 0, 0, 0, 0, 1, 0, 1, 0]"
17656,1,1,2,0.14415647384394525,"[0, 1, 1, 1, 1, 0, 1, 1, 1, 0]"
17657,1,1,2,0.1617386841146966,"[0, 1, 0, 0, 1, 1, 1, 0, 0, 1]"
17658,1,1,2,0.8564813288911188,"[0, 1, 1, 1, 0, 1, 1, 0, 0, 1]"
17659,1,1,2,0.2364854809318725,"[1, 1, 0, 1, 1, 1, 1, 0, 0, 1]"
17660,2,2,4,0.5976187794798031,"[1, 0, 1, 1, 0, 0, 0, 1, 1, 0]"
17661,1,1,2,0.08063631016946371,"[0, 0, 0, 1, 1, 1, 0, 1, 0, 0]"
17662,1,1,2,0.8957390126993301,"[1, 0, 1, 1, 0, 0, 0, 0, 1, 1]"
17663,1,1,2,0.09355124569429785,"[0, 1, 1, 1, 1, 1, 0, 1, 0, 0]"
17664,1,1,2,0.8178683028322522,"[0, 1, 0, 1, 1, 1, 1, 0, 1, 0]"
17665,1,1,2,0.1694307517823228,"[1, 1, 1, 0, 0, 1, 0, 1, 0, 0]"
17666,1,1,2,0.8321647584533158,"[1, 1, 1, 0, 1, 0, 0, 0, 1, 1]"
17667,1,1,2,0.756335417368361,"[1, 0, 1, 0, 0, 0, 1, 1, 1, 0]"
17668,1,1,2,0.2899781683198728,"[1, 0, 1, 1, 1, 0, 1, 1, 0, 1]"
17669,1,1,2,0.6831765102721231,"[1, 1, 1, 1, 1, 0, 0, 1, 1, 1]"
17670,1,1,2,0.2670705336608137,"[1, 0, 1, 1, 0, 1, 0, 0, 1, 0]"
17671,1,1,2,0.22028710379350136,"[0, 0, 1, 0, 0, 0, 1, 1, 0, 0]"
17672,1,1,2,0.2947592413850746,"[0, 1, 1, 1, 1, 1, 1, 1, 0, 1]"
17673,1,1,2,0.1128000271413313,"[1, 0, 1, 0, 0, 1, 0, 1, 0, 0]"
17674,1,1,2,0.7141801431040314,"[1, 0, 0, 1, 0, 0, 0, 0, 0, 0]"
17675,1,1,2,0.11610333328964106,"[0, 1, 1, 0, 1, 0, 0, 0, 1, 1]"
17676,1,1,2,0.19197030689586647,"[1, 1, 0, 0, 1, 1, 0, 1, 0, 0]"
17677,1,1,2,0.6733942940186136,"[0, 0, 0, 0, 1, 1, 1, 0, 1, 0]"
17678,1,1,2,0.3573173993275114,"[1, 0, 1, 1, 0, 0, 0, 0, 0, 1]"
17679,1,1,2,0.3701213493723913,"[1, 0, 0, 0, 1, 1, 0, 0, 1, 1]"
17680,1,1,2,0.16970442570312638,"[1, 0, 1, 0, 1, 0, 1, 0, 1, 1]"
17681,1,1,2,0.570494930398251,"[1, 1, 0, 0, 1, 1, 0, 1, 1, 1]"
17682,1,1,2,0.03324139546542648,"[0, 1, 1, 1, 0, 0, 1, 0, 1, 1]"
17683,1,1,2,0.5665859346066353,"[0, 0, 1, 1, 0, 1, 1, 1, 0, 1]"
17684,1,1,2,0.5174614761840494,"[0, 1, 0, 1, 0, 0, 0, 0, 0, 1]"
17685,1,1,2,0.6404043564923028,"[1, 1, 1, 1, 0, 1, 0, 0, 1, 1]"
17686,1,1,2,0.21786322431463068,"[1, 0, 1, 0, 0, 1, 0, 1, 0, 1]"
17687,1,1,2,0.3135786572331771,"[1, 0, 1, 1, 0, 0, 1, 1, 1, 1]"
17688,1,1,2,0.6655100015638609,"[1, 0, 1, 1, 0, 0, 0, 1, 0, 1]"
17689,1,1,2,0.4493654231887677,"[1, 1, 0, 1, 1, 1, 0, 1, 1, 1]"
17690,1,1,2,0.483281112451039,"[0, 0, 1, 1, 1, 1, 1, 0, 0, 1]"
17691,1,1,2,0.007562185208034644,"[1, 1, 0, 1, 0, 0, 1, 1, 0, 0]"
17692,1,1,2,0.03381678683643863,"[1, 1, 0, 1, 0, 0, 1, 1, 1, 0]"
17693,1,1,2,0.8616163143887209,"[1, 1, 1, 0, 1, 0, 1, 0, 1, 1]"
17694,1,1,2,0.03782785989352455,"[0, 1, 1, 1, 1, 0, 1, 0, 1, 0]"
17695,1,1,2,0.26049587802662666,"[0, 1, 1, 1, 1, 1, 1, 0, 1, 0]"
17696,1,1,2,0.08262848759758157,"[0, 0, 1, 0, 0, 1, 1, 0, 1, 1]"
17697,1,1,2,0.6158187212530063,"[0, 1, 1, 1, 0, 0, 1, 1, 0, 0]"
17698,1,1,2,0.6899908337158219,"[0, 1, 0, 1, 0, 0, 0, 0, 1, 0]"
17699,1,1,2,0.5549262160427696,"[1, 0, 1, 1, 1, 1, 0, 1, 0, 1]"
17700,1,1,2,0.7952669757240847,"[1, 0, 0, 1, 1, 1, 0, 1, 1, 1]"
17701,1,1,2,0.576601382776863,"[0, 0, 0, 0, 1, 1, 0, 1, 1, 0]"
17702,1,1,2,0.9095798160085371,"[0, 0, 1, 1, 0, 0, 0, 0, 0, 0]"
17703,2,2,4,0.01127644438650699,"[0, 1, 0, 1, 1, 1, 1, 1, 1, 1]"
17704,1,1,2,0.9944585537168923,"[0, 0, 1, 1, 0, 1, 0, 1, 0, 1]"
17705,1,1,2,0.6965336174668102,"[0, 1, 1, 0, 0, 1, 1, 1, 1, 1]"
17706,1,1,2,0.6400057364383948,"[0, 1, 1, 1, 1, 1, 1, 1, 0, 1]"
17707,1,1,2,0.6306545313448169,"[0, 0, 0, 0, 0, 0, 1, 0, 0, 0]"
17708,1,1,2,0.4242005402736452,"[0, 1, 0, 0, 1, 0, 1, 1, 0, 1]"
17709,1,1,2,0.4256891492715237,"[0, 0, 1, 0, 0, 1, 1, 1, 1, 0]"
17710,1,1,2,0.015945405268533053,"[1, 1, 1, 0, 0, 1, 0, 0, 0, 0]"
17711,1,1,2,0.3629011968238921,"[0, 0, 1, 1, 1, 0, 0, 0, 0, 1]"
17712,1,1,2,0.4364698520884658,"[0, 1, 0, 1, 1, 0, 0, 1, 0, 0]"
17713,1,1,2,0.3124059938771899,"[0, 0, 0, 0, 0, 1, 1, 0, 0, 0]"
17714,1,1,2,0.49976669307404487,"[1, 0, 1, 0, 0, 1, 0, 0, 1, 1]"
17715,1,1,2,0.8051403626370136,"[1, 0, 1, 1, 0, 1, 0, 0, 0, 1]"
17716,1,1,2,0.8993731907067107,"[0, 1, 1, 0, 1, 0, 1, 0, 1, 0]"
17717,1,1,2,0.8913783209029421,"[0, 1, 0, 1, 1, 0, 0, 1, 0, 0]"
17718,1,1,2,0.41031836887190143,"[1, 1, 1, 1, 0, 0, 1, 1, 1, 1]"
17719,1,1,2,0.07565017664110152,"[0, 0, 1, 0, 0, 1, 1, 0, 0, 1]"
17720,1,1,2,0.6541669586611677,"[0, 1, 1, 0, 0, 1, 0, 1, 0, 0]"
17721,1,1,2,0.4165864538321793,"[1, 1, 1, 0, 1, 0, 0, 0, 0, 1]"
17722,2,2,4,0.20050074787458594,"[0, 0, 1, 1, 0, 1, 0, 1, 1, 1]"
17723,1,1,2,0.4332878768752817,"[0, 1, 1, 1, 0, 1, 0, 0, 1, 1]"
17724,1,1,2,0.21495517031680733,"[1, 1, 1, 0, 1, 0, 1, 0, 0, 1]"
17725,1,1,2,0.3526618765797961,"[0, 1, 0, 0, 1, 1, 0, 0, 0, 0]"
17726,1,1,2,0.7236270550795283,"[0, 1, 1, 1, 0, 1, 1, 0, 1, 1]"
17727,1,1,2,0.47747537182017463,"[0, 1, 1, 0, 0, 0, 0, 0, 1, 1]"
17728,1,1,2,0.7487489407487095,"[0, 1, 1, 0, 0, 1, 0, 1, 0, 1]"
17729,1,1,2,0.19522636247028202,"[1, 1, 0, 1, 1, 1, 0, 1, 0, 1]"
17730,1,1,2,0.6897648649460918,"[0, 0, 1, 1, 1, 0, 1, 1, 0, 1]"
17731,1,1,2,0.22934172332221203,"[0, 0, 1, 1, 0, 1, 1, 1, 0, 0]"
17732,1,1,2,0.024310973664683266,"[1, 0, 0, 1, 1, 0, 0, 1, 1, 1]"
17733,1,1,2,0.6720066132985811,"[0, 0, 0, 0, 1, 1, 0, 0, 1, 1]"
17734,1,1,2,0.727306897129336,"[0, 0, 1, 1, 1, 0, 1, 0, 0, 1]"
17735,1,1,2,0.8023157294790814,"[1, 1, 1, 0, 1, 0, 0, 0, 0, 0]"
17736,1,1,2,0.31172665910035147,"[0, 0, 0, 0, 0, 0, 1, 1, 0, 0]"
17737,1,1,2,0.4069061505012398,"[1, 1, 1, 1, 0, 1, 0, 1, 1, 0]"
17738,1,1,2,0.03737234912958498,"[0, 0, 0, 0, 1, 1, 1, 1, 0, 0]"
17739,1,1,2,0.9164981176966691,"[0, 1, 0, 1, 1, 1, 1, 1, 1, 1]"
17740,1,1,2,0.1690769183414339,"[0, 0, 1, 0, 1, 1, 1, 0, 0, 1]"
17741,1,1,2,0.16614890886261424,"[1, 1, 1, 0, 0, 0, 1, 0, 1, 1]"
17742,1,1,2,0.9180539310075575,"[1, 0, 1, 1, 1, 1, 0, 1, 0, 0]"
17743,1,1,2,0.7677677595607098,"[1, 0, 0, 1, 0, 0, 1, 0, 1, 1]"
17744,1,1,2,0.8390235051661719,"[1, 1, 0, 1, 0, 1, 0, 1, 1, 0]"
17745,2,2,4,0.9248918148188573,"[0, 0, 0, 0, 1, 1, 0, 1, 1, 0]"
17746,1,1,2,0.30930889023687247,"[1, 0, 1, 0, 1, 1, 1, 0, 0, 0]"
17747,1,1,2,0.6857027302292357,"[0, 1, 1, 0, 1, 1, 1, 1, 0, 0]"
17748,1,1,2,0.5633214036339553,"[1, 1, 0, 0, 0, 0, 1, 1, 1, 1]"
17749,1,1,2,0.8127571702164437,"[0, 1, 0, 0, 0, 0, 1, 0, 1, 1]"
17750,1,1,2,0.21775091828837223,"[0, 1, 1, 0, 1, 1, 0, 0, 1, 0]"
17751,1,1,2,0.10599287402008728,"[1, 1, 0, 0, 1, 1, 0, 0, 0, 1]"
17752,1,1,2,0.382064558690589,"[0, 1, 1, 0, 1, 1, 0, 0, 0, 1]"
17753,1,1,2,0.8231463570030425,"[0, 0, 1, 0, 0, 1, 1, 0, 0, 0]"
17754,1,1,2,0.66044073468085,"[0, 0, 1, 1, 0, 1, 1, 0, 0, 1]"
17755,1,1,2,0.7832667441560631,"[0, 1, 1, 1, 1, 1, 1, 1, 0, 0]"
17756,1,1,2,0.23520788874313658,"[1, 1, 1, 1, 1, 0, 1, 1, 1, 0]"
17757,1,1,2,0.18435004619280104,"[1, 1, 0, 0, 1, 0, 0, 0, 0, 1]"
17758,1,1,2,0.5086171963401523,"[1, 1, 1, 1, 0, 1, 1, 0, 1, 1]"
17759,1,1,2,0.3792300634811039,"[0, 0, 1, 0, 0, 1, 1, 1, 1, 0]"
17760,1,1,2,0.5251073963632519,"[0, 0, 1, 0, 1, 0, 1, 1, 0, 0]"
17761,1,1,2,0.07302105408640436,"[0, 1, 0, 1, 1, 1, 0, 1, 1, 0]"
17762,2,2,4,0.38835004457382605,"[0, 0, 0, 1, 0, 0, 1, 1, 1, 0]"
17763,1,1,2,0.2216550841281062,"[1, 0, 1, 1, 1, 0, 1, 0, 1, 1]"
17764,1,1,2,0.7682989214432523,"[1, 1, 1, 1, 1, 0, 1, 1, 1, 0]"
17765,1,1,2,0.39709942259163733,"[0, 0, 0, 1, 1, 0, 1, 1, 1, 1]"
17766,1,1,2,0.04486376677460846,"[0, 1, 0, 0, 0, 1, 1, 0, 1, 0]"
17767,1,1,2,0.5016425944539683,"[0, 0, 0, 1, 1, 0, 1, 1, 0, 1]"
17768,1,1,2,0.563406511706102,"[1, 0, 1, 0, 1, 0, 1, 1, 1, 1]"
17769,1,1,2,0.9953745609771273,"[1, 0, 0, 1, 1, 1, 0, 1, 0, 1]"
17770,1,1,2,0.24899739809726984,"[1, 1, 1, 0, 0, 0, 1, 0, 1, 0]"
17771,1,1,2,0.10853977359222244,"[1, 1, 0, 1, 1, 0, 1, 1, 0, 0]"
17772,1,1,2,0.39647023106071055,"[1, 1, 1, 0, 0, 1, 0, 0, 0, 1]"
17773,1,1,2,0.23984495486640423,"[1, 0, 0, 0, 1, 1, 1, 1, 0, 1]"
17774,1,1,2,0.7487018622999151,"[1, 0, 0, 0, 0, 1, 1, 1, 0, 0]"
17775,1,1,2,0.5450038748395235,"[1, 0, 0, 1, 1, 0, 0, 0, 1, 1]"
17776,1,1,2,0.7344186680232798,"[0, 0, 0, 0, 0, 1, 0, 1, 0, 0]"
17777,2,2,4,0.7237973106475822,"[0, 0, 1, 1, 1, 1, 1, 0, 1, 0]"
17778,1,1,2,0.2063686495735847,"[1, 1, 0, 1, 1, 1, 0, 1, 0, 1]"
17779,1,1,2,0.6260692296045407,"[0, 1, 1, 1, 1, 0, 1, 1, 1, 0]"
17780,1,1,2,0.9745992399414647,"[1, 1, 0, 1, 0, 0, 1, 1, 1, 0]"
17781,1,1,2,0.9454180963380774,"[0, 0, 0, 0, 1, 0, 0, 0, 1, 0]"
17782,1,1,2,0.0572960084260451,"[0, 1, 1, 1, 1, 1, 1, 1, 0, 0]"
17783,1,1,2,0.5836585105887241,"[1, 1, 0, 0, 1, 0, 0, 0, 0, 1]"
17784,1,1,2,0.8122063077992551,"[0, 0, 1, 0, 0, 1, 1, 1, 0, 1]"
17785,1,1,2,0.3427991273395442,"[0, 1, 0, 0, 0, 0, 1, 1, 0, 0]"
17786,1,1,2,0.3717519369926854,"[0, 0, 1, 1, 1, 1, 0, 1, 0, 1]"
17787,1,1,2,0.4280683882828068,"[0, 0, 0, 1, 0, 0, 0, 1, 1, 0]"
17788,1,1,2,0.8412658105741527,"[1, 0, 0, 0, 0, 1, 1, 0, 0, 1]"
17789,1,1,2,0.48185088530898557,"[0, 1, 0, 0, 0, 0, 1, 1, 1, 0]"
17790,1,1,2,0.836403312408391,"[0, 0, 0, 0, 0, 1, 1, 1, 0, 0]"
17791,1,1,2,0.027409848103294276,"[0, 1, 0, 1, 0, 1, 0, 1, 1, 0]"
17792,1,1,2,0.9662820904846979,"[1, 1, 0, 1, 0, 1, 1, 0, 0, 0]"
17793,1,1,2,0.9667314649457643,"[0, 0, 0, 0, 0, 1, 1, 0, 1, 0]"
17794,1,1,2,0.06148834551121429,"[1, 1, 1, 0, 1, 0, 0, 0, 0, 0]"
17795,1,1,2,0.7196306677633002,"[0, 0, 0, 0, 1, 1, 0, 0, 0, 1]"
17796,1,1,2,0.24547894265212988,"[1, 0, 0, 1, 1, 0, 1, 0, 1, 1]"
17797,1,1,2,0.2665944130503046,"[1, 1, 1, 1, 0, 0, 1, 0, 1, 1]"
17798,1,1,2,0.792471260833052,"[1, 0, 1, 0, 0, 1, 1, 0, 1, 0]"
17799,1,1,2,0.4626725050147934,"[0, 1, 1, 0, 1, 0, 0, 0, 0, 0]"
17800,1,1,2,0.9258030102610291,"[0, 0, 0, 0, 1, 1, 1, 0, 0, 1]"
17801,1,1,2,0.5225859356289463,"[0, 0, 0, 0, 1, 1, 1, 1, 1, 1]"
17802,1,1,2,0.8492900304551622,"[1, 1, 0, 0, 0, 0, 1, 1, 0, 0]"
17803,1,1,2,0.1540430754515162,"[0, 1, 0, 1, 1, 0, 1, 0, 0, 1]"
17804,1,1,2,0.6382055678124712,"[0, 1, 1, 1, 0, 1, 1, 1, 1, 1]"
17805,1,1,2,0.292123068895242,"[1, 0, 0, 1, 0, 1, 0, 0, 1, 0]"
17806,1,1,2,0.10039735309226461,"[0, 0, 0, 0, 1, 0, 0, 0, 0, 0]"
17807,1,1,2,0.6996058415250247,"[1, 1, 0, 0, 1, 0, 0, 0, 1, 0]"
17808,1,1,2,0.6317551420913635,"[0, 0, 1, 0, 0, 0, 0, 1, 1, 1]"
17809,1,1,2,0.7778227921904556,"[0, 1, 0, 1, 0, 1, 0, 1, 0, 1]"
17810,1,1,2,0.5494116546954959,"[0, 0, 1, 1, 1, 1, 1, 1, 1, 0]"
17811,1,1,2,0.24402097186175853,"[1, 1, 1, 1, 1, 1, 0, 0, 0, 0]"
17812,1,1,2,0.18366532586926831,"[0, 0, 0, 0, 0, 1, 1, 1, 1, 0]"
17813,1,1,2,0.19814636960377852,"[0, 0, 1, 0, 0, 1, 1, 0, 1, 1]"
17814,1,1,2,0.7404236391713859,"[1, 1, 0, 1, 1, 1, 0, 0, 1, 0]"
17815,1,1,2,0.0475457437154545,"[0, 1, 1, 0, 0, 1, 1, 1, 1, 0]"
17816,1,1,2,0.12118628982419755,"[0, 0, 0, 1, 1, 0, 0, 0, 1, 1]"
17817,1,1,2,0.05905077260621572,"[1, 0, 0, 0, 0, 0, 1, 1, 1, 1]"
17818,1,1,2,0.3370345911052355,"[1, 0, 0, 1, 1, 1, 0, 1, 0, 1]"
17819,1,1,2,0.18987112222531322,"[1, 1, 0, 0, 0, 1, 1, 1, 1, 0]"
17820,1,1,2,0.2556979634464662,"[1, 1, 0, 0, 1, 1, 0, 1, 0, 1]"
17821,1,1,2,0.2833154444372018,"[1, 1, 0, 1, 0, 1, 0, 1, 1, 0]"
17822,1,1,2,0.4793110214462083,"[1, 1, 0, 1, 0, 0, 1, 0, 0, 0]"
17823,1,1,2,0.08537371446979869,"[1, 1, 1, 1, 0, 0, 1, 1, 1, 0]"
17824,1,1,2,0.24680112580562685,"[1, 0, 1, 0, 0, 0, 0, 1, 0, 0]"
17825,1,1,2,0.15828244837576622,"[0, 0, 1, 0, 1, 0, 0, 0, 0, 1]"
17826,1,1,2,0.48747221617476466,"[1, 1, 0, 0, 1, 0, 0, 1, 1, 0]"
17827,1,1,2,0.43864844336479925,"[0, 1, 0, 0, 0, 0, 0, 1, 1, 0]"
17828,1,1,2,0.17863796117033093,"[1, 1, 0, 0, 0, 1, 0, 0, 1, 1]"
17829,1,1,2,0.28624765752618553,"[0, 0, 0, 0, 0, 1, 1, 0, 0, 0]"
17830,1,1,2,0.35416715757074524,"[0, 0, 0, 0, 0, 1, 1, 1, 1, 0]"
17831,1,1,2,0.5893637357874855,"[1, 0, 1, 0, 1, 1, 1, 1, 1, 1]"
17832,1,1,2,0.7086446280477275,"[1, 1, 0, 0, 0, 0, 1, 0, 0, 1]"
17833,1,1,2,0.5213797020637484,"[1, 1, 0, 1, 1, 1, 1, 1, 1, 1]"
17834,1,1,2,0.6552871797039221,"[0, 1, 0, 0, 1, 1, 0, 1, 1, 0]"
17835,1,1,2,0.493029602209217,"[1, 0, 0, 1, 0, 1, 0, 0, 1, 1]"
17836,1,1,2,0.15163734533973994,"[0, 0, 0, 0, 1, 1, 0, 0, 0, 0]"
17837,1,1,2,0.6659354551961439,"[0, 0, 0, 1, 0, 1, 1, 0, 0, 0]"
17838,1,1,2,0.8477688971138677,"[0, 0, 0, 0, 1, 1, 1, 1, 0, 0]"
17839,1,1,2,0.5623227145277242,"[0, 0, 1, 0, 1, 0, 1, 0, 0, 1]"
17840,1,1,2,0.9309783495248407,"[0, 1, 0, 1, 0, 1, 0, 0, 1, 0]"
17841,1,1,2,0.6354421119368253,"[1, 0, 1, 0, 0, 0, 1, 0, 0, 0]"
17842,1,1,2,0.5735132905798643,"[0, 0, 0, 0, 1, 0, 0, 1, 0, 0]"
17843,1,1,2,0.38066952609498383,"[1, 1, 0, 1, 1, 0, 0, 1, 0, 1]"
17844,1,1,2,0.9360573620910588,"[0, 0, 1, 0, 1, 0, 0, 1, 1, 0]"
17845,2,2,4,0.6952804859015397,"[0, 0, 1, 1, 1, 0, 1, 1, 1, 0]"
17846,1,1,2,0.6394858471114988,"[1, 1, 1, 1, 0, 0, 1, 0, 1, 0]"
17847,1,1,2,0.5820338633157159,"[1, 1, 1, 1, 1, 0, 1, 0, 1, 1]"
17848,1,1,2,0.31592077169627064,"[0, 1, 0, 1, 1, 0, 1, 1, 1, 1]"
17849,1,1,2,0.26525713031794595,"[1, 1, 1, 0, 1, 0, 1, 0, 1, 1]"
17850,1,1,2,0.9708266356454418,"[1, 1, 0, 0, 1, 1, 1, 1, 0, 1]"
17851,1,1,2,0.06848452545535111,"[1, 1, 1, 0, 0, 0, 0, 0, 0, 0]"
17852,1,1,2,0.37558062344596144,"[1, 1, 1, 1, 1, 1, 0, 0, 1, 1]"
17853,1,1,2,0.5743851158936607,"[0, 1, 0, 0, 0, 1, 1, 0, 0, 1]"
17854,1,1,2,0.8888835177332156,"[0, 1, 1, 1, 0, 0, 0, 1, 1, 0]"
17855,1,1,2,0.4847343856499853,"[1, 0, 0, 0, 1, 1, 0, 1, 0, 0]"
17856,1,1,2,0.4123782654867453,"[1, 0, 0, 1, 1, 1, 0, 1, 0, 1]"
17857,2,2,4,0.1336101579881136,"[1, 0, 1, 0, 0, 0, 1, 1, 0, 1]"
17858,2,2,4,0.832297299217364,"[1, 0, 0, 0, 0, 1, 0, 1, 1, 1]"
17859,1,1,2,0.2884224310914877,"[1, 1, 1, 1, 0, 1, 1, 0, 0, 1]"
17860,1,1,2,0.18172242729895938,"[1, 0, 0, 0, 0, 1, 1, 0, 0, 0]"
17861,1,1,2,0.2978094687123477,"[0, 0, 1, 1, 1, 1, 0, 0, 0, 0]"
17862,1,1,2,0.5759302882757383,"[1, 1, 1, 0, 1, 0, 1, 1, 1, 1]"
17863,1,1,2,0.038802647602175555,"[0, 1, 0, 1, 0, 1, 0, 1, 0, 0]"
17864,1,1,2,0.8727119405562417,"[0, 1, 1, 0, 1, 0, 0, 1, 1, 1]"
17865,1,1,2,0.7913551992443497,"[0, 1, 0, 1, 0, 1, 0, 1, 0, 1]"
17866,1,1,2,0.8469099982008262,"[1, 1, 1, 0, 0, 0, 1, 0, 0, 0]"
17867,1,1,2,0.27254509551888295,"[1, 0, 1, 0, 0, 0, 1, 1, 0, 0]"
17868,1,1,2,0.1640743299816687,"[1, 1, 1, 1, 0, 0, 1, 0, 1, 0]"
17869,1,1,2,0.5682105927679484,"[0, 1, 1, 1, 1, 1, 0, 0, 1, 0]"
17870,1,1,2,0.9607162010007068,"[1, 1, 1, 0, 0, 1, 1, 0, 1, 1]"
17871,1,1,2,0.5071265417546712,"[0, 1, 0, 1, 0, 0, 1, 0, 0, 0]"
17872,1,1,2,0.6359005814757639,"[0, 0, 1, 0, 1, 1, 0, 0, 1, 0]"
17873,1,1,2,0.3170325881922045,"[1, 1, 0, 0, 1, 0, 0, 1, 0, 0]"
17874,1,1,2,0.7237227421687382,"[1, 1, 1, 1, 0, 0, 0, 1, 0, 1]"
17875,1,1,2,0.5579983086438858,"[0, 0, 1, 1, 0, 1, 0, 0, 1, 1]"
17876,1,1,2,0.33167029566245687,"[1, 1, 1, 1, 0, 1, 1, 1, 0, 1]"
17877,1,1,2,0.050817453980985694,"[1, 1, 0, 1, 0, 0, 0, 1, 1, 0]"
17878,1,1,2,0.4661521372001973,"[0, 1, 0, 1, 1, 0, 1, 0, 1, 0]"
17879,1,1,2,0.23423574146527826,"[0, 0, 0, 0, 0, 1, 1, 0, 1, 0]"
17880,1,1,2,0.8866927332894529,"[1, 1, 1, 1, 0, 0, 1, 0, 1, 1]"
17881,1,1,2,0.9017600198302743,"[0, 0, 1, 1, 1, 1, 1, 1, 1, 1]"
17882,1,1,2,0.1206732788465199,"[1, 1, 1, 0, 1, 1, 1, 1, 0, 1]"
17883,1,1,2,0.5670869090859688,"[1, 0, 0, 0, 1, 0, 1, 0, 1, 0]"
17884,1,1,2,0.8000636341683949,"[0, 0, 1, 0, 1, 0, 0, 0, 0, 0]"
17885,1,1,2,0.25310833060060856,"[0, 1, 1, 0, 1, 0, 0, 1, 0, 1]"
17886,1,1,2,0.09363424670456388,"[1, 0, 1, 0, 0, 0, 0, 0, 1, 1]"
17887,1,1,2,0.5905681228248042,"[0, 0, 1, 1, 1, 0, 0, 1, 1, 0]"
17888,1,1,2,0.4661308752527945,"[1, 1, 0, 0, 1, 0, 0, 0, 0, 1]"
17889,1,1,2,0.9637022664134496,"[1, 0, 1, 0, 0, 0, 0, 0, 0, 1]"
17890,1,1,2,0.05139746683877788,"[0, 0, 0, 0, 1, 0, 0, 0, 1, 0]"
17891,1,1,2,0.6646948294065477,"[0, 1, 1, 0, 1, 1, 1, 1, 0, 0]"
17892,1,1,2,0.3615553534358399,"[1, 0, 0, 0, 1, 0, 1, 0, 0, 1]"
17893,1,1,2,0.4391223584857742,"[0, 1, 1, 1, 0, 1, 0, 1, 0, 1]"
17894,1,1,2,0.3257018628331739,"[1, 1, 0, 1, 1, 0, 1, 1, 1, 1]"
17895,1,1,2,0.0002925501783034301,"[1, 0, 1, 1, 1, 1, 1, 1, 1, 1]"
17896,1,1,2,0.9741222821741877,"[1, 1, 1, 0, 0, 0, 1, 1, 1, 1]"
17897,1,1,2,0.17254569664520292,"[0, 1, 0, 1, 1, 1, 1, 1, 0, 0]"
17898,1,1,2,0.23185821135784435,"[1, 1, 0, 1, 0, 1, 0, 1, 1, 1]"
17899,1,1,2,0.4757959729725021,"[1, 1, 1, 1, 0, 0, 1, 0, 0, 1]"
17900,2,2,4,0.9525848223967963,"[0, 0, 0, 0, 1, 0, 1, 0, 0, 0]"
17901,1,1,2,0.8370005946005016,"[1, 1, 0, 1, 1, 0, 1, 1, 0, 0]"
17902,1,1,2,0.5553624563845302,"[0, 1, 1, 1, 0, 1, 1, 0, 1, 0]"
17903,1,1,2,0.3969221102249718,"[0, 0, 1, 0, 1, 1, 1, 0, 0, 1]"
17904,1,1,2,0.659258690251279,"[1, 0, 1, 1, 1, 1, 0, 1, 1, 0]"
17905,1,1,2,0.1903219969372687,"[1, 0, 0, 0, 1, 0, 0, 0, 0, 1]"
17906,1,1,2,0.49040460727047064,"[0, 0, 1, 1, 0, 0, 0, 1, 1, 1]"
17907,1,1,2,0.7639717036406578,"[0, 0, 1, 1, 0, 0, 1, 1, 1, 1]"
17908,1,1,2,0.3116363810881826,"[0, 1, 1, 0, 0, 0, 0, 1, 0, 0]"
17909,1,1,2,0.9841933425416807,"[0, 0, 0, 0, 1, 0, 1, 0, 0, 1]"
17910,1,1,2,0.7634487933515974,"[1, 1, 0, 0, 1, 0, 0, 1, 0, 1]"
17911,1,1,2,0.5488293913436924,"[0, 1, 0, 1, 1, 0, 0, 0, 0, 1]"
17912,1,1,2,0.879318157018794,"[1, 0, 0, 1, 1, 0, 1, 1, 1, 1]"
17913,1,1,2,0.8238298468455133,"[0, 0, 0, 0, 1, 1, 1, 1, 1, 0]"
17914,1,1,2,0.020829272168764068,"[0, 1, 1, 0, 1, 0, 1, 1, 1, 1]"
17915,1,1,2,0.3662100091647874,"[1, 0, 0, 1, 0, 1, 1, 0, 0, 0]"
17916,1,1,2,0.5535924484801044,"[1, 0, 0, 1, 1, 1, 0, 0, 0, 0]"
17917,1,1,2,0.6478858982728288,"[0, 0, 1, 1, 1, 0, 1, 1, 1, 0]"
17918,1,1,2,0.049028269324851714,"[1, 0, 0, 0, 0, 0, 0, 0, 1, 1]"
17919,2,2,4,0.21847722239617495,"[1, 1, 1, 1, 1, 1, 0, 0, 1, 1]"
17920,1,1,2,0.6393984239288869,"[1, 1, 1, 1, 1, 1, 0, 0, 0, 1]"
17921,1,1,2,0.33780304961228524,"[1, 0, 1, 0, 0, 0, 1, 0, 1, 0]"
17922,1,1,2,0.2702848722175518,"[0, 0, 0, 0, 0, 1, 1, 0, 1, 1]"
17923,1,1,2,0.8715999668377105,"[1, 1, 1, 0, 1, 0, 1, 1, 1, 0]"
17924,1,1,2,0.3440623711845747,"[1, 0, 0, 0, 0, 0, 1, 1, 0, 1]"
17925,1,1,2,0.9285797328805997,"[1, 0, 1, 1, 0, 1, 0, 1, 0, 0]"
17926,1,1,2,0.9755162880007613,"[0, 0, 1, 1, 1, 1, 0, 1, 0, 0]"
17927,1,1,2,0.9336330632407789,"[1, 0, 0, 0, 0, 1, 1, 1, 1, 1]"
17928,1,1,2,0.1259044906553155,"[0, 0, 0, 0, 0, 0, 0, 0, 1, 0]"
17929,1,1,2,0.6664476670055899,"[0, 1, 0, 1, 1, 1, 1, 1, 0, 1]"
17930,1,1,2,0.39081402453577974,"[1, 1, 1, 0, 1, 1, 1, 0, 1, 1]"
17931,1,1,2,0.06892800306002067,"[0, 1, 0, 1, 1, 0, 1, 1, 1, 1]"
17932,1,1,2,0.10260868862398365,"[1, 0, 1, 0, 1, 1, 1, 1, 0, 0]"
17933,1,1,2,0.3163178859459599,"[1, 1, 0, 0, 0, 1, 1, 0, 0, 0]"
17934,1,1,2,0.687445708462703,"[0, 1, 1, 1, 1, 0, 0, 0, 0, 1]"
17935,1,1,2,0.7485811809802431,"[0, 1, 1, 0, 0, 0, 0, 0, 0, 1]"
17936,1,1,2,0.4314866467286651,"[0, 0, 1, 1, 1, 1, 1, 1, 0, 0]"
17937,1,1,2,0.3036906319140734,"[1, 1, 1, 1, 0, 0, 1, 1, 1, 0]"
17938,1,1,2,0.737390495546253,"[0, 0, 0, 1, 0, 1, 1, 0, 1, 0]"
17939,2,2,4,0.8448440861806263,"[1, 0, 0, 0, 1, 1, 0, 0, 0, 0]"
17940,1,1,2,0.9682338763378979,"[1, 1, 1, 0, 0, 0, 1, 0, 1, 0]"
17941,2,2,4,0.05989106965866131,"[0, 0, 1, 1, 1, 0, 0, 0, 0, 1]"
17942,1,1,2,0.23873097131793442,"[1, 0, 0, 0, 1, 1, 0, 0, 1, 0]"
17943,1,1,2,0.048123936842825454,"[1, 1, 1, 0, 0, 0, 0, 1, 1, 0]"
17944,1,1,2,0.08327862903680672,"[0, 0, 0, 1, 1, 0, 0, 0, 0, 1]"
17945,1,1,2,0.26041248084282986,"[1, 0, 1, 1, 1, 1, 1, 1, 1, 1]"
17946,1,1,2,0.1795934765387328,"[0, 0, 0, 0, 1, 0, 0, 1, 0, 1]"
17947,1,1,2,0.4425318180835772,"[0, 0, 1, 0, 1, 1, 0, 0, 0, 0]"
17948,1,1,2,0.9471623207520309,"[0, 1, 1, 0, 0, 1, 1, 1, 0, 1]"
17949,1,1,2,0.899309326593486,"[1, 0, 0, 0, 0, 0, 1, 0, 0, 1]"
17950,1,1,2,0.5017907238075245,"[1, 1, 0, 0, 0, 0, 0, 0, 0, 1]"
17951,1,1,2,0.2614297527706131,"[1, 0, 1, 0, 0, 0, 1, 1, 1, 0]"
17952,2,2,4,0.4680740439864699,"[1, 1, 1, 0, 1, 1, 0, 1, 0, 0]"
17953,1,1,2,0.5807222968251327,"[1, 0, 0, 1, 0, 0, 0, 0, 0, 0]"
17954,1,1,2,0.3924802184698235,"[0, 0, 1, 1, 1, 1, 0, 1, 1, 1]"
17955,1,1,2,0.6334460288240567,"[0, 1, 1, 0, 1, 1, 0, 0, 1, 0]"
17956,1,1,2,0.8134385224910626,"[0, 0, 1, 0, 1, 1, 1, 1, 1, 0]"
17957,1,1,2,0.5533900679121075,"[0, 0, 0, 0, 0, 1, 1, 0, 1, 1]"
17958,2,2,4,0.4928175834220382,"[1, 1, 1, 0, 0, 0, 1, 0, 0, 0]"
17959,1,1,2,0.6107501891608007,"[0, 0, 0, 1, 0, 0, 1, 0, 1, 1]"
17960,1,1,2,0.40157392602951536,"[0, 0, 0, 0, 1, 0, 0, 0, 0, 1]"
17961,1,1,2,0.22938095300125494,"[1, 1, 0, 0, 0, 0, 1, 1, 1, 0]"
17962,1,1,2,0.0297067167568007,"[1, 0, 1, 1, 1, 0, 0, 0, 0, 0]"
17963,1,1,2,0.08687364946269693,"[1, 1, 1, 1, 0, 1, 1, 0, 1, 1]"
17964,1,1,2,0.8483581917769121,"[0, 1, 1, 1, 0, 1, 1, 1, 1, 1]"
17965,1,1,2,0.6798002852032391,"[0, 0, 1, 1, 0, 1, 0, 1, 1, 0]"
17966,1,1,2,0.22001457792093748,"[1, 0, 0, 0, 0, 1, 1, 1, 0, 1]"
17967,1,1,2,0.25544250426421966,"[1, 0, 0, 0, 0, 0, 1, 0, 0, 0]"
17968,1,1,2,0.7568846409538598,"[0, 1, 1, 1, 0, 0, 1, 1, 1, 0]"
17969,1,1,2,0.8690359983370315,"[0, 0, 0, 1, 0, 0, 1, 0, 0, 0]"
17970,1,1,2,0.3645368845266487,"[1, 0, 1, 1, 0, 1, 0, 1, 0, 1]"
17971,1,1,2,0.38142529582913554,"[0, 1, 1, 0, 0, 0, 0, 1, 1, 1]"
17972,1,1,2,0.7930495419318158,"[0, 1, 1, 0, 0, 1, 0, 1, 0, 1]"
17973,1,1,2,0.29308658022568357,"[1, 0, 1, 0, 0, 1, 0, 1, 0, 0]"
17974,1,1,2,0.8775374486673388,"[0, 0, 0, 1, 1, 1, 1, 1, 0, 0]"
17975,1,1,2,0.24966106587568204,"[0, 0, 0, 0, 0, 0, 0, 0, 1, 1]"
17976,1,1,2,0.9668688401109644,"[0, 0, 0, 1, 0, 0, 1, 1, 0, 1]"
17977,1,1,2,0.5404174414195498,"[0, 1, 1, 1, 1, 0, 1, 0, 0, 1]"
17978,1,1,2,0.9636549764140236,"[1, 0, 0, 1, 0, 0, 1, 0, 0, 0]"
17979,1,1,2,0.6138524416478682,"[1, 0, 1, 0, 1, 1, 1, 1, 0, 0]"
17980,2,2,4,0.547781300083059,"[1, 0, 1, 1, 1, 0, 0, 1, 1, 0]"
17981,1,1,2,0.41685662113647615,"[1, 0, 0, 0, 0, 0, 1, 0, 1, 1]"
17982,1,1,2,0.40346257312618783,"[1, 0, 1, 0, 0, 0, 0, 1, 0, 0]"
17983,1,1,2,0.7468966964357975,"[0, 1, 0, 0, 1, 1, 0, 0, 0, 1]"
17984,1,1,2,0.5105063042242038,"[1, 1, 0, 1, 0, 1, 1, 1, 1, 0]"
17985,2,2,4,0.7888118763448818,"[0, 0, 1, 1, 1, 1, 0, 0, 1, 1]"
17986,1,1,2,0.7737499309467731,"[1, 1, 1, 1, 0, 0, 0, 0, 0, 0]"
17987,1,1,2,0.7538090153084728,"[1, 0, 1, 1, 0, 0, 1, 1, 1, 1]"
17988,1,1,2,0.16826533061206717,"[1, 1, 0, 0, 0, 1, 0, 0, 1, 1]"
17989,1,1,2,0.7067337015983305,"[0, 0, 0, 1, 0, 1, 0, 0, 1, 0]"
17990,1,1,2,0.8097002940420548,"[0, 0, 1, 0, 0, 1, 0, 1, 1, 1]"
17991,1,1,2,0.6779634936750236,"[0, 1, 1, 0, 0, 0, 0, 0, 0, 1]"
17992,1,1,2,0.773341764385158,"[0, 1, 0, 0, 1, 1, 0, 1, 0, 1]"
17993,1,1,2,0.2975934002087226,"[1, 1, 0, 0, 0, 1, 0, 1, 0, 0]"
17994,1,1,2,0.9469313955815861,"[1, 1, 0, 1, 0, 1, 0, 1, 0, 1]"
17995,1,1,2,0.30946035222952684,"[1, 1, 1, 0, 0, 0, 0, 1, 0, 1]"
17996,1,1,2,0.5943792166636769,"[1, 1, 0, 1, 0, 0, 0, 1, 0, 1]"
17997,1,1,2,0.5717672297659611,"[1, 1, 1, 0, 1, 1, 1, 0, 1, 1]"
17998,1,1,2,0.675853279761689,"[0, 1, 0, 1, 0, 0, 1, 1, 1, 0]"
17999,1,1,2,0.4997116464685064,"[0, 1, 0, 0, 0, 0, 1, 1, 0, 1]"
18000,2,2,4,0.0866548310520554,"[0, 1, 1, 0, 1, 1, 1, 0, 1, 0]"
18001,1,1,2,0.04972565075656199,"[0, 1, 1, 1, 1, 1, 0, 0, 1, 0]"
18002,1,1,2,0.019805391176128673,"[1, 0, 1, 1, 1, 0, 0, 1, 1, 0]"
18003,1,1,2,0.6218885415302786,"[0, 1, 1, 0, 0, 1, 0, 1, 1, 1]"
18004,1,1,2,0.392578709755111,"[0, 0, 0, 0, 0, 0, 0, 0, 1, 1]"
18005,1,1,2,0.9241800459606614,"[0, 0, 0, 1, 1, 0, 0, 0, 0, 0]"
18006,1,1,2,0.7374924564238534,"[0, 1, 1, 0, 1, 1, 1, 0, 1, 1]"
18007,1,1,2,0.9756139644162368,"[1, 1, 1, 1, 0, 0, 1, 1, 0, 1]"
18008,1,1,2,0.5887924754180599,"[0, 0, 1, 1, 1, 0, 1, 1, 1, 0]"
18009,1,1,2,0.7513259298264235,"[1, 0, 1, 0, 0, 1, 0, 0, 0, 1]"
18010,1,1,2,0.8520618635104352,"[0, 1, 0, 0, 0, 0, 0, 1, 1, 1]"
18011,1,1,2,0.23800455843838808,"[0, 1, 1, 0, 1, 1, 1, 0, 1, 1]"
18012,1,1,2,0.8670678959429057,"[0, 1, 0, 0, 1, 0, 0, 0, 0, 0]"
18013,1,1,2,0.9047056883329779,"[1, 1, 0, 0, 1, 1, 1, 0, 1, 1]"
18014,1,1,2,0.40424790277158196,"[0, 1, 1, 1, 1, 0, 1, 1, 1, 1]"
18015,1,1,2,0.22682722120486765,"[0, 0, 0, 0, 0, 1, 1, 1, 0, 0]"
18016,1,1,2,0.4935382538015882,"[0, 1, 0, 0, 0, 0, 0, 0, 1, 1]"
18017,1,1,2,0.6046477510926858,"[1, 1, 1, 0, 1, 1, 1, 1, 0, 0]"
18018,1,1,2,0.4012565011269916,"[0, 1, 1, 0, 1, 0, 0, 0, 0, 0]"
18019,1,1,2,0.8491949471516513,"[1, 0, 1, 1, 0, 1, 0, 0, 0, 1]"
18020,1,1,2,0.2080629747161341,"[1, 1, 1, 1, 1, 0, 0, 1, 1, 1]"
18021,1,1,2,0.9509781669663792,"[1, 0, 0, 1, 1, 1, 0, 1, 1, 1]"
18022,1,1,2,0.013651498205379031,"[1, 0, 0, 1, 1, 0, 1, 1, 0, 1]"
18023,1,1,2,0.048201686451481485,"[1, 0, 1, 1, 0, 1, 0, 0, 1, 1]"
18024,2,2,4,0.15221982588649907,"[0, 0, 1, 0, 0, 0, 0, 1, 1, 0]"
18025,1,1,2,0.9477680063331461,"[1, 0, 1, 0, 0, 0, 0, 0, 0, 1]"
18026,1,1,2,0.1895030055889847,"[0, 1, 1, 0, 0, 1, 1, 0, 1, 1]"
18027,1,1,2,0.8107805169635461,"[1, 1, 0, 0, 0, 1, 0, 1, 0, 0]"
18028,1,1,2,0.11388307602069792,"[0, 1, 0, 1, 0, 1, 0, 1, 1, 0]"
18029,1,1,2,0.616169586306056,"[0, 1, 0, 0, 1, 1, 0, 0, 0, 0]"
18030,1,1,2,0.6678937504459546,"[1, 0, 1, 1, 0, 0, 0, 1, 0, 1]"
18031,1,1,2,0.5633683733698465,"[1, 0, 1, 1, 0, 1, 0, 0, 0, 0]"
18032,1,1,2,0.33567512880754624,"[0, 0, 1, 1, 0, 0, 1, 0, 1, 1]"
18033,1,1,2,0.9642432079558285,"[0, 1, 1, 1, 1, 0, 0, 1, 0, 1]"
18034,1,1,2,0.07713985071506202,"[1, 1, 1, 1, 1, 1, 0, 1, 1, 1]"
18035,1,1,2,0.7798980514306638,"[0, 0, 0, 0, 0, 1, 0, 0, 0, 0]"
18036,1,1,2,0.4642377630355624,"[1, 1, 0, 1, 0, 0, 0, 0, 1, 1]"
18037,1,1,2,0.8514940908231311,"[1, 1, 1, 1, 0, 1, 1, 0, 0, 1]"
18038,1,1,2,0.38640322746462363,"[0, 0, 0, 1, 0, 1, 0, 1, 1, 0]"
18039,1,1,2,0.9307468801021435,"[1, 0, 1, 1, 1, 0, 1, 1, 0, 0]"
18040,1,1,2,0.2753051821466225,"[0, 0, 0, 1, 1, 0, 0, 1, 0, 0]"
18041,1,1,2,0.13317966761533973,"[0, 0, 0, 1, 0, 0, 1, 0, 1, 1]"
18042,1,1,2,0.5044994387503687,"[1, 0, 1, 0, 0, 0, 0, 0, 0, 1]"
18043,1,1,2,0.1777149453740463,"[0, 1, 1, 1, 1, 0, 0, 1, 0, 1]"
18044,1,1,2,0.4911221917172137,"[0, 1, 1, 1, 0, 0, 0, 1, 1, 0]"
18045,1,1,2,0.7998670942878661,"[1, 0, 0, 0, 1, 0, 0, 1, 0, 0]"
18046,1,1,2,0.946128625112198,"[1, 1, 1, 0, 1, 0, 0, 1, 0, 0]"
18047,1,1,2,0.08621392752401547,"[1, 0, 0, 1, 0, 1, 0, 0, 1, 1]"
18048,1,1,2,0.2240282472380356,"[1, 0, 0, 1, 0, 1, 0, 1, 1, 1]"
18049,1,1,2,0.971201884114042,"[1, 1, 0, 1, 0, 0, 0, 0, 1, 1]"
18050,1,1,2,0.11185174235029383,"[0, 1, 1, 0, 1, 1, 0, 1, 1, 0]"
18051,1,1,2,0.48816171688221777,"[0, 0, 1, 1, 1, 0, 1, 1, 0, 0]"
18052,1,1,2,0.3657621106871649,"[0, 1, 1, 0, 0, 1, 1, 1, 1, 0]"
18053,1,1,2,0.5217537890300166,"[0, 0, 1, 1, 0, 0, 1, 1, 0, 0]"
18054,1,1,2,0.6396024641866048,"[1, 0, 1, 1, 1, 1, 1, 0, 0, 0]"
18055,1,1,2,0.4465821547994072,"[1, 1, 1, 0, 0, 1, 1, 1, 0, 0]"
18056,1,1,2,0.6354977635193021,"[0, 0, 1, 0, 1, 1, 1, 0, 1, 1]"
18057,1,1,2,0.5839542416753513,"[0, 1, 1, 1, 1, 1, 0, 0, 0, 1]"
18058,1,1,2,0.9294709680117577,"[1, 1, 0, 1, 0, 0, 0, 0, 1, 1]"
18059,1,1,2,0.34388431164101596,"[0, 1, 1, 1, 0, 1, 1, 1, 0, 1]"
18060,1,1,2,0.9962263666731964,"[1, 1, 0, 1, 0, 1, 1, 1, 1, 1]"
18061,1,1,2,0.5232714821067158,"[0, 0, 1, 1, 0, 1, 0, 0, 1, 0]"
18062,1,1,2,0.7232781102209194,"[0, 0, 1, 0, 0, 1, 1, 1, 1, 0]"
18063,1,1,2,0.9052834985507086,"[0, 0, 0, 0, 0, 1, 0, 1, 1, 1]"
18064,1,1,2,0.8819613386348817,"[0, 0, 0, 1, 1, 1, 1, 1, 0, 0]"
18065,1,1,2,0.9688665094959523,"[1, 0, 1, 0, 1, 0, 0, 0, 0, 1]"
18066,1,1,2,0.5502123912943101,"[1, 1, 0, 1, 0, 0, 1, 1, 1, 0]"
18067,1,1,2,0.4068902660603031,"[0, 1, 1, 0, 0, 0, 0, 0, 0, 0]"
18068,1,1,2,0.587594436880609,"[0, 1, 1, 1, 0, 1, 1, 1, 1, 1]"
18069,1,1,2,0.8150904953724029,"[1, 1, 0, 0, 1, 0, 0, 0, 1, 1]"
18070,1,1,2,0.8664404926269825,"[0, 0, 0, 0, 0, 0, 0, 0, 0, 1]"
18071,1,1,2,0.15559676180812332,"[1, 0, 1, 1, 1, 0, 0, 1, 0, 1]"
18072,1,1,2,0.2577405380681791,"[0, 1, 1, 1, 0, 0, 0, 1, 0, 1]"
18073,1,1,2,0.7175051243333025,"[1, 0, 1, 0, 0, 1, 1, 0, 1, 0]"
18074,1,1,2,0.4773107273055386,"[0, 0, 1, 0, 1, 1, 1, 1, 0, 0]"
18075,1,1,2,0.5222190905386078,"[0, 0, 1, 1, 1, 0, 1, 1, 0, 0]"
18076,1,1,2,0.3548027892623663,"[1, 1, 0, 1, 1, 0, 0, 1, 1, 0]"
18077,1,1,2,0.16154318788972,"[0, 1, 1, 1, 1, 0, 1, 0, 0, 0]"
18078,1,1,2,0.018298714949960937,"[0, 0, 0, 1, 1, 0, 1, 1, 1, 0]"
18079,1,1,2,0.9604795542176878,"[0, 0, 0, 1, 0, 0, 0, 1, 0, 1]"
18080,1,1,2,0.7715170551704226,"[1, 0, 1, 0, 0, 0, 1, 1, 1, 0]"
18081,1,1,2,0.6212221664995243,"[1, 1, 1, 1, 0, 1, 1, 1, 1, 1]"
18082,1,1,2,0.5497076576691188,"[0, 0, 1, 1, 1, 0, 0, 1, 1, 1]"
18083,1,1,2,0.11579322088857369,"[0, 1, 0, 0, 1, 0, 1, 0, 0, 1]"
18084,1,1,2,0.6302739795558735,"[1, 0, 0, 1, 0, 0, 1, 0, 0, 0]"
18085,1,1,2,0.2068392813786435,"[1, 0, 1, 1, 0, 0, 0, 1, 1, 0]"
18086,1,1,2,0.5036350313429611,"[1, 0, 1, 0, 1, 0, 1, 0, 0, 1]"
18087,1,1,2,0.12594448318715745,"[1, 1, 1, 0, 1, 1, 1, 0, 1, 1]"
18088,1,1,2,0.5686320065050365,"[1, 1, 0, 0, 0, 1, 1, 1, 0, 0]"
18089,1,1,2,0.2403785342053163,"[1, 1, 1, 1, 1, 0, 0, 1, 1, 1]"
18090,1,1,2,0.8674810191905479,"[1, 1, 0, 1, 1, 1, 0, 1, 0, 1]"
18091,1,1,2,0.07735513696575058,"[1, 1, 1, 1, 0, 1, 1, 0, 0, 0]"
18092,1,1,2,0.44573847306055614,"[1, 0, 1, 0, 0, 1, 1, 0, 0, 0]"
18093,1,1,2,0.3524534914176688,"[1, 1, 0, 1, 0, 1, 0, 1, 1, 1]"
18094,1,1,2,0.5531764340144323,"[0, 1, 1, 1, 0, 1, 0, 0, 1, 1]"
18095,1,1,2,0.5017837083905773,"[0, 1, 1, 0, 1, 0, 1, 0, 0, 0]"
18096,1,1,2,0.4240703453783774,"[0, 0, 0, 0, 0, 0, 0, 1, 0, 1]"
18097,1,1,2,0.07171584186939328,"[0, 0, 1, 1, 0, 0, 0, 1, 0, 1]"
18098,1,1,2,0.2783592799103147,"[1, 0, 0, 1, 1, 1, 1, 0, 1, 0]"
18099,1,1,2,0.4562549178169528,"[1, 0, 0, 1, 0, 1, 1, 1, 0, 0]"
18100,1,1,2,0.4725850657480808,"[0, 1, 1, 0, 1, 0, 1, 0, 0, 0]"
18101,1,1,2,0.44473411606648205,"[0, 1, 0, 1, 1, 0, 1, 0, 1, 1]"
18102,1,1,2,0.7378936035172979,"[0, 1, 1, 1, 0, 0, 0, 1, 1, 1]"
18103,1,1,2,0.9765947849180646,"[1, 0, 0, 1, 0, 0, 1, 1, 1, 1]"
18104,1,1,2,0.6245535826203384,"[0, 0, 0, 1, 1, 0, 0, 1, 1, 0]"
18105,1,1,2,0.294184757209661,"[1, 1, 1, 1, 0, 0, 0, 1, 1, 1]"
18106,1,1,2,0.47712569474987243,"[0, 1, 1, 0, 1, 1, 1, 0, 0, 0]"
18107,2,2,4,0.6092341506974952,"[1, 0, 1, 1, 1, 0, 1, 1, 0, 0]"
18108,1,1,2,0.7265049243156735,"[0, 1, 1, 1, 0, 0, 1, 0, 0, 1]"
18109,1,1,2,0.059947391467403244,"[1, 1, 0, 0, 0, 1, 1, 1, 0, 0]"
18110,1,1,2,0.9967704150280093,"[1, 1, 0, 1, 0, 0, 1, 1, 1, 1]"
18111,1,1,2,0.9942024975572337,"[1, 1, 1, 1, 1, 1, 1, 0, 1, 0]"
18112,1,1,2,0.5094448487180331,"[1, 1, 1, 1, 1, 0, 1, 0, 1, 1]"
18113,1,1,2,0.6321969419910021,"[1, 0, 1, 1, 0, 1, 0, 1, 0, 1]"
18114,1,1,2,0.6462719254458493,"[0, 1, 0, 0, 1, 1, 0, 0, 1, 1]"
18115,1,1,2,0.5418203919705675,"[1, 1, 1, 0, 0, 1, 1, 1, 0, 0]"
18116,1,1,2,0.8930631746566465,"[1, 1, 1, 1, 1, 1, 1, 1, 1, 0]"
18117,1,1,2,0.6269164092154853,"[1, 1, 1, 1, 0, 1, 1, 0, 0, 0]"
18118,1,1,2,0.6957987776630479,"[1, 0, 1, 1, 0, 1, 1, 1, 0, 1]"
18119,1,1,2,0.17468027888601245,"[1, 0, 1, 1, 0, 0, 1, 1, 1, 1]"
18120,1,1,2,0.29922788510768106,"[0, 1, 0, 0, 1, 1, 0, 1, 1, 0]"
18121,1,1,2,0.47395787035478243,"[0, 0, 1, 1, 0, 0, 1, 0, 1, 1]"
18122,1,1,2,0.7150692418980558,"[1, 0, 0, 0, 0, 0, 0, 0, 0, 1]"
18123,1,1,2,0.6485936063306529,"[1, 1, 0, 0, 1, 1, 0, 0, 1, 0]"
18124,1,1,2,0.10150956931793431,"[0, 0, 0, 0, 1, 1, 1, 0, 1, 1]"
18125,1,1,2,0.2880478972187164,"[0, 1, 1, 0, 1, 1, 0, 1, 1, 1]"
18126,1,1,2,0.3302290215174658,"[1, 1, 0, 1, 0, 0, 0, 1, 1, 0]"
18127,1,1,2,0.08091133860160049,"[1, 0, 0, 1, 1, 0, 1, 0, 0, 0]"
18128,1,1,2,0.8720598115513574,"[0, 0, 1, 0, 1, 0, 1, 0, 1, 0]"
18129,1,1,2,0.9800621799640219,"[0, 1, 0, 1, 0, 0, 0, 1, 0, 0]"
18130,1,1,2,0.954877825603961,"[1, 0, 1, 0, 1, 1, 1, 1, 1, 0]"
18131,1,1,2,0.20064866075954646,"[0, 0, 1, 0, 1, 0, 0, 0, 0, 1]"
18132,1,1,2,0.40432985513084296,"[1, 1, 0, 0, 1, 1, 1, 0, 1, 0]"
18133,2,2,4,0.1798675967259984,"[1, 1, 1, 1, 1, 1, 0, 0, 1, 0]"
18134,1,1,2,0.8652743778071761,"[1, 1, 0, 1, 0, 0, 1, 1, 1, 1]"
18135,1,1,2,0.4969782514032042,"[0, 1, 1, 1, 1, 1, 0, 0, 0, 1]"
18136,1,1,2,0.5447613725321908,"[0, 1, 1, 1, 1, 1, 0, 1, 1, 1]"
18137,1,1,2,0.1763156859823084,"[0, 0, 0, 0, 0, 0, 0, 0, 1, 1]"
18138,1,1,2,0.3737540525808013,"[1, 1, 0, 0, 1, 1, 1, 1, 1, 1]"
18139,2,2,4,0.551971237272053,"[1, 1, 0, 0, 1, 1, 1, 0, 0, 1]"
18140,1,1,2,0.6744419545163113,"[1, 1, 1, 1, 1, 1, 0, 0, 1, 1]"
18141,1,1,2,0.09932270611499827,"[1, 0, 0, 0, 0, 0, 1, 1, 0, 0]"
18142,1,1,2,0.9865552552581993,"[0, 0, 0, 1, 0, 0, 0, 1, 0, 0]"
18143,1,1,2,0.670337790499107,"[1, 0, 0, 1, 1, 0, 1, 0, 1, 0]"
18144,1,1,2,0.4221195857732746,"[0, 1, 1, 1, 1, 1, 0, 1, 1, 0]"
18145,1,1,2,0.8997727663436177,"[0, 0, 1, 1, 0, 1, 1, 0, 1, 1]"
18146,1,1,2,0.801716235801137,"[0, 0, 0, 1, 1, 0, 1, 1, 1, 1]"
18147,1,1,2,0.31054455935958614,"[0, 1, 1, 0, 0, 1, 1, 1, 1, 1]"
18148,1,1,2,0.9293590146020845,"[1, 1, 0, 0, 0, 1, 0, 0, 1, 0]"
18149,1,1,2,0.8539987485905518,"[0, 0, 0, 0, 1, 0, 1, 0, 0, 1]"
18150,1,1,2,0.5197776614821109,"[0, 1, 1, 1, 0, 0, 0, 1, 1, 1]"
18151,1,1,2,0.8120897190134968,"[0, 0, 1, 1, 1, 0, 1, 0, 0, 1]"
18152,1,1,2,0.3615647741842507,"[1, 1, 0, 0, 1, 1, 0, 0, 0, 1]"
18153,1,1,2,0.8810851975583336,"[0, 1, 0, 1, 0, 0, 1, 0, 1, 1]"
18154,1,1,2,0.42463297783201004,"[0, 1, 0, 1, 1, 1, 1, 0, 1, 0]"
18155,1,1,2,0.5783880099064467,"[0, 1, 1, 1, 1, 1, 1, 1, 1, 0]"
18156,1,1,2,0.28285103081497776,"[1, 1, 0, 0, 1, 0, 0, 1, 0, 0]"
18157,1,1,2,0.6992540155686406,"[0, 0, 1, 0, 0, 1, 0, 1, 0, 0]"
18158,1,1,2,0.7534197880045207,"[0, 0, 1, 0, 1, 1, 1, 0, 0, 1]"
18159,1,1,2,0.5330940242533213,"[1, 1, 0, 1, 1, 1, 1, 0, 0, 0]"
18160,1,1,2,0.5343845201101608,"[1, 1, 0, 1, 1, 1, 1, 1, 0, 0]"
18161,1,1,2,0.1545473879212833,"[1, 0, 0, 0, 0, 0, 1, 1, 1, 0]"
18162,1,1,2,0.036730888082263546,"[0, 0, 0, 0, 1, 0, 0, 0, 1, 1]"
18163,1,1,2,0.5769153634427415,"[1, 0, 1, 0, 1, 0, 1, 1, 1, 1]"
18164,1,1,2,0.22879341952683796,"[0, 0, 1, 0, 1, 1, 1, 0, 0, 0]"
18165,1,1,2,0.35711854143947164,"[1, 1, 0, 1, 1, 1, 1, 0, 0, 1]"
18166,1,1,2,0.06674079559029933,"[1, 0, 0, 0, 1, 1, 0, 1, 0, 0]"
18167,1,1,2,0.9087906780653497,"[1, 1, 1, 1, 1, 0, 0, 1, 0, 0]"
18168,1,1,2,0.6958263933961857,"[0, 1, 0, 0, 1, 0, 0, 0, 1, 0]"
18169,1,1,2,0.3409602585714937,"[0, 1, 1, 0, 1, 0, 0, 1, 0, 1]"
18170,1,1,2,0.850668380652418,"[0, 0, 0, 1, 1, 1, 1, 0, 0, 0]"
18171,1,1,2,0.8581250831891499,"[1, 1, 0, 1, 1, 0, 1, 0, 0, 1]"
18172,1,1,2,0.6669028346748439,"[0, 0, 1, 0, 1, 0, 1, 1, 0, 1]"
18173,2,2,4,0.8981328728800256,"[1, 0, 0, 0, 1, 1, 0, 0, 0, 0]"
18174,1,1,2,0.7063189191067863,"[1, 0, 1, 1, 0, 1, 0, 1, 1, 1]"
18175,1,1,2,0.752771515483687,"[0, 1, 0, 1, 0, 1, 0, 1, 0, 1]"
18176,1,1,2,0.4122889916913167,"[1, 0, 0, 0, 1, 1, 1, 1, 1, 0]"
18177,1,1,2,0.3563893601796003,"[1, 1, 0, 0, 0, 0, 1, 1, 0, 1]"
18178,1,1,2,0.3626990697539395,"[1, 0, 0, 0, 0, 1, 1, 0, 1, 0]"
18179,1,1,2,0.964761662956329,"[1, 1, 0, 1, 1, 0, 1, 1, 1, 1]"
18180,1,1,2,0.473935269793582,"[0, 0, 0, 1, 0, 1, 1, 1, 1, 1]"
18181,1,1,2,0.6827627316509725,"[0, 1, 1, 0, 0, 0, 1, 1, 1, 0]"
18182,1,1,2,0.24375372714437515,"[1, 0, 1, 1, 0, 0, 1, 0, 0, 0]"
18183,1,1,2,0.5698646728294633,"[1, 0, 0, 1, 1, 1, 0, 0, 1, 0]"
18184,1,1,2,0.056885216562062135,"[1, 1, 0, 1, 1, 0, 1, 0, 0, 0]"
18185,1,1,2,0.5269788499505091,"[0, 0, 1, 1, 1, 0, 1, 1, 0, 0]"
18186,1,1,2,0.5145099202858743,"[0, 1, 1, 0, 0, 0, 1, 0, 0, 1]"
18187,1,1,2,0.4824358445290611,"[1, 1, 1, 1, 1, 0, 0, 0, 1, 1]"
18188,1,1,2,0.00485340732022399,"[0, 1, 1, 1, 0, 1, 1, 0, 1, 0]"
18189,1,1,2,0.3947440103495199,"[0, 0, 1, 0, 0, 1, 1, 1, 0, 0]"
18190,1,1,2,0.8229476600524656,"[0, 0, 0, 0, 1, 0, 1, 1, 1, 1]"
18191,1,1,2,0.9017094992889755,"[1, 1, 0, 0, 1, 1, 0, 0, 0, 1]"
18192,1,1,2,0.05891706901345051,"[0, 1, 0, 0, 0, 1, 0, 1, 1, 1]"
18193,1,1,2,0.7807974229272752,"[0, 1, 0, 1, 0, 0, 1, 1, 0, 1]"
18194,1,1,2,0.44421406710119826,"[0, 0, 1, 1, 1, 1, 0, 1, 0, 0]"
18195,1,1,2,0.724025301403779,"[0, 0, 0, 0, 0, 0, 0, 0, 0, 0]"
18196,1,1,2,0.8886703719812759,"[0, 0, 0, 1, 0, 1, 1, 0, 0, 1]"
18197,1,1,2,0.7062382939969304,"[0, 1, 1, 1, 1, 1, 1, 1, 0, 1]"
18198,1,1,2,0.8807894530692169,"[0, 0, 1, 1, 0, 0, 0, 1, 1, 0]"
18199,1,1,2,0.46363542438936123,"[0, 0, 0, 0, 1, 0, 0, 0, 1, 1]"
18200,1,1,2,0.5226185258311913,"[1, 1, 1, 1, 0, 0, 1, 1, 1, 0]"
18201,1,1,2,0.8415172918109529,"[0, 1, 0, 0, 0, 0, 1, 0, 0, 0]"
18202,1,1,2,0.4696886255389918,"[1, 1, 0, 1, 0, 0, 1, 1, 0, 0]"
18203,1,1,2,0.14339726163628919,"[0, 0, 1, 1, 1, 0, 0, 1, 0, 1]"
18204,1,1,2,0.4998298331490948,"[1, 0, 1, 0, 0, 1, 0, 1, 1, 0]"
18205,1,1,2,0.3252552316984725,"[1, 0, 1, 1, 1, 0, 0, 1, 0, 0]"
18206,1,1,2,0.38199737218652263,"[0, 0, 0, 1, 0, 1, 1, 1, 1, 0]"
18207,1,1,2,0.0069383098622451955,"[0, 1, 1, 0, 1, 0, 1, 1, 0, 0]"
18208,1,1,2,0.5716255880923361,"[0, 0, 0, 1, 0, 1, 0, 0, 0, 0]"
18209,2,2,4,0.3819771418150504,"[0, 1, 0, 1, 0, 1, 0, 1, 0, 1]"
18210,1,1,2,0.21490663578536973,"[0, 0, 1, 0, 1, 1, 1, 0, 0, 1]"
18211,1,1,2,0.08712611090421807,"[1, 0, 1, 1, 1, 0, 1, 1, 1, 1]"
18212,1,1,2,0.7308964297716634,"[0, 1, 1, 1, 1, 1, 1, 1, 0, 1]"
18213,1,1,2,0.9351130539797742,"[1, 0, 0, 0, 1, 0, 0, 0, 0, 0]"
18214,1,1,2,0.4149300286771703,"[1, 0, 0, 1, 1, 0, 0, 0, 1, 1]"
18215,1,1,2,0.02655054355050479,"[1, 1, 1, 0, 1, 0, 0, 0, 1, 1]"
18216,1,1,2,0.5420320999277729,"[0, 1, 1, 1, 1, 1, 0, 1, 0, 0]"
18217,1,1,2,0.5107414071382551,"[0, 0, 0, 1, 0, 1, 0, 0, 0, 1]"
18218,1,1,2,0.7261419329508335,"[0, 1, 0, 1, 0, 0, 0, 1, 0, 0]"
18219,1,1,2,0.2794456099132401,"[1, 0, 0, 1, 0, 0, 0, 1, 0, 0]"
18220,1,1,2,0.6338395781437921,"[0, 0, 0, 1, 0, 0, 0, 1, 1, 0]"
18221,1,1,2,0.17409225361453728,"[0, 0, 0, 0, 1, 1, 1, 0, 1, 1]"
18222,1,1,2,0.8387328223793241,"[0, 0, 1, 1, 0, 1, 1, 1, 1, 1]"
18223,1,1,2,0.4270788058915638,"[0, 1, 1, 1, 1, 0, 1, 1, 1, 0]"
18224,1,1,2,0.6906043410948721,"[1, 1, 1, 0, 0, 0, 0, 0, 1, 0]"
18225,1,1,2,0.1362701751306119,"[1, 0, 1, 0, 1, 0, 0, 0, 0, 1]"
18226,1,1,2,0.14655833955786368,"[1, 1, 1, 1, 1, 1, 0, 0, 1, 0]"
18227,1,1,2,0.38309132085328956,"[1, 0, 0, 0, 0, 0, 1, 1, 0, 0]"
18228,1,1,2,0.5937761292863363,"[0, 1, 0, 1, 0, 0, 1, 1, 1, 1]"
18229,1,1,2,0.6506429155360132,"[1, 1, 0, 0, 0, 0, 0, 0, 0, 1]"
18230,1,1,2,0.10234009259597954,"[1, 1, 0, 0, 1, 1, 0, 0, 0, 0]"
18231,1,1,2,0.9758256322498128,"[0, 1, 1, 0, 0, 1, 0, 1, 1, 1]"
18232,1,1,2,0.016461938634254714,"[1, 1, 0, 0, 0, 0, 1, 0, 1, 0]"
18233,1,1,2,0.030785307102127124,"[1, 0, 0, 0, 1, 1, 0, 1, 1, 0]"
18234,1,1,2,0.7087498402883107,"[0, 0, 0, 0, 1, 0, 0, 1, 0, 1]"
18235,1,1,2,0.916135506724583,"[1, 0, 1, 1, 0, 1, 1, 1, 1, 0]"
18236,1,1,2,0.11060795116973965,"[1, 1, 1, 1, 1, 1, 1, 0, 1, 1]"
18237,1,1,2,0.7231368083315515,"[0, 0, 1, 1, 0, 0, 0, 1, 0, 0]"
18238,1,1,2,0.3225268010239579,"[0, 1, 1, 1, 0, 1, 0, 0, 1, 1]"
18239,1,1,2,0.29403483263322416,"[0, 1, 1, 0, 0, 1, 0, 1, 1, 1]"
18240,1,1,2,0.7096821761582877,"[0, 0, 0, 0, 1, 0, 0, 0, 0, 0]"
18241,1,1,2,0.1985806884214414,"[0, 0, 1, 1, 1, 1, 1, 1, 0, 1]"
18242,1,1,2,0.40804258357430534,"[0, 0, 0, 0, 1, 0, 0, 0, 0, 1]"
18243,1,1,2,0.5824605475557483,"[0, 1, 0, 0, 0, 1, 0, 0, 1, 0]"
18244,1,1,2,0.2820315509885728,"[0, 0, 1, 1, 0, 0, 1, 0, 0, 1]"
18245,1,1,2,0.08809590501428499,"[1, 0, 0, 0, 0, 1, 0, 0, 1, 1]"
18246,1,1,2,0.76897335559264,"[0, 0, 1, 0, 0, 0, 1, 1, 0, 1]"
18247,1,1,2,0.782508638071684,"[1, 0, 1, 1, 0, 1, 0, 0, 0, 0]"
18248,1,1,2,0.09867665105113699,"[0, 1, 1, 0, 0, 1, 1, 0, 1, 0]"
18249,1,1,2,0.18925803164529553,"[1, 1, 1, 1, 1, 1, 1, 0, 0, 1]"
18250,1,1,2,0.32701478024286956,"[0, 0, 0, 1, 0, 1, 0, 0, 1, 0]"
18251,1,1,2,0.5736353794847304,"[0, 1, 1, 1, 0, 0, 1, 0, 0, 1]"
18252,1,1,2,0.6644202204799944,"[1, 0, 0, 1, 1, 0, 0, 1, 1, 0]"
18253,1,1,2,0.585149621231323,"[1, 1, 0, 0, 0, 1, 0, 0, 0, 1]"
18254,1,1,2,0.6969866756154616,"[1, 1, 0, 0, 1, 0, 0, 1, 1, 0]"
18255,1,1,2,0.8822189779433527,"[0, 1, 0, 0, 0, 1, 0, 0, 1, 1]"
18256,1,1,2,0.007125784580146455,"[0, 0, 1, 0, 0, 1, 0, 0, 1, 1]"
18257,1,1,2,0.5964659409495479,"[0, 1, 1, 1, 0, 0, 1, 0, 0, 1]"
18258,1,1,2,0.21603726119053268,"[0, 1, 0, 1, 1, 0, 0, 0, 0, 1]"
18259,1,1,2,0.41032445713407484,"[0, 0, 1, 1, 0, 0, 1, 0, 0, 1]"
18260,1,1,2,0.8237951076298071,"[1, 0, 0, 1, 0, 1, 1, 1, 1, 1]"
18261,1,1,2,0.7962073723447708,"[0, 1, 1, 1, 0, 0, 1, 0, 1, 1]"
18262,1,1,2,0.602680395952361,"[1, 0, 1, 1, 0, 0, 1, 1, 1, 1]"
18263,1,1,2,0.1523660759532307,"[1, 0, 0, 0, 1, 0, 0, 0, 1, 0]"
18264,1,1,2,0.966707169192736,"[1, 0, 1, 1, 0, 1, 1, 1, 1, 1]"
18265,1,1,2,0.3504285412514754,"[1, 0, 0, 1, 0, 1, 0, 1, 1, 0]"
18266,1,1,2,0.8817018837856936,"[0, 1, 1, 1, 0, 0, 1, 0, 1, 1]"
18267,1,1,2,0.5538599397757471,"[1, 1, 1, 0, 1, 1, 1, 1, 1, 0]"
18268,1,1,2,0.6850571291617541,"[1, 1, 0, 1, 0, 1, 0, 1, 1, 0]"
18269,1,1,2,0.5113773514211948,"[0, 1, 0, 0, 1, 0, 1, 0, 0, 1]"
18270,2,2,4,0.11474620030551441,"[1, 0, 0, 1, 1, 1, 1, 1, 1, 1]"
18271,1,1,2,0.6352240741350544,"[1, 0, 1, 1, 1, 0, 1, 1, 0, 0]"
18272,1,1,2,0.2296494085059657,"[0, 1, 0, 1, 0, 0, 1, 1, 1, 1]"
18273,1,1,2,0.21507999975331193,"[0, 1, 1, 0, 1, 0, 1, 0, 1, 1]"
18274,1,1,2,0.455481530043935,"[1, 0, 0, 0, 0, 0, 0, 1, 1, 0]"
18275,1,1,2,0.30193741131639285,"[0, 0, 0, 1, 0, 1, 0, 1, 1, 0]"
18276,1,1,2,0.17437343314661324,"[0, 0, 0, 1, 1, 0, 1, 1, 1, 1]"
18277,1,1,2,0.7187883609956103,"[0, 0, 0, 0, 0, 1, 1, 1, 0, 1]"
18278,1,1,2,0.06608507197953839,"[1, 0, 1, 1, 0, 0, 0, 0, 0, 0]"
18279,1,1,2,0.8653173527205218,"[1, 1, 1, 1, 0, 1, 0, 0, 1, 1]"
18280,1,1,2,0.06769210905443679,"[1, 1, 1, 0, 1, 0, 0, 0, 1, 0]"
18281,1,1,2,0.810621376742344,"[0, 1, 0, 1, 1, 0, 0, 0, 0, 0]"
18282,1,1,2,0.3011568296370407,"[0, 1, 0, 0, 1, 1, 1, 0, 1, 1]"
18283,1,1,2,0.8232289894543694,"[0, 1, 0, 1, 1, 0, 1, 0, 1, 1]"
18284,1,1,2,0.1722238949820345,"[1, 0, 0, 0, 0, 1, 1, 1, 0, 0]"
18285,1,1,2,0.10307055304044688,"[1, 1, 1, 0, 1, 0, 0, 0, 0, 0]"
18286,1,1,2,0.1562473697260155,"[1, 0, 1, 1, 1, 1, 1, 1, 1, 0]"
18287,2,2,4,0.7946998373869214,"[1, 1, 1, 1, 1, 0, 1, 0, 1, 0]"
18288,1,1,2,0.44565980283891204,"[1, 1, 1, 1, 0, 1, 1, 1, 1, 0]"
18289,1,1,2,0.36926190123034575,"[0, 1, 1, 1, 1, 1, 0, 1, 1, 0]"
18290,1,1,2,0.6260210969173025,"[1, 0, 1, 0, 1, 0, 0, 0, 1, 1]"
18291,1,1,2,0.9810739806017208,"[1, 0, 1, 1, 0, 1, 0, 0, 1, 0]"
18292,1,1,2,0.818473273811979,"[0, 0, 0, 0, 1, 1, 1, 1, 1, 0]"
18293,1,1,2,0.20160093585992245,"[1, 0, 1, 0, 1, 0, 1, 0, 0, 0]"
18294,1,1,2,0.04310274201099995,"[1, 1, 0, 0, 0, 1, 1, 0, 1, 0]"
18295,1,1,2,0.5923094522697202,"[0, 1, 1, 1, 1, 0, 1, 0, 0, 0]"
18296,1,1,2,0.02990181288212379,"[0, 1, 0, 0, 0, 1, 1, 0, 1, 0]"
18297,1,1,2,0.4677042214178917,"[0, 0, 1, 0, 1, 0, 1, 1, 0, 1]"
18298,1,1,2,0.4172866369870337,"[0, 0, 1, 1, 0, 1, 0, 0, 0, 0]"
18299,1,1,2,0.8024761278665116,"[1, 1, 0, 0, 0, 1, 1, 1, 1, 1]"
18300,1,1,2,0.10206544674551898,"[1, 1, 0, 1, 0, 0, 0, 1, 1, 0]"
18301,1,1,2,0.3274490120344613,"[1, 0, 1, 1, 0, 1, 0, 0, 0, 1]"
18302,1,1,2,0.3607729010911055,"[1, 1, 0, 1, 0, 1, 1, 0, 0, 0]"
18303,1,1,2,0.6803851768498521,"[0, 0, 0, 1, 0, 1, 1, 0, 1, 0]"
18304,1,1,2,0.8865460334941533,"[1, 0, 0, 1, 1, 0, 0, 1, 0, 0]"
18305,1,1,2,0.23628706139449684,"[1, 1, 0, 0, 0, 1, 1, 0, 1, 1]"
18306,1,1,2,0.1557446481325554,"[1, 0, 1, 1, 1, 1, 0, 1, 0, 1]"
18307,1,1,2,0.7309514321581697,"[1, 0, 1, 1, 0, 1, 0, 0, 0, 1]"
18308,1,1,2,0.8651446277456808,"[1, 1, 0, 0, 0, 1, 0, 0, 1, 0]"
18309,1,1,2,0.7732042632586131,"[0, 0, 1, 0, 0, 0, 0, 0, 0, 1]"
18310,1,1,2,0.8501399450739662,"[1, 0, 0, 0, 0, 0, 1, 1, 1, 1]"
18311,1,1,2,0.722841201105722,"[0, 1, 1, 1, 1, 1, 1, 1, 1, 0]"
18312,1,1,2,0.1400203260129398,"[0, 0, 1, 0, 1, 0, 0, 1, 1, 0]"
18313,1,1,2,0.9966214166042455,"[0, 0, 1, 0, 1, 0, 0, 1, 0, 0]"
18314,1,1,2,0.9001764127334168,"[1, 0, 1, 1, 1, 1, 0, 0, 1, 1]"
18315,1,1,2,0.4011033940976765,"[1, 0, 0, 0, 1, 0, 1, 1, 0, 0]"
18316,1,1,2,0.6622019645211427,"[0, 1, 1, 0, 0, 0, 1, 1, 0, 1]"
18317,1,1,2,0.4328247937254739,"[0, 0, 1, 0, 0, 1, 0, 0, 0, 0]"
18318,1,1,2,0.47273714453430626,"[0, 0, 0, 1, 0, 0, 1, 0, 1, 1]"
18319,1,1,2,0.5390931077467269,"[0, 0, 1, 0, 1, 0, 0, 0, 1, 0]"
18320,1,1,2,0.34599940366667403,"[1, 1, 1, 0, 1, 0, 0, 0, 0, 0]"
18321,1,1,2,0.13985371566360616,"[0, 0, 0, 1, 1, 1, 1, 0, 0, 0]"
18322,1,1,2,0.20331131534018254,"[0, 0, 1, 1, 1, 0, 0, 1, 1, 0]"
18323,1,1,2,0.8851137381270349,"[0, 1, 0, 1, 0, 1, 1, 0, 1, 0]"
18324,1,1,2,0.708542452632598,"[0, 1, 1, 1, 0, 1, 1, 0, 1, 1]"
18325,1,1,2,0.12393453050508396,"[0, 1, 1, 0, 0, 0, 1, 0, 0, 0]"
18326,1,1,2,0.4805189407420104,"[1, 0, 1, 0, 1, 0, 0, 0, 0, 0]"
18327,1,1,2,0.45247559608517895,"[1, 1, 0, 1, 1, 1, 1, 1, 0, 1]"
18328,1,1,2,0.1974323187580388,"[1, 1, 0, 1, 1, 1, 0, 1, 0, 0]"
18329,1,1,2,0.2731065770332416,"[1, 1, 1, 1, 0, 1, 0, 0, 1, 0]"
18330,1,1,2,0.9984703908692822,"[0, 0, 1, 1, 0, 1, 1, 1, 0, 0]"
18331,1,1,2,0.9271918282365853,"[1, 1, 0, 0, 0, 1, 0, 0, 1, 0]"
18332,1,1,2,0.5416130969664338,"[1, 0, 0, 1, 1, 1, 1, 0, 1, 0]"
18333,1,1,2,0.22942013245761428,"[0, 1, 0, 1, 1, 1, 0, 0, 0, 0]"
18334,1,1,2,0.9500946942136156,"[1, 0, 0, 1, 1, 1, 0, 0, 0, 1]"
18335,1,1,2,0.6963909636327329,"[0, 1, 0, 0, 0, 1, 1, 0, 0, 0]"
18336,1,1,2,0.2686741814085123,"[0, 1, 0, 0, 1, 1, 0, 1, 0, 0]"
18337,1,1,2,0.12901943295087726,"[1, 0, 0, 0, 0, 0, 1, 0, 1, 0]"
18338,1,1,2,0.766289930938972,"[0, 0, 1, 1, 0, 0, 0, 0, 1, 0]"
18339,1,1,2,0.554852630137735,"[0, 0, 1, 0, 0, 0, 1, 0, 0, 1]"
18340,1,1,2,0.17577183587587963,"[1, 1, 1, 0, 1, 0, 0, 0, 0, 0]"
18341,1,1,2,0.30005306732459547,"[0, 1, 0, 1, 0, 0, 0, 0, 0, 0]"
18342,1,1,2,0.9894317314470467,"[1, 1, 1, 1, 0, 0, 0, 0, 0, 1]"
18343,1,1,2,0.3129306398716736,"[1, 1, 0, 0, 1, 0, 1, 1, 0, 0]"
18344,1,1,2,0.9354705738099222,"[0, 1, 1, 0, 0, 1, 0, 0, 1, 1]"
18345,1,1,2,0.27363537336385535,"[1, 0, 0, 1, 0, 0, 1, 0, 1, 0]"
18346,2,2,4,0.2547266050593815,"[0, 0, 1, 0, 1, 0, 0, 1, 1, 1]"
18347,1,1,2,0.15123807941319312,"[0, 0, 0, 0, 0, 0, 1, 1, 1, 1]"
18348,1,1,2,0.9721022311640006,"[0, 1, 1, 0, 1, 1, 0, 0, 0, 0]"
18349,1,1,2,0.4545128954936519,"[0, 1, 1, 0, 0, 1, 1, 0, 1, 1]"
18350,1,1,2,0.9250231129254891,"[1, 0, 0, 0, 1, 1, 1, 0, 1, 1]"
18351,1,1,2,0.9575330061520392,"[0, 1, 0, 0, 0, 0, 0, 1, 0, 0]"
18352,1,1,2,0.5270354976539205,"[0, 1, 1, 0, 0, 0, 0, 0, 0, 1]"
18353,1,1,2,0.5100332461390925,"[0, 1, 0, 0, 1, 0, 0, 1, 1, 1]"
18354,1,1,2,0.9518916190001429,"[0, 1, 1, 0, 1, 1, 1, 1, 0, 1]"
18355,1,1,2,0.959858680850346,"[0, 1, 0, 0, 0, 1, 1, 1, 1, 0]"
18356,1,1,2,0.27547329157599654,"[0, 1, 0, 0, 1, 0, 1, 1, 1, 0]"
18357,1,1,2,0.038535773189113165,"[1, 0, 0, 0, 0, 0, 1, 1, 1, 1]"
18358,1,1,2,0.37017896900314773,"[1, 1, 0, 0, 0, 1, 1, 1, 0, 1]"
18359,1,1,2,0.8425577233309178,"[1, 1, 0, 0, 0, 1, 0, 1, 0, 1]"
18360,1,1,2,0.36608435699781283,"[0, 0, 1, 0, 0, 1, 1, 1, 1, 0]"
18361,1,1,2,0.4533565170989393,"[0, 0, 0, 1, 0, 1, 0, 1, 0, 0]"
18362,1,1,2,0.7947359684180056,"[1, 1, 1, 0, 1, 0, 0, 1, 0, 1]"
18363,1,1,2,0.7329733516098851,"[0, 1, 0, 1, 1, 1, 0, 0, 0, 1]"
18364,2,2,4,0.5988930114595937,"[1, 1, 1, 1, 0, 0, 0, 1, 0, 1]"
18365,1,1,2,0.7325744167917627,"[0, 1, 0, 1, 0, 0, 0, 0, 1, 1]"
18366,1,1,2,0.3414374949157568,"[0, 1, 1, 1, 0, 0, 0, 0, 1, 1]"
18367,1,1,2,0.7607297952054634,"[1, 0, 1, 1, 1, 0, 0, 0, 0, 0]"
18368,1,1,2,0.25410320559992994,"[0, 0, 1, 0, 0, 0, 1, 0, 0, 0]"
18369,1,1,2,0.4154084698606565,"[1, 1, 1, 1, 0, 0, 1, 1, 1, 1]"
18370,1,1,2,0.39347971533011084,"[1, 0, 0, 1, 0, 0, 1, 0, 1, 1]"
18371,1,1,2,0.12835790167396932,"[1, 1, 0, 0, 1, 0, 0, 1, 0, 1]"
18372,1,1,2,0.6888581655252121,"[0, 0, 1, 1, 0, 1, 1, 0, 1, 1]"
18373,1,1,2,0.13162999737083336,"[0, 1, 1, 0, 1, 0, 1, 1, 0, 0]"
18374,1,1,2,0.006630228321399034,"[1, 0, 0, 1, 1, 0, 1, 1, 1, 1]"
18375,1,1,2,0.12952027284268752,"[0, 0, 1, 0, 0, 0, 0, 1, 1, 1]"
18376,1,1,2,0.27817628390128024,"[0, 0, 1, 0, 1, 0, 0, 0, 1, 1]"
18377,2,2,4,0.29182803702698124,"[0, 1, 0, 1, 1, 1, 1, 0, 0, 1]"
18378,1,1,2,0.9907564205043874,"[0, 1, 1, 0, 0, 0, 0, 1, 0, 0]"
18379,1,1,2,0.305249549253803,"[1, 1, 1, 0, 1, 1, 1, 0, 0, 0]"
18380,1,1,2,0.7948600204060912,"[1, 0, 1, 1, 1, 1, 0, 1, 0, 0]"
18381,2,2,4,0.4812994122652675,"[0, 0, 0, 0, 0, 1, 1, 0, 1, 1]"
18382,1,1,2,0.5109295738981325,"[1, 0, 1, 0, 1, 1, 1, 0, 1, 0]"
18383,1,1,2,0.16780400359939263,"[0, 1, 1, 0, 0, 0, 1, 0, 0, 1]"
18384,1,1,2,0.02833485446260442,"[0, 0, 0, 0, 1, 1, 1, 0, 0, 1]"
18385,1,1,2,0.9124971263693412,"[1, 1, 0, 0, 0, 1, 0, 0, 0, 0]"
18386,1,1,2,0.6282356618151672,"[1, 1, 1, 1, 0, 0, 1, 1, 1, 0]"
18387,1,1,2,0.38761522255391334,"[1, 0, 1, 0, 1, 0, 0, 0, 1, 0]"
18388,1,1,2,0.28437458216041633,"[0, 0, 0, 1, 0, 0, 0, 1, 0, 0]"
18389,1,1,2,0.32259839987355365,"[0, 1, 1, 1, 0, 0, 1, 1, 1, 1]"
18390,1,1,2,0.36652972962493013,"[1, 0, 1, 0, 1, 1, 0, 1, 0, 1]"
18391,1,1,2,0.1253047991557591,"[0, 1, 1, 1, 0, 0, 0, 1, 0, 0]"
18392,1,1,2,0.23574048570412964,"[0, 1, 0, 1, 1, 0, 1, 1, 0, 0]"
18393,1,1,2,0.3873398342263943,"[1, 1, 1, 1, 0, 0, 1, 0, 0, 0]"
18394,1,1,2,0.14995837021425074,"[1, 1, 0, 0, 0, 0, 0, 1, 1, 1]"
18395,1,1,2,0.15958900181044766,"[1, 0, 0, 0, 0, 0, 0, 1, 0, 0]"
18396,1,1,2,0.5692943067137068,"[1, 1, 0, 0, 1, 0, 0, 0, 0, 1]"
18397,1,1,2,0.448346952784891,"[0, 0, 1, 1, 1, 0, 0, 0, 1, 1]"
18398,1,1,2,0.08687180709865006,"[1, 1, 0, 0, 1, 0, 0, 1, 0, 0]"
18399,1,1,2,0.6693467844833528,"[0, 0, 0, 0, 0, 1, 1, 1, 0, 0]"
18400,1,1,2,0.7140504299284717,"[0, 1, 1, 0, 1, 1, 0, 0, 0, 0]"
18401,1,1,2,0.4064754001853287,"[1, 0, 1, 1, 1, 0, 0, 1, 1, 0]"
18402,1,1,2,0.8388585493369671,"[0, 1, 1, 1, 0, 1, 0, 1, 0, 1]"
18403,1,1,2,0.25525139935603436,"[1, 0, 1, 0, 1, 0, 1, 0, 1, 1]"
18404,1,1,2,0.3479087980415435,"[1, 1, 1, 1, 1, 1, 1, 1, 1, 0]"
18405,1,1,2,0.4760632415211302,"[0, 0, 0, 1, 1, 1, 1, 0, 0, 0]"
18406,1,1,2,0.4670842158649162,"[0, 0, 1, 1, 1, 1, 1, 0, 1, 0]"
18407,2,2,4,0.6845765062417956,"[1, 1, 1, 1, 1, 0, 1, 1, 0, 1]"
18408,1,1,2,0.5148111207371359,"[0, 1, 1, 0, 0, 1, 0, 1, 0, 1]"
18409,1,1,2,0.8719396436962807,"[1, 0, 0, 1, 0, 1, 1, 1, 1, 0]"
18410,1,1,2,0.03515472979404677,"[0, 1, 1, 1, 0, 0, 1, 1, 1, 1]"
18411,1,1,2,0.5514090054958608,"[0, 1, 1, 1, 1, 0, 1, 1, 0, 1]"
18412,1,1,2,0.4645280933637138,"[1, 1, 0, 0, 1, 1, 0, 1, 0, 0]"
18413,1,1,2,0.6775447024463952,"[0, 1, 0, 1, 1, 1, 0, 0, 1, 0]"
18414,1,1,2,0.24929841953496068,"[1, 1, 1, 0, 1, 1, 0, 1, 0, 0]"
18415,1,1,2,0.44508540710229905,"[0, 1, 0, 1, 1, 0, 1, 0, 0, 1]"
18416,1,1,2,0.03408721393089731,"[1, 0, 0, 0, 0, 0, 0, 1, 0, 1]"
18417,1,1,2,0.8887495388398878,"[1, 1, 1, 1, 0, 0, 1, 1, 0, 0]"
18418,1,1,2,0.6512814788745472,"[1, 0, 1, 0, 1, 1, 0, 1, 1, 1]"
18419,1,1,2,0.7204235778332325,"[1, 0, 0, 0, 1, 1, 0, 0, 1, 0]"
18420,1,1,2,0.9071851427083055,"[0, 1, 0, 0, 1, 0, 0, 1, 1, 1]"
18421,1,1,2,0.9950482735072722,"[0, 0, 0, 1, 0, 1, 0, 1, 0, 1]"
18422,1,1,2,0.6078530592950736,"[0, 1, 0, 1, 1, 1, 0, 1, 1, 1]"
18423,1,1,2,0.5935078974604007,"[1, 0, 0, 1, 1, 0, 0, 1, 0, 1]"
18424,1,1,2,0.6273077375185286,"[0, 1, 1, 1, 0, 0, 1, 0, 1, 0]"
18425,1,1,2,0.7546103856960563,"[1, 1, 1, 0, 1, 1, 1, 1, 0, 0]"
18426,1,1,2,0.5627656431933368,"[0, 1, 1, 0, 0, 0, 0, 1, 1, 0]"
18427,1,1,2,0.9909172205904254,"[1, 1, 0, 0, 1, 1, 0, 1, 1, 0]"
18428,1,1,2,0.790477256441569,"[1, 1, 1, 1, 0, 0, 1, 0, 1, 1]"
18429,1,1,2,0.6335917257173589,"[0, 0, 0, 1, 1, 1, 1, 1, 0, 1]"
18430,1,1,2,0.7925509569296367,"[1, 0, 1, 1, 0, 0, 1, 1, 0, 0]"
18431,1,1,2,0.8341342877391306,"[1, 1, 1, 0, 1, 0, 1, 0, 1, 1]"
18432,1,1,2,0.46682173799525406,"[0, 1, 0, 1, 0, 1, 1, 1, 1, 0]"
18433,1,1,2,0.3176993050204838,"[0, 0, 0, 1, 1, 1, 1, 0, 0, 0]"
18434,1,1,2,0.8047237279515149,"[1, 0, 0, 1, 0, 0, 0, 1, 0, 1]"
18435,1,1,2,0.8524097229075563,"[0, 0, 1, 1, 1, 1, 1, 1, 1, 1]"
18436,1,1,2,0.8361734049475623,"[0, 1, 1, 0, 1, 1, 0, 1, 1, 1]"
18437,1,1,2,0.999093821939101,"[1, 1, 1, 0, 0, 1, 1, 1, 1, 1]"
18438,1,1,2,0.07949930646430603,"[0, 0, 0, 1, 0, 0, 0, 1, 0, 1]"
18439,1,1,2,0.6660435500934041,"[0, 0, 0, 0, 0, 0, 0, 0, 1, 0]"
18440,1,1,2,0.314186671420322,"[0, 1, 0, 1, 1, 1, 0, 1, 0, 1]"
18441,1,1,2,0.7009431111133472,"[1, 0, 1, 1, 1, 0, 1, 0, 1, 1]"
18442,1,1,2,0.43946798253115693,"[1, 0, 1, 1, 0, 0, 0, 0, 1, 0]"
18443,1,1,2,0.3105237806405401,"[1, 1, 0, 1, 1, 0, 1, 1, 0, 0]"
18444,2,2,4,0.9160568929955102,"[1, 1, 0, 0, 1, 1, 1, 0, 0, 0]"
18445,1,1,2,0.39143162900431294,"[1, 1, 0, 1, 1, 1, 0, 0, 0, 1]"
18446,1,1,2,0.9715751383626752,"[1, 0, 1, 1, 0, 1, 1, 1, 0, 1]"
18447,1,1,2,0.2582487727866697,"[1, 0, 1, 1, 1, 1, 0, 0, 1, 0]"
18448,2,2,4,0.9205871531489678,"[1, 0, 1, 0, 0, 1, 1, 1, 0, 1]"
18449,1,1,2,0.01823243251803075,"[1, 1, 0, 1, 1, 1, 0, 1, 1, 0]"
18450,1,1,2,0.812844489342124,"[0, 0, 1, 0, 0, 0, 0, 1, 0, 0]"
18451,1,1,2,0.9893850518522748,"[0, 1, 1, 0, 0, 0, 0, 1, 1, 1]"
18452,1,1,2,0.44820625658783364,"[1, 1, 0, 0, 0, 1, 0, 0, 0, 1]"
18453,1,1,2,0.9714629872540012,"[1, 0, 0, 1, 0, 0, 0, 0, 0, 1]"
18454,1,1,2,0.2416433504391272,"[1, 1, 1, 0, 0, 0, 0, 0, 1, 0]"
18455,1,1,2,0.006662660889956706,"[1, 0, 0, 1, 1, 1, 0, 1, 0, 1]"
18456,2,2,4,0.9762373551762925,"[1, 1, 0, 1, 0, 0, 0, 0, 0, 0]"
18457,1,1,2,0.2635301858866337,"[1, 1, 1, 1, 0, 1, 0, 1, 0, 1]"
18458,1,1,2,0.879840334972333,"[1, 1, 1, 0, 1, 1, 0, 0, 0, 0]"
18459,1,1,2,0.6259240641655405,"[0, 0, 1, 1, 1, 0, 0, 1, 1, 1]"
18460,1,1,2,0.3506470335305766,"[1, 0, 0, 0, 1, 0, 1, 0, 1, 1]"
18461,1,1,2,0.15418684781425773,"[0, 1, 0, 0, 1, 1, 1, 0, 1, 0]"
18462,1,1,2,0.6814793091835845,"[1, 0, 1, 0, 0, 0, 1, 0, 1, 1]"
18463,1,1,2,0.452629820213604,"[1, 1, 0, 1, 0, 0, 0, 1, 1, 1]"
18464,1,1,2,0.5470261068512048,"[0, 0, 0, 1, 1, 0, 0, 1, 0, 0]"
18465,1,1,2,0.015496833115315578,"[1, 0, 0, 1, 1, 1, 0, 1, 1, 1]"
18466,1,1,2,0.6843068916301176,"[1, 0, 1, 0, 0, 0, 1, 0, 0, 0]"
18467,1,1,2,0.027695908947583003,"[1, 1, 0, 0, 0, 0, 1, 1, 1, 0]"
18468,1,1,2,0.0048535395209915455,"[0, 1, 0, 0, 1, 1, 0, 1, 0, 0]"
18469,1,1,2,0.6477828904223542,"[0, 1, 1, 1, 1, 1, 1, 1, 1, 1]"
18470,1,1,2,0.12279140429799273,"[0, 1, 0, 0, 0, 0, 1, 0, 0, 1]"
18471,1,1,2,0.35474074094176666,"[1, 1, 1, 1, 1, 1, 0, 0, 0, 1]"
18472,1,1,2,0.20340113164757145,"[1, 0, 1, 1, 1, 1, 0, 1, 1, 0]"
18473,1,1,2,0.5259575361512367,"[1, 1, 0, 0, 0, 0, 0, 0, 1, 0]"
18474,1,1,2,0.4477597096245961,"[1, 1, 0, 1, 0, 1, 1, 1, 1, 0]"
18475,1,1,2,0.6012441686192566,"[0, 1, 0, 1, 1, 1, 1, 0, 1, 0]"
18476,1,1,2,0.9304654904451647,"[0, 1, 1, 0, 0, 0, 1, 1, 0, 1]"
18477,1,1,2,0.6675407147856808,"[0, 0, 0, 1, 1, 1, 1, 1, 0, 0]"
18478,1,1,2,0.4974351229597136,"[1, 1, 0, 0, 0, 0, 1, 0, 1, 1]"
18479,1,1,2,0.9927859806215886,"[1, 1, 1, 1, 0, 0, 0, 0, 1, 1]"
18480,1,1,2,0.8205523270328658,"[0, 1, 1, 1, 0, 1, 1, 0, 0, 0]"
18481,1,1,2,0.7942848343999908,"[1, 1, 1, 1, 0, 0, 0, 1, 1, 0]"
18482,1,1,2,0.15775261529764162,"[1, 1, 1, 0, 1, 1, 1, 1, 0, 1]"
18483,1,1,2,0.92395036950156,"[0, 0, 0, 0, 1, 0, 1, 0, 0, 0]"
18484,1,1,2,0.2662091144271589,"[1, 0, 1, 1, 1, 1, 0, 1, 0, 0]"
18485,1,1,2,0.036433491772964066,"[1, 0, 0, 0, 0, 0, 1, 0, 1, 0]"
18486,1,1,2,0.29473351399931635,"[1, 1, 0, 1, 0, 0, 1, 1, 0, 1]"
18487,1,1,2,0.12105536202419942,"[1, 1, 0, 0, 1, 0, 0, 1, 1, 1]"
18488,1,1,2,0.8121278616967811,"[1, 0, 1, 0, 1, 1, 1, 1, 1, 1]"
18489,1,1,2,0.8132508343194438,"[0, 1, 0, 1, 0, 0, 0, 1, 1, 1]"
18490,1,1,2,0.2714654990574553,"[1, 0, 0, 1, 0, 0, 0, 0, 0, 1]"
18491,1,1,2,0.8243275917662773,"[0, 0, 0, 1, 1, 1, 1, 1, 1, 1]"
18492,1,1,2,0.07650768848920197,"[1, 0, 0, 1, 0, 0, 0, 0, 1, 1]"
18493,2,2,4,0.34528368699878664,"[0, 1, 1, 1, 0, 1, 1, 1, 1, 0]"
18494,1,1,2,0.2189169279979476,"[1, 0, 0, 1, 0, 0, 1, 1, 0, 1]"
18495,1,1,2,0.5552174885608089,"[1, 0, 1, 1, 1, 0, 0, 0, 0, 0]"
18496,1,1,2,0.6587899019916564,"[1, 0, 0, 0, 1, 0, 1, 0, 0, 1]"
18497,1,1,2,0.06856848046839725,"[0, 1, 0, 1, 0, 0, 0, 1, 0, 1]"
18498,2,2,4,0.6288193384241322,"[1, 0, 1, 1, 1, 0, 0, 0, 1, 1]"
18499,1,1,2,0.06279936108684814,"[1, 1, 0, 0, 0, 0, 0, 0, 1, 1]"
18500,1,1,2,0.6523590523787074,"[1, 0, 1, 0, 0, 0, 1, 1, 0, 1]"
18501,1,1,2,0.739691982928101,"[0, 0, 1, 0, 1, 1, 1, 0, 1, 1]"
18502,1,1,2,0.38923159268822927,"[0, 0, 1, 1, 0, 1, 1, 1, 1, 0]"
18503,1,1,2,0.45397812780556324,"[0, 1, 0, 1, 1, 1, 0, 0, 0, 0]"
18504,1,1,2,0.9557790533166115,"[1, 1, 0, 0, 1, 1, 0, 0, 1, 0]"
18505,1,1,2,0.7027571787607056,"[1, 1, 1, 1, 1, 0, 1, 1, 1, 0]"
18506,1,1,2,0.5874351765962498,"[0, 1, 1, 1, 0, 0, 0, 1, 0, 1]"
18507,1,1,2,0.9654831214612474,"[1, 0, 0, 1, 1, 0, 0, 1, 1, 1]"
18508,1,1,2,0.8336391206363654,"[1, 0, 0, 0, 0, 0, 0, 0, 1, 0]"
18509,1,1,2,0.8883810483068585,"[1, 0, 1, 1, 1, 1, 0, 1, 1, 0]"
18510,1,1,2,0.44162344109739504,"[0, 0, 1, 0, 1, 0, 0, 1, 0, 0]"
18511,1,1,2,0.5577081502039921,"[1, 0, 0, 0, 0, 1, 0, 0, 0, 0]"
18512,1,1,2,0.7604347674940986,"[1, 0, 1, 1, 1, 0, 1, 1, 1, 1]"
18513,1,1,2,0.4093320031762602,"[0, 0, 0, 1, 0, 1, 0, 0, 0, 1]"
18514,1,1,2,0.1804872146039218,"[0, 0, 1, 1, 1, 1, 1, 1, 1, 0]"
18515,1,1,2,0.9796061182832162,"[1, 0, 1, 0, 0, 1, 1, 1, 0, 1]"
18516,1,1,2,0.8410782269685732,"[1, 0, 1, 1, 0, 1, 1, 0, 1, 0]"
18517,1,1,2,0.5276953467266201,"[0, 1, 0, 1, 0, 0, 1, 0, 0, 0]"
18518,1,1,2,0.0921211142519317,"[0, 1, 0, 0, 1, 0, 1, 0, 1, 0]"
18519,1,1,2,0.8752602703865068,"[1, 1, 1, 1, 1, 0, 1, 0, 1, 1]"
18520,1,1,2,0.672044396536344,"[0, 1, 1, 1, 1, 1, 0, 0, 1, 0]"
18521,1,1,2,0.9640165033681549,"[1, 1, 0, 1, 1, 1, 0, 0, 1, 0]"
18522,1,1,2,0.7029929481990153,"[1, 0, 1, 1, 1, 1, 1, 1, 1, 1]"
18523,1,1,2,0.7127179872808587,"[1, 1, 1, 0, 0, 1, 0, 1, 0, 1]"
18524,1,1,2,0.7815574191931915,"[1, 0, 1, 1, 0, 0, 1, 1, 1, 0]"
18525,1,1,2,0.3736038816871745,"[0, 1, 0, 1, 1, 0, 1, 0, 1, 1]"
18526,1,1,2,0.8488461282805454,"[0, 1, 0, 1, 1, 1, 1, 1, 0, 1]"
18527,1,1,2,0.18867911275202442,"[0, 1, 1, 1, 0, 0, 1, 1, 0, 0]"
18528,1,1,2,0.4020717550964027,"[0, 0, 0, 1, 0, 0, 1, 1, 0, 0]"
18529,1,1,2,0.8673492800329947,"[1, 1, 0, 1, 0, 1, 0, 1, 0, 0]"
18530,2,2,4,0.3685182671880257,"[1, 0, 0, 0, 0, 1, 1, 0, 1, 0]"
18531,1,1,2,0.3371438206756875,"[1, 0, 1, 0, 1, 0, 1, 1, 0, 1]"
18532,1,1,2,0.18417534845035,"[0, 0, 1, 0, 1, 0, 1, 0, 0, 1]"
18533,1,1,2,0.9392163637356616,"[1, 1, 1, 0, 0, 0, 1, 1, 0, 0]"
18534,1,1,2,0.015821166079750704,"[0, 0, 1, 1, 0, 0, 0, 1, 1, 0]"
18535,2,2,4,0.6212527085628956,"[1, 1, 1, 0, 0, 1, 0, 0, 0, 0]"
18536,1,1,2,0.9525540327437251,"[0, 0, 1, 1, 1, 0, 0, 1, 0, 0]"
18537,1,1,2,0.16268421928424437,"[0, 1, 0, 1, 1, 0, 1, 0, 1, 1]"
18538,1,1,2,0.7690091709827938,"[1, 1, 1, 0, 1, 1, 0, 1, 0, 0]"
18539,1,1,2,0.30816242205239885,"[1, 0, 0, 1, 0, 0, 1, 0, 1, 1]"
18540,1,1,2,0.8838755049863471,"[0, 1, 0, 1, 1, 1, 0, 0, 1, 0]"
18541,1,1,2,0.7900605547945336,"[0, 0, 1, 1, 0, 0, 1, 0, 1, 1]"
18542,1,1,2,0.731183972197493,"[1, 1, 0, 0, 1, 0, 1, 1, 1, 1]"
18543,1,1,2,0.7467055855726614,"[1, 1, 0, 1, 0, 0, 0, 1, 0, 0]"
18544,1,1,2,0.015929021621431727,"[0, 0, 0, 0, 0, 1, 1, 1, 0, 1]"
18545,1,1,2,0.027393156366334992,"[0, 1, 0, 0, 0, 1, 1, 0, 1, 0]"
18546,1,1,2,0.33213497817319093,"[1, 0, 1, 0, 0, 0, 0, 0, 0, 1]"
18547,1,1,2,0.9787503745035587,"[1, 1, 1, 1, 0, 1, 0, 1, 0, 1]"
18548,1,1,2,0.26614577197217426,"[0, 0, 0, 0, 1, 0, 0, 1, 1, 0]"
18549,1,1,2,0.5073547438879596,"[1, 1, 0, 1, 1, 0, 0, 0, 1, 0]"
18550,1,1,2,0.07228005724455977,"[1, 0, 1, 1, 1, 0, 1, 0, 1, 0]"
18551,1,1,2,0.9212294077077741,"[0, 1, 1, 0, 1, 1, 1, 1, 0, 0]"
18552,1,1,2,0.5195668385583161,"[1, 1, 0, 1, 0, 0, 0, 0, 0, 0]"
18553,1,1,2,0.48623067474699777,"[0, 0, 0, 1, 0, 1, 1, 0, 1, 0]"
18554,1,1,2,0.02485721535029528,"[0, 1, 0, 1, 1, 0, 1, 1, 1, 0]"
18555,1,1,2,0.7193863861488365,"[1, 1, 0, 1, 0, 0, 0, 0, 0, 1]"
18556,1,1,2,0.9852647655746563,"[0, 0, 1, 1, 0, 1, 1, 0, 0, 1]"
18557,1,1,2,0.4382134143372416,"[1, 1, 0, 1, 0, 1, 1, 1, 0, 0]"
18558,1,1,2,0.8957125759361936,"[0, 1, 1, 1, 0, 0, 0, 0, 0, 0]"
18559,1,1,2,0.901578302809245,"[1, 0, 0, 0, 0, 0, 0, 0, 0, 1]"
18560,1,1,2,0.28786951827853646,"[1, 1, 1, 0, 1, 0, 1, 1, 0, 0]"
18561,1,1,2,0.7817978108540968,"[0, 0, 1, 0, 1, 1, 1, 0, 1, 1]"
18562,2,2,4,0.38474651561136064,"[0, 1, 0, 1, 0, 1, 1, 0, 1, 0]"
18563,1,1,2,0.8521108462578817,"[1, 1, 1, 0, 1, 0, 1, 0, 0, 1]"
18564,1,1,2,0.803314030016421,"[0, 1, 0, 0, 0, 1, 1, 0, 1, 0]"
18565,1,1,2,0.6016762487816523,"[1, 1, 1, 0, 0, 1, 0, 0, 0, 1]"
18566,1,1,2,0.9291980885487006,"[0, 1, 1, 1, 1, 0, 1, 1, 1, 0]"
18567,1,1,2,0.9485372787439155,"[0, 0, 0, 0, 0, 1, 1, 0, 0, 0]"
18568,1,1,2,0.02849798887108901,"[0, 1, 0, 0, 0, 1, 0, 1, 1, 1]"
18569,1,1,2,0.7575336727944637,"[0, 1, 1, 0, 1, 1, 0, 1, 0, 1]"
18570,1,1,2,0.3707092870380375,"[1, 0, 0, 1, 1, 1, 1, 0, 0, 1]"
18571,1,1,2,0.10870537166220084,"[0, 0, 0, 0, 0, 1, 0, 0, 0, 1]"
18572,1,1,2,0.508891950678212,"[0, 1, 0, 1, 1, 1, 0, 0, 1, 1]"
18573,1,1,2,0.7932083844580295,"[0, 0, 1, 0, 0, 1, 0, 0, 0, 0]"
18574,1,1,2,0.8167787256674715,"[0, 0, 0, 1, 1, 1, 1, 1, 1, 0]"
18575,2,2,4,0.36935007580964585,"[0, 1, 1, 0, 1, 0, 1, 1, 1, 0]"
18576,1,1,2,0.843190373223667,"[1, 1, 0, 0, 0, 1, 1, 0, 0, 1]"
18577,1,1,2,0.9235521016655528,"[1, 1, 1, 0, 1, 0, 1, 0, 1, 1]"
18578,1,1,2,0.8681355715369579,"[1, 0, 1, 0, 0, 0, 0, 1, 1, 1]"
18579,1,1,2,0.3161331585067033,"[1, 1, 0, 1, 1, 0, 1, 0, 1, 0]"
18580,1,1,2,0.5049370254631159,"[0, 0, 0, 1, 0, 0, 1, 1, 1, 0]"
18581,1,1,2,0.7521360012540567,"[1, 0, 0, 1, 0, 0, 0, 0, 0, 0]"
18582,1,1,2,0.08050867919785554,"[1, 0, 0, 1, 0, 0, 1, 1, 1, 0]"
18583,1,1,2,0.5985936171481029,"[1, 1, 0, 0, 0, 0, 0, 1, 0, 1]"
18584,1,1,2,0.8912642720734473,"[1, 0, 1, 0, 0, 1, 1, 0, 0, 1]"
18585,1,1,2,0.525133993796496,"[1, 0, 0, 1, 0, 0, 1, 1, 0, 0]"
18586,1,1,2,0.31225351296068904,"[1, 0, 1, 1, 0, 0, 1, 1, 0, 1]"
18587,1,1,2,0.5014718521315245,"[0, 1, 0, 0, 1, 0, 0, 1, 0, 1]"
18588,1,1,2,0.9408231195889295,"[0, 0, 1, 0, 0, 1, 0, 1, 1, 0]"
18589,1,1,2,0.6223629318985306,"[1, 1, 0, 1, 1, 1, 1, 1, 0, 1]"
18590,1,1,2,0.9950804340001719,"[0, 0, 1, 1, 0, 0, 0, 1, 0, 1]"
18591,1,1,2,0.22752907576739922,"[0, 0, 0, 1, 0, 1, 0, 0, 1, 1]"
18592,2,2,4,0.7773833184949256,"[1, 0, 1, 1, 0, 1, 0, 1, 0, 1]"
18593,1,1,2,0.33067718109524213,"[0, 1, 0, 0, 0, 0, 0, 1, 0, 1]"
18594,1,1,2,0.8792657457998062,"[0, 0, 0, 0, 0, 0, 0, 1, 1, 1]"
18595,1,1,2,0.5258669664181072,"[1, 0, 0, 0, 1, 1, 1, 1, 0, 0]"
18596,2,2,4,0.5330694042486543,"[1, 1, 0, 1, 0, 0, 1, 1, 1, 1]"
18597,1,1,2,0.3826129175521057,"[0, 0, 1, 0, 0, 1, 1, 0, 1, 1]"
18598,1,1,2,0.8642347757544332,"[0, 1, 0, 0, 1, 1, 1, 1, 1, 0]"
18599,1,1,2,0.6045628192142275,"[1, 1, 0, 0, 0, 0, 1, 1, 1, 0]"
18600,1,1,2,0.2346444106086818,"[0, 1, 1, 1, 0, 0, 0, 0, 0, 1]"
18601,1,1,2,0.9065188704894213,"[1, 0, 0, 1, 1, 1, 0, 0, 1, 0]"
18602,1,1,2,0.5183400722766508,"[1, 0, 1, 1, 1, 1, 1, 1, 0, 1]"
18603,1,1,2,0.2692920660606134,"[1, 1, 1, 0, 1, 1, 1, 0, 0, 1]"
18604,1,1,2,0.7890458554028479,"[1, 0, 1, 0, 0, 0, 1, 0, 0, 0]"
18605,1,1,2,0.7565490835297944,"[0, 0, 0, 0, 0, 0, 0, 0, 1, 1]"
18606,1,1,2,0.8746998733487243,"[1, 0, 0, 1, 0, 0, 1, 0, 1, 1]"
18607,1,1,2,0.173346991839623,"[0, 0, 0, 0, 0, 0, 1, 1, 0, 0]"
18608,1,1,2,0.7633883459847072,"[1, 0, 1, 1, 0, 1, 0, 0, 0, 0]"
18609,1,1,2,0.9174893661763649,"[0, 0, 0, 0, 1, 1, 1, 1, 0, 1]"
18610,1,1,2,0.9136878629566382,"[0, 0, 1, 1, 0, 0, 0, 0, 0, 0]"
18611,1,1,2,0.6200258556097117,"[0, 0, 0, 1, 1, 0, 0, 0, 1, 1]"
18612,1,1,2,0.9784850011878032,"[1, 0, 1, 1, 1, 0, 1, 0, 0, 1]"
18613,1,1,2,0.9539439843509477,"[1, 0, 1, 1, 1, 1, 0, 0, 0, 1]"
18614,1,1,2,0.39791695966854,"[0, 0, 0, 1, 0, 0, 0, 1, 0, 0]"
18615,1,1,2,0.8198243269051431,"[0, 1, 1, 1, 1, 0, 0, 0, 1, 1]"
18616,1,1,2,0.9736609761586057,"[1, 1, 0, 1, 1, 1, 0, 1, 0, 0]"
18617,1,1,2,0.9983256067715485,"[0, 0, 0, 1, 0, 1, 0, 1, 1, 0]"
18618,1,1,2,0.6816416794227936,"[1, 0, 1, 0, 1, 0, 1, 0, 1, 0]"
18619,1,1,2,0.37799003572161094,"[0, 0, 1, 1, 0, 1, 0, 0, 1, 1]"
18620,1,1,2,0.947078923126589,"[1, 1, 0, 0, 0, 0, 1, 1, 0, 1]"
18621,1,1,2,0.7204746271804523,"[1, 1, 0, 1, 1, 0, 0, 1, 1, 1]"
18622,1,1,2,0.9283752868801075,"[0, 1, 1, 1, 1, 0, 0, 1, 0, 0]"
18623,1,1,2,0.2858441339568155,"[0, 1, 1, 0, 0, 0, 1, 1, 1, 0]"
18624,1,1,2,0.9305344237943238,"[1, 0, 0, 0, 0, 0, 1, 0, 0, 0]"
18625,1,1,2,0.20102724486341295,"[1, 0, 0, 1, 1, 0, 1, 0, 0, 0]"
18626,1,1,2,0.0750246638079789,"[0, 1, 1, 1, 0, 0, 0, 0, 0, 0]"
18627,1,1,2,0.853884666977181,"[1, 0, 1, 0, 1, 0, 1, 0, 1, 0]"
18628,1,1,2,0.28622278157062864,"[0, 1, 0, 0, 1, 1, 1, 0, 0, 1]"
18629,1,1,2,0.7052068845084032,"[1, 1, 1, 0, 0, 0, 1, 0, 1, 1]"
18630,1,1,2,0.5008391369108061,"[1, 0, 0, 0, 1, 1, 1, 1, 1, 0]"
18631,1,1,2,0.9783281528204454,"[1, 0, 0, 1, 0, 0, 0, 1, 1, 1]"
18632,1,1,2,0.7259024580018453,"[1, 0, 0, 1, 0, 0, 0, 1, 1, 0]"
18633,1,1,2,0.7302104969290464,"[0, 1, 1, 0, 1, 1, 1, 1, 0, 1]"
18634,1,1,2,0.8639024390533971,"[1, 0, 0, 0, 0, 1, 0, 0, 1, 0]"
18635,1,1,2,0.72928817023404,"[0, 1, 0, 1, 0, 0, 1, 1, 0, 1]"
18636,1,1,2,0.9312928985245391,"[1, 1, 0, 0, 0, 1, 0, 0, 1, 1]"
18637,1,1,2,0.7511885959757141,"[0, 0, 0, 0, 0, 0, 0, 1, 1, 0]"
18638,1,1,2,0.679808033932012,"[1, 0, 0, 0, 0, 0, 1, 0, 0, 0]"
18639,1,1,2,0.5201009491516672,"[1, 0, 0, 0, 1, 1, 1, 0, 1, 1]"
18640,1,1,2,0.6780698679638496,"[1, 1, 0, 1, 0, 1, 0, 1, 1, 1]"
18641,1,1,2,0.9858793214084064,"[0, 1, 1, 0, 1, 1, 1, 0, 0, 1]"
18642,1,1,2,0.44863410293310935,"[0, 1, 1, 0, 1, 1, 1, 1, 0, 0]"
18643,1,1,2,0.032124612569794375,"[1, 0, 0, 0, 0, 0, 0, 1, 0, 0]"
18644,1,1,2,0.5068205733116569,"[1, 0, 1, 0, 0, 0, 0, 1, 1, 1]"
18645,1,1,2,0.6437934239710016,"[1, 1, 1, 1, 1, 0, 0, 0, 1, 0]"
18646,1,1,2,0.5250751330865466,"[1, 1, 0, 1, 1, 0, 1, 0, 1, 1]"
18647,1,1,2,0.7766838550300692,"[1, 0, 1, 1, 0, 0, 1, 0, 1, 0]"
18648,1,1,2,0.769611531438152,"[0, 1, 0, 0, 1, 1, 0, 1, 0, 0]"
18649,1,1,2,0.38547521803512563,"[0, 0, 1, 1, 1, 0, 1, 1, 0, 1]"
18650,1,1,2,0.8470763793912611,"[1, 1, 1, 1, 0, 1, 0, 0, 1, 0]"
18651,1,1,2,0.14307369833554306,"[0, 0, 0, 0, 0, 0, 1, 0, 1, 0]"
18652,1,1,2,0.17634296202696176,"[1, 0, 0, 0, 0, 1, 0, 0, 1, 1]"
18653,1,1,2,0.016524801471411554,"[1, 0, 0, 1, 0, 1, 0, 0, 0, 1]"
18654,1,1,2,0.9198587820640651,"[0, 0, 0, 1, 1, 1, 0, 1, 1, 1]"
18655,1,1,2,0.4838615755998993,"[1, 1, 1, 0, 0, 1, 0, 1, 0, 0]"
18656,1,1,2,0.9790411409390398,"[1, 1, 0, 0, 1, 1, 0, 0, 0, 0]"
18657,1,1,2,0.37040317935687117,"[0, 0, 1, 1, 1, 0, 1, 1, 0, 1]"
18658,1,1,2,0.31619675324631935,"[1, 1, 0, 1, 0, 1, 1, 1, 0, 0]"
18659,1,1,2,0.20770713316784362,"[0, 0, 1, 0, 1, 0, 1, 1, 0, 0]"
18660,1,1,2,0.7901786915995246,"[0, 0, 1, 1, 1, 1, 0, 0, 1, 0]"
18661,1,1,2,0.04383334183265797,"[1, 1, 0, 1, 0, 1, 1, 0, 0, 1]"
18662,1,1,2,0.5887949030602121,"[1, 0, 0, 1, 0, 0, 0, 1, 1, 0]"
18663,1,1,2,0.8157302180019864,"[1, 0, 1, 1, 0, 0, 0, 1, 0, 0]"
18664,1,1,2,0.9475258473714896,"[1, 0, 1, 1, 0, 0, 0, 1, 1, 0]"
18665,1,1,2,0.8352516422804842,"[1, 0, 0, 0, 0, 1, 1, 1, 0, 0]"
18666,1,1,2,0.3541421734180231,"[0, 0, 1, 0, 1, 1, 0, 0, 0, 1]"
18667,1,1,2,0.9147528919093896,"[0, 0, 1, 1, 0, 1, 1, 0, 0, 1]"
18668,1,1,2,0.9082094396460962,"[0, 0, 1, 1, 1, 0, 1, 1, 1, 1]"
18669,1,1,2,0.17968824183406018,"[1, 0, 0, 1, 1, 1, 1, 0, 1, 0]"
18670,1,1,2,0.41243458279732037,"[1, 1, 0, 1, 0, 1, 1, 1, 1, 0]"
18671,1,1,2,0.699205536488108,"[1, 1, 1, 0, 1, 1, 0, 1, 1, 1]"
18672,1,1,2,0.30461711390564095,"[0, 0, 0, 0, 0, 1, 0, 0, 0, 0]"
18673,1,1,2,0.7287165703884241,"[0, 0, 0, 0, 0, 1, 1, 1, 1, 0]"
18674,1,1,2,0.4509411599579569,"[1, 1, 1, 1, 1, 0, 1, 0, 0, 1]"
18675,1,1,2,0.09085843587884956,"[0, 0, 1, 0, 0, 1, 0, 1, 0, 0]"
18676,1,1,2,0.9647835470137757,"[1, 1, 1, 0, 0, 1, 1, 1, 1, 1]"
18677,1,1,2,0.4790794934387561,"[0, 1, 1, 0, 0, 1, 0, 1, 1, 0]"
18678,1,1,2,0.025007628317576636,"[0, 0, 0, 0, 1, 0, 1, 1, 1, 1]"
18679,2,2,4,0.7641677954309575,"[0, 1, 0, 1, 0, 0, 1, 0, 1, 0]"
18680,1,1,2,0.9627006296346714,"[0, 1, 1, 1, 0, 1, 1, 0, 0, 0]"
18681,1,1,2,0.23046943194645042,"[1, 0, 1, 0, 0, 1, 0, 1, 1, 1]"
18682,1,1,2,0.013155317663019583,"[1, 1, 0, 1, 1, 0, 1, 0, 0, 0]"
18683,1,1,2,0.5255090913461088,"[0, 1, 1, 1, 1, 1, 0, 0, 1, 1]"
18684,1,1,2,0.5526225614034146,"[1, 0, 0, 1, 0, 0, 1, 0, 0, 1]"
18685,1,1,2,0.8384985580916429,"[1, 1, 0, 1, 1, 1, 1, 1, 0, 1]"
18686,1,1,2,0.8402784218357433,"[0, 0, 0, 1, 0, 1, 0, 1, 0, 1]"
18687,1,1,2,0.24446230546952386,"[1, 0, 1, 1, 0, 0, 0, 0, 1, 1]"
18688,1,1,2,0.3217940723192889,"[0, 1, 0, 0, 1, 0, 1, 0, 0, 1]"
18689,1,1,2,0.3701197683767963,"[0, 0, 0, 0, 1, 1, 0, 1, 0, 0]"
18690,1,1,2,0.8260175138196058,"[1, 1, 1, 0, 0, 1, 0, 1, 1, 1]"
18691,1,1,2,0.5585294696289762,"[1, 1, 1, 0, 0, 0, 1, 1, 1, 0]"
18692,1,1,2,0.1515238336642698,"[0, 1, 0, 0, 0, 0, 1, 0, 1, 0]"
18693,1,1,2,0.07585956495915358,"[0, 0, 0, 0, 0, 1, 0, 0, 0, 0]"
18694,1,1,2,0.9003147231190272,"[1, 1, 1, 0, 0, 1, 0, 0, 0, 0]"
18695,1,1,2,0.06790473202606973,"[0, 1, 1, 0, 1, 0, 1, 0, 1, 0]"
18696,1,1,2,0.7011976454939111,"[1, 0, 0, 0, 0, 0, 1, 0, 1, 1]"
18697,1,1,2,0.8486193086377515,"[0, 1, 1, 1, 0, 0, 0, 1, 1, 1]"
18698,1,1,2,0.8822822818317668,"[0, 1, 1, 1, 0, 1, 1, 0, 0, 0]"
18699,1,1,2,0.7168809719186989,"[1, 0, 0, 0, 0, 0, 0, 0, 0, 0]"
18700,1,1,2,0.7530961181834845,"[1, 0, 1, 1, 1, 0, 0, 1, 0, 1]"
18701,1,1,2,0.7670885554669904,"[0, 1, 1, 1, 1, 1, 0, 0, 1, 1]"
18702,1,1,2,0.09863767907927923,"[0, 0, 0, 0, 1, 0, 0, 0, 1, 1]"
18703,1,1,2,0.5606241371447239,"[1, 1, 1, 1, 0, 0, 0, 0, 1, 0]"
18704,2,2,4,0.8437404389959435,"[1, 1, 0, 1, 1, 0, 0, 0, 1, 0]"
18705,1,1,2,0.9109914112003207,"[0, 0, 0, 0, 0, 0, 1, 1, 0, 0]"
18706,1,1,2,0.25571142489734133,"[1, 1, 1, 0, 0, 0, 0, 0, 1, 0]"
18707,1,1,2,0.13123973172023817,"[1, 0, 1, 1, 0, 1, 0, 0, 0, 1]"
18708,1,1,2,0.9506301894693598,"[0, 0, 1, 0, 1, 0, 0, 1, 1, 0]"
18709,1,1,2,0.7266695905003769,"[1, 0, 1, 0, 1, 0, 0, 0, 0, 0]"
18710,1,1,2,0.034766572992764866,"[1, 0, 0, 1, 0, 0, 0, 0, 1, 1]"
18711,1,1,2,0.8484378361236713,"[0, 1, 1, 1, 0, 1, 1, 0, 1, 0]"
18712,1,1,2,0.43017584243345575,"[1, 0, 1, 1, 0, 0, 1, 0, 0, 0]"
18713,1,1,2,0.5795636806800459,"[1, 0, 1, 1, 0, 1, 1, 0, 1, 0]"
18714,1,1,2,0.7964908799877759,"[1, 1, 0, 0, 1, 1, 1, 0, 0, 0]"
18715,1,1,2,0.5880843251072441,"[1, 0, 1, 1, 0, 1, 0, 0, 0, 0]"
18716,1,1,2,0.1390868143602677,"[1, 1, 0, 0, 1, 0, 1, 0, 1, 0]"
18717,1,1,2,0.6668523911877123,"[0, 1, 0, 1, 0, 0, 1, 1, 1, 1]"
18718,1,1,2,0.3044644168097792,"[0, 0, 1, 0, 1, 0, 0, 1, 1, 1]"
18719,1,1,2,0.31037278962027426,"[1, 0, 1, 0, 0, 1, 1, 0, 0, 1]"
18720,1,1,2,0.5266375405695198,"[0, 1, 1, 0, 0, 0, 1, 0, 0, 0]"
18721,1,1,2,0.301653821233445,"[0, 1, 1, 0, 1, 1, 1, 0, 0, 0]"
18722,1,1,2,0.4403298963011001,"[1, 0, 1, 1, 0, 0, 1, 0, 0, 1]"
18723,1,1,2,0.8332869021946295,"[1, 1, 0, 0, 0, 0, 1, 0, 1, 0]"
18724,1,1,2,0.12652947082213983,"[0, 0, 0, 0, 0, 0, 1, 0, 1, 1]"
18725,1,1,2,0.41954328419396203,"[1, 1, 1, 1, 1, 0, 1, 1, 0, 0]"
18726,2,2,4,0.9746412820342156,"[0, 0, 0, 0, 1, 1, 1, 1, 1, 1]"
18727,1,1,2,0.5199209332673266,"[0, 0, 0, 1, 0, 1, 0, 0, 0, 1]"
18728,1,1,2,0.8046499494653947,"[0, 0, 0, 0, 0, 1, 1, 0, 0, 1]"
18729,1,1,2,0.8415551343996809,"[1, 0, 1, 0, 0, 0, 0, 0, 1, 1]"
18730,1,1,2,0.5612343067831453,"[0, 1, 1, 0, 1, 1, 0, 1, 1, 1]"
18731,1,1,2,0.12066466731675496,"[1, 0, 1, 1, 1, 0, 1, 0, 1, 1]"
18732,1,1,2,0.4005570378081539,"[1, 1, 0, 0, 1, 1, 0, 0, 1, 0]"
18733,2,2,4,0.41842548748494646,"[1, 1, 0, 1, 1, 1, 1, 0, 0, 1]"
18734,1,1,2,0.6904079985000183,"[1, 1, 1, 0, 0, 0, 0, 1, 0, 1]"
18735,1,1,2,0.4224293576530157,"[1, 1, 0, 0, 0, 0, 0, 0, 0, 0]"
18736,1,1,2,0.45379160389897133,"[1, 0, 1, 0, 0, 1, 0, 1, 1, 1]"
18737,1,1,2,0.7403205515178615,"[1, 1, 1, 0, 0, 1, 0, 1, 0, 0]"
18738,1,1,2,0.38021068125729396,"[1, 0, 0, 0, 1, 1, 1, 0, 1, 0]"
18739,1,1,2,0.785141102937012,"[0, 0, 0, 0, 1, 1, 0, 1, 1, 1]"
18740,1,1,2,0.8020392561807173,"[0, 0, 0, 1, 0, 1, 0, 0, 1, 0]"
18741,1,1,2,0.889014983762779,"[1, 0, 1, 1, 0, 1, 0, 0, 0, 0]"
18742,1,1,2,0.298996554972741,"[0, 1, 0, 1, 1, 0, 1, 1, 0, 0]"
18743,1,1,2,0.18901117287827118,"[1, 1, 0, 0, 0, 1, 0, 1, 0, 0]"
18744,1,1,2,0.06786090228762365,"[1, 0, 1, 1, 1, 0, 1, 1, 0, 1]"
18745,1,1,2,0.5676141933810339,"[1, 0, 1, 1, 1, 0, 1, 1, 0, 1]"
18746,1,1,2,0.39995693886959593,"[1, 0, 1, 0, 1, 1, 0, 0, 1, 1]"
18747,1,1,2,0.8913510980253155,"[1, 0, 0, 0, 0, 1, 1, 1, 0, 1]"
18748,1,1,2,0.6188358288209631,"[1, 1, 1, 0, 1, 1, 0, 1, 1, 0]"
18749,1,1,2,0.6134890394950966,"[0, 1, 0, 1, 1, 1, 0, 1, 1, 0]"
18750,1,1,2,0.1672471303698405,"[0, 1, 0, 0, 1, 0, 0, 1, 1, 0]"
18751,1,1,2,0.9233998058278136,"[0, 1, 1, 0, 1, 1, 0, 1, 1, 1]"
18752,1,1,2,0.09154195306703794,"[1, 1, 1, 0, 0, 0, 1, 0, 1, 0]"
18753,1,1,2,0.6894903749159152,"[1, 0, 1, 0, 0, 1, 0, 0, 0, 0]"
18754,1,1,2,0.017021366676874372,"[0, 1, 0, 0, 1, 1, 1, 1, 0, 0]"
18755,2,2,4,0.33152707050649677,"[1, 1, 0, 1, 0, 1, 0, 1, 1, 1]"
18756,1,1,2,0.9476857931109582,"[0, 1, 0, 1, 1, 0, 0, 0, 0, 0]"
18757,1,1,2,0.1862938897095513,"[0, 0, 0, 0, 0, 1, 1, 0, 1, 0]"
18758,1,1,2,0.9534706427363658,"[0, 0, 0, 0, 1, 1, 1, 1, 0, 0]"
18759,1,1,2,0.28509490057963316,"[1, 0, 1, 0, 0, 1, 0, 0, 0, 0]"
18760,1,1,2,0.5153062909388422,"[1, 1, 1, 1, 1, 1, 0, 0, 1, 1]"
18761,1,1,2,0.3998339279132862,"[0, 1, 1, 1, 1, 1, 0, 0, 0, 1]"
18762,1,1,2,0.5230289938917435,"[1, 0, 0, 0, 0, 1, 1, 1, 0, 1]"
18763,1,1,2,0.4228013783962298,"[1, 0, 0, 1, 1, 1, 0, 0, 0, 1]"
18764,1,1,2,0.9916380516506519,"[0, 0, 0, 0, 1, 1, 0, 1, 1, 1]"
18765,1,1,2,0.6674341925236424,"[1, 1, 0, 0, 0, 1, 1, 0, 1, 0]"
18766,1,1,2,0.31691231516361396,"[0, 0, 0, 1, 1, 0, 1, 0, 1, 1]"
18767,1,1,2,0.37443221781743974,"[0, 1, 1, 1, 1, 1, 0, 0, 0, 0]"
18768,1,1,2,0.5345220896609347,"[1, 1, 1, 1, 0, 1, 1, 1, 0, 0]"
18769,1,1,2,0.8959010157682584,"[1, 0, 0, 1, 1, 1, 1, 1, 0, 0]"
18770,1,1,2,0.621731630456965,"[0, 0, 0, 1, 1, 1, 0, 0, 1, 0]"
18771,1,1,2,0.8077454454707529,"[0, 1, 0, 0, 0, 0, 1, 1, 1, 1]"
18772,1,1,2,0.2903805449474891,"[1, 1, 0, 1, 1, 1, 0, 1, 0, 0]"
18773,1,1,2,0.5346375404544546,"[0, 0, 0, 0, 1, 0, 0, 1, 1, 1]"
18774,1,1,2,0.4889012798864537,"[1, 1, 0, 0, 1, 0, 0, 0, 0, 0]"
18775,1,1,2,0.9675169276775779,"[0, 0, 0, 1, 0, 1, 0, 1, 1, 0]"
18776,1,1,2,0.9256350965358459,"[0, 0, 1, 0, 0, 0, 1, 0, 1, 0]"
18777,1,1,2,0.20989778159376882,"[0, 0, 0, 1, 0, 1, 0, 1, 1, 0]"
18778,1,1,2,0.6202846573888803,"[1, 1, 0, 0, 0, 1, 1, 1, 1, 0]"
18779,1,1,2,0.597241250231505,"[1, 1, 0, 1, 0, 1, 0, 0, 1, 0]"
18780,1,1,2,0.5979809343094211,"[0, 0, 0, 0, 1, 0, 0, 1, 0, 0]"
18781,1,1,2,0.6006066966365183,"[1, 1, 1, 0, 0, 0, 0, 0, 0, 1]"
18782,1,1,2,0.32155945371569283,"[1, 1, 1, 0, 1, 0, 1, 1, 1, 1]"
18783,1,1,2,0.15274021691665685,"[1, 1, 1, 1, 1, 0, 0, 0, 1, 0]"
18784,1,1,2,0.4564584590411742,"[1, 0, 1, 1, 0, 0, 1, 1, 1, 0]"
18785,1,1,2,0.6164953450236332,"[0, 1, 0, 0, 0, 0, 1, 1, 1, 1]"
18786,1,1,2,0.4943542600824625,"[0, 0, 1, 1, 0, 1, 0, 0, 0, 0]"
18787,1,1,2,0.2588752245223831,"[0, 0, 0, 0, 1, 0, 0, 0, 1, 0]"
18788,1,1,2,0.8937140903248273,"[1, 1, 0, 0, 1, 1, 1, 1, 1, 0]"
18789,1,1,2,0.12001242007040525,"[0, 0, 0, 1, 0, 0, 1, 0, 0, 0]"
18790,1,1,2,0.7855595697284466,"[0, 1, 0, 0, 1, 1, 0, 0, 1, 1]"
18791,1,1,2,0.9568677410313203,"[1, 0, 0, 0, 0, 0, 1, 1, 0, 0]"
18792,1,1,2,0.8880649039087506,"[1, 0, 0, 0, 0, 0, 1, 1, 1, 1]"
18793,1,1,2,0.27650725829988354,"[1, 1, 0, 1, 0, 1, 1, 1, 0, 1]"
18794,1,1,2,0.338483202483124,"[1, 0, 1, 0, 1, 1, 0, 0, 1, 0]"
18795,1,1,2,0.8936630194828519,"[1, 0, 1, 0, 1, 0, 0, 1, 1, 1]"
18796,1,1,2,0.7194264838040654,"[0, 0, 0, 0, 0, 1, 1, 0, 1, 1]"
18797,1,1,2,0.4487693988387741,"[1, 0, 0, 0, 1, 0, 1, 1, 0, 1]"
18798,1,1,2,0.9580979733858768,"[0, 1, 0, 0, 0, 0, 1, 1, 1, 1]"
18799,1,1,2,0.31960456408047877,"[1, 0, 1, 1, 0, 1, 1, 0, 0, 1]"
18800,1,1,2,0.4960327624280436,"[0, 1, 0, 0, 0, 1, 1, 0, 0, 1]"
18801,1,1,2,0.6236186224366028,"[1, 0, 1, 0, 0, 1, 1, 0, 0, 1]"
18802,1,1,2,0.6622385371015053,"[0, 1, 0, 0, 0, 1, 1, 1, 1, 0]"
18803,1,1,2,0.9473564529123304,"[0, 0, 0, 0, 1, 1, 1, 0, 1, 0]"
18804,1,1,2,0.12108229362496314,"[1, 1, 0, 0, 0, 0, 1, 1, 1, 1]"
18805,1,1,2,0.6380382240116914,"[1, 0, 1, 0, 0, 1, 0, 1, 0, 1]"
18806,1,1,2,0.42113923208725756,"[1, 1, 1, 1, 0, 0, 0, 0, 1, 1]"
18807,1,1,2,0.19539084961937336,"[0, 0, 1, 0, 1, 1, 0, 0, 1, 0]"
18808,1,1,2,0.8634271380210344,"[0, 0, 1, 0, 1, 1, 0, 0, 1, 0]"
18809,1,1,2,0.529231186602706,"[0, 1, 1, 1, 0, 0, 0, 1, 1, 0]"
18810,1,1,2,0.5367755948220038,"[1, 0, 1, 1, 0, 0, 1, 0, 1, 1]"
18811,1,1,2,0.9157219111104038,"[0, 1, 0, 1, 0, 0, 0, 0, 0, 0]"
18812,1,1,2,0.6195779677896529,"[1, 1, 0, 1, 0, 1, 0, 0, 0, 0]"
18813,1,1,2,0.5134379319175102,"[0, 1, 0, 0, 0, 1, 1, 1, 1, 0]"
18814,1,1,2,0.8058911074045183,"[0, 1, 0, 1, 0, 0, 0, 1, 0, 1]"
18815,1,1,2,0.2898143997152287,"[1, 0, 0, 0, 0, 1, 0, 0, 0, 1]"
18816,1,1,2,0.9895201287461154,"[1, 1, 1, 1, 0, 0, 0, 1, 1, 1]"
18817,1,1,2,0.3745584437691525,"[0, 1, 1, 0, 1, 0, 1, 0, 1, 0]"
18818,1,1,2,0.26895807248212433,"[1, 0, 0, 0, 0, 0, 0, 0, 1, 0]"
18819,1,1,2,0.4024603211161295,"[0, 0, 1, 1, 1, 1, 0, 0, 1, 1]"
18820,1,1,2,0.23168096781451963,"[1, 0, 0, 0, 1, 0, 0, 1, 1, 1]"
18821,1,1,2,0.1682988979805482,"[0, 1, 1, 0, 1, 0, 1, 1, 0, 0]"
18822,1,1,2,0.5575788965262141,"[1, 1, 0, 0, 0, 1, 1, 1, 1, 0]"
18823,1,1,2,0.07190015826498974,"[1, 1, 1, 0, 0, 0, 0, 1, 0, 0]"
18824,1,1,2,0.8533955669857827,"[0, 1, 1, 1, 0, 0, 0, 0, 0, 0]"
18825,1,1,2,0.38959772263673953,"[0, 0, 0, 1, 0, 1, 0, 1, 0, 1]"
18826,1,1,2,0.5394845728056209,"[1, 0, 0, 0, 0, 1, 0, 1, 0, 0]"
18827,1,1,2,0.2190093233903917,"[0, 0, 0, 0, 1, 0, 0, 0, 0, 1]"
18828,1,1,2,0.13441479374252852,"[1, 0, 0, 0, 1, 1, 0, 0, 0, 1]"
18829,1,1,2,0.9712440165899109,"[1, 1, 0, 1, 1, 0, 0, 0, 0, 0]"
18830,1,1,2,0.7156912427179511,"[1, 1, 0, 0, 0, 0, 0, 1, 1, 0]"
18831,1,1,2,0.0036484410826980174,"[0, 1, 0, 0, 0, 1, 1, 0, 1, 1]"
18832,1,1,2,0.17538010540955484,"[1, 1, 0, 1, 1, 0, 0, 1, 0, 1]"
18833,1,1,2,0.2487956897221375,"[0, 1, 1, 1, 0, 1, 0, 1, 1, 1]"
18834,1,1,2,0.22763007024828996,"[0, 0, 0, 0, 1, 1, 1, 1, 0, 1]"
18835,1,1,2,0.06767279358805633,"[0, 0, 0, 1, 0, 1, 0, 1, 1, 0]"
18836,2,2,4,0.3743933691194007,"[0, 0, 1, 1, 1, 0, 1, 0, 0, 0]"
18837,1,1,2,0.07531925687687635,"[0, 0, 1, 0, 1, 1, 1, 0, 1, 1]"
18838,1,1,2,0.17950983754282657,"[0, 1, 1, 0, 0, 0, 1, 0, 1, 1]"
18839,1,1,2,0.019309168050343883,"[0, 0, 1, 1, 0, 1, 0, 1, 1, 1]"
18840,1,1,2,0.38751137930378254,"[0, 0, 0, 0, 0, 0, 0, 0, 1, 0]"
18841,2,2,4,0.07093146379570625,"[1, 0, 1, 0, 0, 1, 1, 1, 0, 0]"
18842,1,1,2,0.4279996979852849,"[1, 0, 0, 1, 1, 0, 0, 0, 1, 1]"
18843,1,1,2,0.9096744865246222,"[0, 0, 0, 0, 1, 1, 1, 1, 1, 1]"
18844,1,1,2,0.19728051872975483,"[0, 0, 1, 1, 1, 0, 1, 1, 1, 1]"
18845,1,1,2,0.6216191919755557,"[1, 1, 0, 1, 0, 0, 0, 0, 0, 0]"
18846,1,1,2,0.7850866883280244,"[1, 0, 1, 1, 0, 0, 0, 1, 0, 0]"
18847,1,1,2,0.6350068460094901,"[1, 0, 1, 0, 1, 1, 1, 1, 1, 1]"
18848,1,1,2,0.4428971586078344,"[1, 1, 1, 0, 0, 1, 1, 1, 1, 1]"
18849,1,1,2,0.8508751300312904,"[0, 1, 0, 1, 1, 0, 1, 0, 0, 1]"
18850,1,1,2,0.32265767940226064,"[1, 1, 0, 1, 0, 0, 1, 1, 0, 0]"
18851,1,1,2,0.2602702260830443,"[0, 1, 0, 0, 0, 1, 0, 0, 0, 0]"
18852,1,1,2,0.2776747987657924,"[0, 1, 1, 0, 1, 1, 1, 0, 0, 0]"
18853,1,1,2,0.7066073118698512,"[1, 1, 0, 0, 0, 1, 0, 1, 1, 0]"
18854,1,1,2,0.5922047836751794,"[0, 0, 0, 1, 1, 1, 0, 1, 1, 0]"
18855,1,1,2,0.26621325564023146,"[1, 1, 1, 1, 0, 0, 0, 1, 0, 1]"
18856,1,1,2,0.32715203990229946,"[1, 0, 1, 0, 1, 0, 1, 1, 0, 0]"
18857,1,1,2,0.5384102329521335,"[1, 1, 1, 0, 1, 0, 1, 1, 0, 1]"
18858,1,1,2,0.08589056365716707,"[0, 0, 0, 1, 1, 0, 1, 0, 0, 1]"
18859,1,1,2,0.04127511437269793,"[1, 1, 1, 1, 1, 0, 1, 1, 1, 1]"
18860,1,1,2,0.06672265208983075,"[1, 1, 0, 0, 0, 1, 1, 1, 0, 1]"
18861,1,1,2,0.33674852896995844,"[1, 0, 1, 0, 0, 0, 0, 1, 1, 1]"
18862,1,1,2,0.8681252132741196,"[0, 1, 0, 0, 0, 1, 0, 0, 0, 1]"
18863,1,1,2,0.6657056550551231,"[0, 1, 0, 0, 0, 1, 1, 1, 1, 1]"
18864,1,1,2,0.7717734829720314,"[0, 1, 1, 1, 0, 1, 1, 0, 1, 0]"
18865,1,1,2,0.8191326729825762,"[0, 1, 0, 0, 1, 0, 1, 0, 1, 0]"
18866,1,1,2,0.9126644091780457,"[0, 0, 0, 1, 1, 0, 1, 1, 1, 1]"
18867,1,1,2,0.9849624333963813,"[0, 1, 1, 0, 0, 0, 0, 0, 1, 0]"
18868,1,1,2,0.8382008822078176,"[0, 0, 0, 1, 1, 0, 0, 1, 0, 1]"
18869,1,1,2,0.11906308101376095,"[0, 1, 0, 0, 0, 1, 0, 1, 0, 0]"
18870,1,1,2,0.1491660077004925,"[1, 1, 1, 0, 0, 1, 1, 0, 1, 1]"
18871,1,1,2,0.5825496563266381,"[0, 0, 0, 1, 0, 1, 1, 0, 0, 0]"
18872,1,1,2,0.6343463146257015,"[1, 1, 0, 1, 0, 0, 0, 1, 1, 1]"
18873,1,1,2,0.4311199284317495,"[0, 1, 0, 1, 0, 0, 1, 0, 0, 1]"
18874,1,1,2,0.5571848058017838,"[1, 0, 1, 0, 1, 1, 1, 0, 1, 1]"
18875,1,1,2,0.2888851307410667,"[0, 0, 1, 0, 0, 1, 0, 1, 1, 1]"
18876,1,1,2,0.7561886278468087,"[0, 0, 0, 0, 1, 0, 1, 0, 1, 0]"
18877,1,1,2,0.3761539665716689,"[0, 0, 1, 0, 1, 1, 0, 0, 0, 0]"
18878,1,1,2,0.17615162367753034,"[0, 1, 0, 0, 1, 0, 1, 1, 1, 1]"
18879,1,1,2,0.5761062816482592,"[1, 1, 0, 1, 1, 0, 0, 0, 0, 1]"
18880,1,1,2,0.6764908775369206,"[0, 1, 1, 1, 1, 1, 1, 1, 0, 0]"
18881,1,1,2,0.27145861085202905,"[1, 1, 0, 1, 1, 1, 1, 1, 1, 0]"
18882,1,1,2,0.7102145906305638,"[1, 0, 1, 1, 0, 1, 1, 0, 1, 0]"
18883,1,1,2,0.8943452505596936,"[0, 0, 1, 1, 0, 0, 1, 0, 0, 1]"
18884,1,1,2,0.2327080423230814,"[0, 1, 0, 0, 1, 0, 1, 1, 1, 0]"
18885,1,1,2,0.30540853923854183,"[0, 0, 0, 1, 1, 1, 0, 0, 0, 0]"
18886,1,1,2,0.9785358666333437,"[0, 0, 0, 1, 0, 1, 1, 1, 0, 0]"
18887,1,1,2,0.36820938047766316,"[1, 0, 0, 1, 1, 1, 1, 0, 1, 0]"
18888,1,1,2,0.3462611129340146,"[1, 1, 0, 1, 1, 1, 1, 1, 0, 1]"
18889,1,1,2,0.9788626696019221,"[1, 0, 1, 0, 1, 1, 1, 1, 0, 0]"
18890,1,1,2,0.4907962204053047,"[0, 1, 1, 0, 1, 1, 1, 1, 1, 0]"
18891,1,1,2,0.8030839297574498,"[1, 1, 1, 1, 0, 1, 0, 1, 1, 1]"
18892,1,1,2,0.7728880183184371,"[0, 0, 0, 0, 1, 1, 1, 1, 1, 1]"
18893,1,1,2,0.4915163091383604,"[0, 1, 0, 1, 1, 0, 1, 1, 1, 0]"
18894,1,1,2,0.9147771069224447,"[0, 0, 1, 0, 0, 1, 0, 0, 1, 0]"
18895,1,1,2,0.4681550482043082,"[1, 0, 1, 1, 1, 0, 0, 1, 1, 0]"
18896,1,1,2,0.23430458265472554,"[0, 0, 1, 0, 0, 1, 1, 0, 0, 1]"
18897,1,1,2,0.5312023356362578,"[0, 0, 0, 1, 1, 1, 0, 0, 0, 0]"
18898,1,1,2,0.4620615795400357,"[1, 1, 0, 1, 0, 1, 1, 1, 1, 0]"
18899,1,1,2,0.69211716938629,"[0, 0, 1, 0, 1, 0, 1, 0, 1, 1]"
18900,1,1,2,0.9382269739824503,"[0, 0, 1, 1, 1, 0, 1, 0, 0, 0]"
18901,1,1,2,0.5803524772129641,"[0, 0, 1, 0, 1, 1, 0, 1, 0, 0]"
18902,1,1,2,0.22921072071558912,"[0, 0, 0, 0, 0, 1, 0, 1, 1, 1]"
18903,1,1,2,0.9548086886503223,"[1, 1, 0, 0, 1, 1, 0, 0, 1, 1]"
18904,1,1,2,0.25809887009866894,"[1, 0, 0, 1, 1, 0, 1, 1, 0, 0]"
18905,1,1,2,0.07917408235925849,"[0, 0, 1, 1, 0, 1, 1, 1, 1, 1]"
18906,1,1,2,0.7871029066524924,"[0, 0, 1, 1, 0, 1, 0, 1, 1, 1]"
18907,1,1,2,0.24283616330248536,"[0, 1, 0, 0, 0, 0, 1, 0, 0, 1]"
18908,1,1,2,0.3960915701673915,"[0, 0, 0, 1, 1, 1, 0, 0, 1, 1]"
18909,2,2,4,0.30287662560792705,"[1, 1, 0, 1, 1, 1, 0, 0, 1, 1]"
18910,1,1,2,0.9021311418362066,"[0, 1, 0, 1, 1, 0, 1, 0, 1, 1]"
18911,1,1,2,0.1658821369768232,"[0, 0, 1, 0, 1, 0, 1, 0, 1, 0]"
18912,1,1,2,0.6986198195601935,"[0, 1, 1, 0, 0, 1, 0, 0, 1, 0]"
18913,1,1,2,0.5044932235012667,"[0, 1, 0, 1, 0, 0, 1, 0, 1, 1]"
18914,1,1,2,0.9202335939660898,"[0, 1, 1, 1, 0, 0, 1, 1, 1, 1]"
18915,2,2,4,0.4417583938942179,"[1, 1, 1, 1, 0, 0, 0, 0, 1, 1]"
18916,1,1,2,0.4277994650167306,"[1, 1, 1, 1, 1, 1, 0, 0, 0, 0]"
18917,1,1,2,0.46408944934180385,"[0, 1, 0, 0, 1, 1, 1, 0, 0, 1]"
18918,1,1,2,0.1324416943699286,"[1, 1, 1, 0, 1, 0, 1, 1, 0, 1]"
18919,1,1,2,0.10285632099951636,"[0, 1, 0, 1, 0, 0, 1, 1, 0, 0]"
18920,1,1,2,0.7856366485016136,"[1, 0, 0, 0, 1, 1, 1, 1, 0, 0]"
18921,1,1,2,0.5323948046103332,"[0, 1, 0, 0, 1, 0, 0, 0, 1, 1]"
18922,1,1,2,0.6500375680479984,"[1, 0, 1, 0, 1, 1, 1, 1, 1, 0]"
18923,1,1,2,0.19454521321318008,"[0, 1, 1, 0, 0, 0, 1, 1, 1, 1]"
18924,1,1,2,0.7983362810157243,"[1, 1, 1, 1, 1, 1, 0, 1, 1, 0]"
18925,1,1,2,0.5860461853281306,"[1, 1, 1, 1, 1, 0, 0, 1, 1, 1]"
18926,1,1,2,0.03204688234441089,"[1, 1, 1, 0, 0, 0, 0, 1, 1, 0]"
18927,1,1,2,0.25462176541363846,"[0, 1, 1, 0, 1, 1, 0, 0, 0, 0]"
18928,1,1,2,0.20442442153908547,"[1, 0, 0, 0, 1, 1, 0, 1, 1, 1]"
18929,1,1,2,0.09888811382973295,"[1, 0, 1, 1, 1, 1, 0, 0, 1, 1]"
18930,1,1,2,0.8651530199215548,"[0, 0, 1, 1, 1, 1, 0, 0, 0, 0]"
18931,1,1,2,0.2376526957499513,"[1, 0, 0, 1, 0, 0, 0, 1, 0, 0]"
18932,1,1,2,0.8799348746497292,"[0, 1, 1, 1, 0, 1, 1, 1, 0, 1]"
18933,1,1,2,0.154724120145721,"[0, 0, 1, 1, 0, 1, 1, 0, 0, 0]"
18934,1,1,2,0.12286908123266527,"[0, 0, 1, 1, 1, 0, 0, 1, 0, 0]"
18935,1,1,2,0.17773733253976687,"[0, 1, 1, 0, 1, 0, 1, 0, 0, 1]"
18936,1,1,2,0.5213606112513924,"[0, 1, 1, 1, 1, 1, 0, 0, 1, 1]"
18937,1,1,2,0.3071570920810467,"[1, 1, 1, 1, 0, 1, 1, 1, 1, 1]"
18938,1,1,2,0.4594804578235059,"[0, 1, 1, 1, 1, 1, 0, 1, 1, 1]"
18939,1,1,2,0.08333200422998777,"[0, 1, 1, 1, 0, 1, 1, 0, 0, 1]"
18940,1,1,2,0.18210837032013782,"[0, 1, 0, 0, 0, 0, 1, 0, 0, 0]"
18941,1,1,2,0.8751752273853455,"[0, 0, 0, 0, 0, 1, 1, 1, 0, 0]"
18942,1,1,2,0.5353112605464277,"[1, 0, 0, 1, 0, 1, 0, 1, 0, 0]"
18943,1,1,2,0.4222261593985225,"[0, 1, 0, 1, 1, 0, 1, 1, 1, 1]"
18944,1,1,2,0.16797869820303757,"[1, 0, 0, 1, 1, 1, 0, 0, 1, 1]"
18945,1,1,2,0.7031040599882327,"[1, 0, 0, 1, 0, 1, 1, 1, 0, 0]"
18946,1,1,2,0.27987515852778144,"[0, 1, 0, 1, 0, 1, 0, 0, 0, 1]"
18947,1,1,2,0.5705366959733849,"[1, 0, 0, 0, 0, 1, 0, 0, 0, 0]"
18948,1,1,2,0.6583064543516282,"[1, 0, 0, 1, 1, 1, 1, 0, 1, 1]"
18949,1,1,2,0.13105112233584026,"[1, 0, 1, 1, 1, 0, 1, 0, 1, 1]"
18950,1,1,2,0.024457063657310485,"[1, 0, 0, 1, 0, 0, 1, 0, 0, 0]"
18951,1,1,2,0.5119304184886609,"[1, 0, 1, 0, 1, 0, 0, 1, 0, 1]"
18952,1,1,2,0.4867258286705115,"[1, 1, 0, 1, 1, 0, 1, 0, 1, 0]"
18953,1,1,2,0.5508752524715045,"[0, 1, 1, 1, 1, 0, 1, 0, 1, 1]"
18954,1,1,2,0.10140423929476938,"[0, 1, 0, 1, 0, 0, 0, 1, 1, 0]"
18955,1,1,2,0.7387594926646808,"[0, 1, 1, 0, 1, 1, 1, 0, 1, 0]"
18956,1,1,2,0.5966206505962017,"[1, 1, 0, 0, 1, 0, 0, 0, 0, 0]"
18957,1,1,2,0.24006342988369267,"[0, 0, 1, 1, 0, 0, 0, 0, 1, 0]"
18958,1,1,2,0.07376991702203861,"[1, 1, 1, 1, 1, 0, 1, 0, 0, 1]"
18959,1,1,2,0.11276412236422295,"[0, 1, 1, 1, 1, 0, 0, 1, 1, 0]"
18960,1,1,2,0.763667043224399,"[0, 0, 1, 1, 1, 0, 1, 1, 0, 0]"
18961,1,1,2,0.41772138997441033,"[0, 0, 1, 1, 1, 1, 1, 1, 1, 1]"
18962,1,1,2,0.3598165800684534,"[1, 0, 0, 0, 0, 1, 0, 1, 0, 0]"
18963,1,1,2,0.17190837638975454,"[1, 0, 0, 1, 0, 1, 0, 1, 0, 1]"
18964,1,1,2,0.889639425571788,"[0, 1, 1, 1, 0, 1, 0, 0, 1, 1]"
18965,1,1,2,0.5411135015426299,"[1, 1, 1, 0, 1, 1, 0, 0, 1, 1]"
18966,1,1,2,0.9502855318954081,"[0, 0, 0, 0, 1, 0, 1, 1, 0, 1]"
18967,1,1,2,0.18308399792733288,"[1, 0, 0, 0, 0, 1, 0, 1, 1, 0]"
18968,1,1,2,0.6445183535934821,"[0, 1, 0, 0, 1, 1, 1, 1, 0, 1]"
18969,1,1,2,0.7312691520956338,"[0, 1, 0, 0, 0, 0, 0, 0, 0, 1]"
18970,1,1,2,0.31458264358026566,"[0, 0, 0, 0, 1, 1, 0, 1, 0, 0]"
18971,1,1,2,0.4546773215982579,"[0, 1, 0, 0, 0, 1, 0, 1, 1, 0]"
18972,1,1,2,0.22612600452003218,"[0, 0, 1, 1, 1, 1, 0, 1, 1, 1]"
18973,1,1,2,0.40596949520748693,"[0, 1, 0, 0, 1, 0, 0, 1, 0, 1]"
18974,1,1,2,0.16657736947616952,"[0, 1, 0, 1, 0, 0, 0, 0, 1, 1]"
18975,1,1,2,0.5983159153800751,"[0, 1, 1, 1, 1, 1, 0, 1, 0, 0]"
18976,1,1,2,0.2859882374007926,"[0, 0, 1, 0, 1, 0, 1, 0, 1, 1]"
18977,1,1,2,0.6171130422951612,"[0, 0, 1, 0, 1, 0, 0, 1, 1, 1]"
18978,1,1,2,0.17394077058485347,"[1, 1, 1, 1, 1, 1, 0, 0, 1, 1]"
18979,1,1,2,0.8947619773581257,"[0, 0, 0, 0, 1, 1, 1, 0, 0, 1]"
18980,1,1,2,0.47914116365946313,"[1, 1, 1, 0, 0, 1, 1, 1, 0, 1]"
18981,1,1,2,0.009903865977347825,"[1, 0, 1, 0, 0, 1, 1, 1, 0, 1]"
18982,1,1,2,0.6354320584252249,"[0, 1, 0, 1, 1, 0, 0, 0, 1, 0]"
18983,1,1,2,0.4328916733582182,"[1, 1, 0, 0, 0, 1, 1, 1, 0, 1]"
18984,1,1,2,0.15428323723213078,"[1, 1, 1, 0, 0, 1, 1, 0, 1, 0]"
18985,1,1,2,0.6395049917066782,"[1, 0, 0, 0, 1, 1, 0, 0, 1, 1]"
18986,1,1,2,0.10485686209641354,"[1, 0, 0, 0, 0, 1, 0, 0, 1, 1]"
18987,1,1,2,0.3843819196990329,"[0, 1, 1, 0, 0, 1, 0, 1, 1, 0]"
18988,1,1,2,0.4969926277558253,"[1, 1, 1, 1, 1, 0, 0, 0, 0, 1]"
18989,1,1,2,0.4110783634136578,"[0, 0, 1, 0, 1, 0, 1, 1, 1, 1]"
18990,1,1,2,0.07102312745497541,"[1, 0, 1, 0, 1, 1, 0, 0, 1, 0]"
18991,1,1,2,0.19627816577393298,"[0, 1, 1, 0, 0, 0, 1, 1, 1, 0]"
18992,1,1,2,0.667110618812556,"[1, 0, 0, 1, 0, 0, 0, 0, 1, 1]"
18993,1,1,2,0.9674756596097291,"[1, 0, 0, 1, 1, 0, 0, 0, 1, 0]"
18994,1,1,2,0.6575569590918483,"[1, 0, 0, 0, 1, 1, 0, 1, 0, 1]"
18995,1,1,2,0.8554784164525598,"[1, 1, 1, 1, 1, 1, 0, 0, 1, 0]"
18996,1,1,2,0.9695934898956788,"[1, 1, 1, 0, 0, 0, 0, 0, 0, 1]"
18997,1,1,2,0.6581304175980338,"[1, 0, 1, 0, 0, 0, 1, 0, 1, 1]"
18998,1,1,2,0.8108589921526331,"[0, 1, 1, 1, 0, 1, 1, 1, 1, 1]"
18999,2,2,4,0.2570852930361952,"[0, 0, 1, 1, 1, 0, 1, 0, 1, 0]"
19000,1,1,2,0.3580198762898762,"[1, 0, 1, 0, 1, 0, 0, 0, 0, 1]"
19001,1,1,2,0.7251070672601171,"[1, 0, 0, 0, 1, 1, 1, 0, 0, 1]"
19002,1,1,2,0.5098131429302855,"[0, 0, 1, 0, 1, 0, 1, 1, 1, 0]"
19003,1,1,2,0.6331934853518285,"[1, 0, 1, 1, 1, 0, 0, 0, 1, 1]"
19004,1,1,2,0.04654677619851655,"[0, 0, 0, 0, 0, 1, 1, 1, 1, 1]"
19005,1,1,2,0.6739299963314165,"[1, 0, 0, 0, 0, 1, 0, 0, 0, 0]"
19006,1,1,2,0.07180501443133136,"[1, 0, 1, 1, 1, 1, 1, 1, 1, 0]"
19007,1,1,2,0.7760820690929963,"[1, 0, 1, 0, 1, 0, 1, 0, 0, 0]"
19008,1,1,2,0.17550436092816923,"[1, 1, 0, 1, 0, 0, 1, 0, 0, 1]"
19009,1,1,2,0.5523256369904733,"[1, 1, 0, 0, 1, 0, 0, 1, 1, 1]"
19010,1,1,2,0.36149228400793987,"[1, 0, 1, 0, 1, 1, 1, 1, 1, 1]"
19011,1,1,2,0.7062177070496577,"[1, 1, 0, 1, 1, 0, 1, 1, 0, 0]"
19012,1,1,2,0.21161883630102174,"[0, 1, 0, 0, 0, 1, 1, 1, 0, 1]"
19013,1,1,2,0.9065945384787146,"[0, 1, 0, 0, 0, 1, 0, 1, 1, 0]"
19014,1,1,2,0.7869096626308532,"[0, 0, 0, 1, 1, 1, 0, 1, 0, 1]"
19015,1,1,2,0.8981310303376668,"[0, 0, 1, 1, 1, 0, 1, 1, 1, 0]"
19016,1,1,2,0.7328713154109862,"[1, 1, 0, 0, 1, 1, 0, 1, 0, 0]"
19017,1,1,2,0.13023842171796873,"[1, 1, 1, 1, 1, 0, 0, 0, 0, 1]"
19018,1,1,2,0.2521207512622683,"[1, 1, 0, 0, 1, 1, 1, 1, 1, 1]"
19019,1,1,2,0.8666542959680387,"[0, 1, 0, 0, 0, 0, 0, 0, 0, 1]"
19020,1,1,2,0.5874913301493392,"[1, 1, 1, 1, 0, 1, 1, 0, 0, 1]"
19021,1,1,2,0.7015705517920053,"[1, 0, 0, 0, 0, 1, 0, 0, 1, 1]"
19022,1,1,2,0.7365919753827744,"[0, 1, 1, 1, 0, 1, 1, 0, 0, 0]"
19023,1,1,2,0.32482343615095266,"[0, 1, 0, 0, 1, 0, 0, 1, 1, 0]"
19024,1,1,2,0.11556937605105821,"[0, 0, 1, 1, 1, 1, 1, 0, 0, 1]"
19025,1,1,2,0.8022243725111847,"[0, 0, 0, 0, 0, 0, 1, 0, 0, 0]"
19026,1,1,2,0.6398944739937914,"[1, 1, 1, 0, 0, 1, 0, 0, 0, 0]"
19027,1,1,2,0.9867565117135185,"[1, 0, 0, 1, 1, 0, 1, 1, 1, 0]"
19028,1,1,2,0.10531070141261079,"[0, 1, 0, 1, 1, 0, 0, 0, 0, 1]"
19029,1,1,2,0.982276770664172,"[1, 1, 1, 0, 1, 0, 0, 1, 0, 1]"
19030,1,1,2,0.5920376159572113,"[0, 1, 0, 1, 0, 0, 1, 1, 1, 0]"
19031,1,1,2,0.5886203145785163,"[1, 1, 1, 1, 1, 1, 0, 0, 0, 1]"
19032,1,1,2,0.25259486067055326,"[0, 0, 0, 0, 0, 1, 1, 1, 1, 0]"
19033,1,1,2,0.5775252896397308,"[0, 1, 0, 0, 0, 1, 0, 0, 0, 1]"
19034,1,1,2,0.9455857642929323,"[1, 0, 1, 0, 0, 1, 0, 1, 0, 0]"
19035,1,1,2,0.03030977747162389,"[0, 1, 0, 0, 1, 0, 0, 1, 0, 0]"
19036,1,1,2,0.5228856211476358,"[0, 0, 1, 1, 0, 1, 1, 0, 0, 1]"
19037,1,1,2,0.1082586514327355,"[1, 0, 0, 0, 0, 0, 0, 0, 0, 0]"
19038,1,1,2,0.6610459687203708,"[0, 1, 1, 1, 0, 1, 1, 0, 0, 0]"
19039,1,1,2,0.9373295652046914,"[0, 1, 0, 0, 1, 1, 0, 1, 0, 1]"
19040,1,1,2,0.45724238963873975,"[0, 0, 0, 0, 1, 0, 0, 0, 0, 1]"
19041,1,1,2,0.05759213916882355,"[1, 1, 1, 0, 1, 0, 1, 0, 1, 1]"
19042,1,1,2,0.1081900063604081,"[1, 0, 0, 0, 0, 0, 0, 0, 0, 1]"
19043,1,1,2,0.02319143151535208,"[1, 1, 1, 1, 1, 1, 1, 1, 1, 1]"
19044,1,1,2,0.734090215859479,"[0, 0, 0, 0, 1, 1, 0, 0, 1, 1]"
19045,1,1,2,0.25034344008807885,"[1, 1, 1, 0, 0, 0, 1, 0, 0, 0]"
19046,1,1,2,0.6600402373218668,"[0, 0, 1, 1, 1, 0, 1, 1, 1, 1]"
19047,1,1,2,0.8866495034244871,"[1, 1, 0, 1, 0, 0, 1, 1, 0, 1]"
19048,1,1,2,0.71528448332275,"[0, 0, 1, 0, 0, 1, 1, 0, 0, 1]"
19049,1,1,2,0.9501901641247786,"[1, 1, 0, 0, 0, 1, 0, 0, 0, 0]"
19050,1,1,2,0.9144835590719254,"[0, 1, 1, 1, 0, 0, 1, 1, 0, 0]"
19051,1,1,2,0.4795466100418332,"[0, 1, 1, 1, 0, 0, 0, 1, 1, 0]"
19052,1,1,2,0.2396052327566125,"[0, 1, 1, 0, 1, 1, 1, 0, 1, 0]"
19053,1,1,2,0.55960374613037,"[1, 1, 1, 0, 0, 1, 1, 1, 1, 1]"
19054,1,1,2,0.42916350539723525,"[0, 1, 1, 1, 0, 0, 1, 0, 1, 1]"
19055,1,1,2,0.9656652933345015,"[1, 1, 0, 0, 0, 1, 1, 0, 1, 1]"
19056,1,1,2,0.11719211315699718,"[0, 0, 1, 1, 0, 0, 0, 1, 1, 0]"
19057,1,1,2,0.3832511417961594,"[1, 1, 1, 1, 0, 0, 1, 1, 0, 0]"
19058,1,1,2,0.7403120900091841,"[1, 0, 0, 1, 0, 1, 1, 0, 0, 0]"
19059,1,1,2,0.5604487064834889,"[1, 0, 0, 0, 0, 0, 0, 0, 0, 0]"
19060,1,1,2,0.17864066886565977,"[1, 1, 0, 1, 1, 1, 0, 1, 1, 1]"
19061,1,1,2,0.24094353655482004,"[1, 1, 0, 1, 1, 0, 1, 0, 1, 0]"
19062,1,1,2,0.07491513242248016,"[1, 1, 0, 0, 0, 1, 1, 1, 1, 0]"
19063,2,2,4,0.5171394892222893,"[1, 1, 1, 0, 1, 1, 0, 0, 0, 0]"
19064,1,1,2,0.7203748067012993,"[1, 0, 0, 1, 0, 1, 0, 1, 1, 1]"
19065,1,1,2,0.17486199282484627,"[0, 0, 1, 0, 0, 1, 1, 0, 1, 0]"
19066,1,1,2,0.2582076784871721,"[0, 1, 0, 0, 0, 1, 0, 0, 1, 1]"
19067,1,1,2,0.8724249501096244,"[0, 1, 1, 1, 0, 0, 1, 0, 0, 1]"
19068,1,1,2,0.12773697686326735,"[1, 1, 1, 1, 0, 0, 0, 0, 0, 1]"
19069,1,1,2,0.7047810045191121,"[0, 1, 1, 1, 0, 0, 1, 1, 0, 1]"
19070,1,1,2,0.45129807989583026,"[1, 1, 1, 1, 0, 1, 0, 0, 0, 1]"
19071,1,1,2,0.6400684639522324,"[1, 0, 0, 0, 1, 0, 0, 1, 1, 0]"
19072,1,1,2,0.8251312138167927,"[1, 0, 1, 0, 0, 1, 1, 0, 1, 1]"
19073,1,1,2,0.9747104869090141,"[1, 1, 0, 0, 1, 1, 0, 0, 0, 1]"
19074,1,1,2,0.43281633507675465,"[0, 0, 1, 0, 1, 0, 0, 1, 0, 1]"
19075,1,1,2,0.6923712162818293,"[1, 1, 1, 0, 0, 0, 0, 1, 0, 0]"
19076,1,1,2,0.9951899879400403,"[1, 1, 1, 1, 0, 0, 0, 0, 1, 1]"
19077,1,1,2,0.6871310966768198,"[0, 1, 1, 1, 0, 1, 0, 1, 0, 1]"
19078,1,1,2,0.10281924644681917,"[1, 1, 1, 1, 0, 0, 1, 1, 1, 1]"
19079,1,1,2,0.8426783751682094,"[0, 0, 1, 0, 0, 0, 1, 1, 0, 1]"
19080,1,1,2,0.9035205828843594,"[0, 0, 1, 0, 1, 1, 1, 1, 1, 0]"
19081,1,1,2,0.37602928421731274,"[0, 1, 1, 1, 0, 0, 0, 0, 1, 0]"
19082,1,1,2,0.08434657532433354,"[1, 1, 1, 1, 1, 1, 1, 1, 1, 1]"
19083,1,1,2,0.8625512116195367,"[0, 0, 1, 1, 1, 1, 0, 0, 0, 0]"
19084,1,1,2,0.9834117502940465,"[0, 0, 0, 0, 1, 1, 0, 1, 1, 1]"
19085,1,1,2,0.2135423400639036,"[1, 1, 0, 0, 0, 1, 1, 0, 0, 0]"
19086,1,1,2,0.6683765162472327,"[1, 0, 0, 0, 0, 1, 1, 0, 1, 1]"
19087,1,1,2,0.16308376575901617,"[1, 1, 0, 0, 1, 1, 1, 0, 0, 0]"
19088,1,1,2,0.7868965498951492,"[1, 0, 1, 1, 1, 0, 1, 1, 0, 0]"
19089,1,1,2,0.33861659032020675,"[1, 1, 1, 1, 1, 0, 1, 1, 1, 0]"
19090,1,1,2,0.19108478146862073,"[0, 0, 1, 0, 1, 0, 1, 0, 0, 0]"
19091,1,1,2,0.6117353271498839,"[1, 0, 1, 0, 1, 1, 1, 1, 1, 0]"
19092,1,1,2,0.7736802931030031,"[0, 0, 1, 1, 1, 0, 0, 0, 1, 1]"
19093,1,1,2,0.4677602711005743,"[0, 1, 1, 0, 0, 0, 0, 0, 0, 1]"
19094,3,3,6,0.9695131553835868,"[0, 0, 0, 0, 0, 1, 0, 1, 1, 0]"
19095,1,1,2,0.9521948708892362,"[0, 1, 1, 1, 1, 0, 0, 1, 1, 1]"
19096,1,1,2,0.6739247400763998,"[1, 0, 1, 1, 0, 1, 1, 1, 1, 1]"
19097,1,1,2,0.9098100839297817,"[1, 1, 0, 1, 1, 1, 0, 0, 1, 1]"
19098,1,1,2,0.6299461691726236,"[1, 1, 1, 1, 0, 0, 1, 1, 0, 1]"
19099,1,1,2,0.11020261723907843,"[0, 0, 1, 0, 1, 0, 0, 1, 1, 0]"
19100,1,1,2,0.4860103353221522,"[1, 1, 0, 1, 0, 0, 0, 0, 0, 1]"
19101,1,1,2,0.5480098076042276,"[0, 1, 1, 0, 1, 1, 0, 0, 0, 1]"
19102,1,1,2,0.7191224968490164,"[1, 0, 1, 1, 1, 0, 0, 0, 1, 1]"
19103,1,1,2,0.29898124444217644,"[1, 0, 1, 0, 1, 0, 0, 0, 0, 0]"
19104,1,1,2,0.42280506334617407,"[0, 1, 0, 1, 0, 0, 0, 1, 0, 0]"
19105,1,1,2,0.37570382158443527,"[1, 0, 0, 1, 1, 0, 1, 1, 1, 0]"
19106,1,1,2,0.07904781003625538,"[0, 0, 1, 1, 0, 1, 0, 1, 1, 1]"
19107,1,1,2,0.561884862855185,"[0, 0, 0, 1, 0, 1, 1, 0, 0, 1]"
19108,1,1,2,0.24781734620336493,"[1, 1, 0, 0, 1, 1, 1, 0, 0, 1]"
19109,1,1,2,0.6958652570364268,"[0, 0, 1, 0, 0, 0, 1, 0, 1, 0]"
19110,1,1,2,0.2963320741557258,"[1, 1, 0, 0, 1, 1, 0, 0, 1, 0]"
19111,1,1,2,0.9837540802245515,"[1, 1, 1, 1, 0, 1, 1, 0, 0, 0]"
19112,1,1,2,0.41044972678074065,"[1, 0, 1, 0, 0, 1, 0, 0, 0, 1]"
19113,1,1,2,0.9099494042069843,"[1, 0, 0, 1, 1, 0, 0, 1, 0, 0]"
19114,2,2,4,0.29338748978511686,"[0, 0, 0, 1, 0, 0, 0, 1, 1, 1]"
19115,1,1,2,0.9667916042226224,"[0, 0, 1, 1, 1, 1, 0, 0, 1, 0]"
19116,1,1,2,0.9202550248405075,"[0, 0, 1, 0, 0, 1, 0, 0, 1, 1]"
19117,1,1,2,0.45052888112772393,"[1, 1, 1, 1, 1, 1, 1, 0, 1, 1]"
19118,1,1,2,0.9405592274439041,"[1, 1, 1, 1, 0, 0, 1, 1, 0, 1]"
19119,1,1,2,0.8129363095574446,"[1, 0, 0, 1, 0, 1, 0, 1, 1, 1]"
19120,1,1,2,0.22315027442041735,"[0, 0, 0, 0, 1, 0, 0, 0, 1, 0]"
19121,1,1,2,0.1138073200158437,"[0, 1, 1, 1, 1, 1, 0, 1, 0, 1]"
19122,1,1,2,0.23536114954900456,"[0, 0, 1, 1, 1, 1, 1, 1, 0, 1]"
19123,1,1,2,0.23546206951939286,"[0, 0, 1, 0, 1, 1, 0, 0, 0, 1]"
19124,1,1,2,0.5266640444093622,"[1, 1, 0, 0, 1, 0, 1, 0, 0, 0]"
19125,1,1,2,0.9969921010916842,"[1, 1, 0, 0, 0, 0, 0, 1, 1, 0]"
19126,1,1,2,0.6170296017396495,"[1, 1, 1, 0, 0, 1, 1, 0, 1, 1]"
19127,1,1,2,0.08784586905807323,"[1, 0, 1, 0, 0, 0, 0, 0, 0, 0]"
19128,1,1,2,0.019843014989998298,"[1, 1, 1, 0, 1, 0, 0, 0, 0, 1]"
19129,1,1,2,0.8184367824940526,"[0, 1, 0, 1, 1, 0, 1, 1, 0, 1]"
19130,1,1,2,0.6488090684575852,"[1, 0, 1, 1, 1, 0, 0, 1, 1, 1]"
19131,1,1,2,0.17627347354345635,"[1, 1, 0, 0, 1, 1, 1, 0, 0, 0]"
19132,1,1,2,0.7438339161499904,"[1, 0, 0, 1, 1, 1, 1, 0, 0, 1]"
19133,1,1,2,0.4059882932203964,"[1, 1, 0, 0, 0, 0, 0, 1, 1, 1]"
19134,1,1,2,0.23183804400201158,"[0, 0, 1, 0, 1, 0, 1, 0, 1, 1]"
19135,1,1,2,0.16153004150422812,"[1, 1, 0, 1, 1, 1, 0, 0, 0, 0]"
19136,1,1,2,0.16435216489338333,"[1, 0, 1, 0, 1, 0, 0, 0, 0, 0]"
19137,2,2,4,0.05313771555255242,"[1, 1, 0, 1, 0, 1, 1, 0, 1, 1]"
19138,1,1,2,0.8745534155128328,"[1, 0, 1, 1, 1, 0, 1, 1, 0, 0]"
19139,1,1,2,0.3340931241404407,"[1, 1, 0, 1, 0, 0, 1, 0, 0, 1]"
19140,1,1,2,0.724720289616951,"[1, 1, 0, 1, 0, 1, 0, 0, 1, 1]"
19141,1,1,2,0.27186804334751546,"[1, 0, 1, 0, 0, 0, 1, 1, 1, 0]"
19142,1,1,2,0.3163655976503351,"[1, 0, 0, 1, 1, 1, 1, 1, 0, 1]"
19143,1,1,2,0.7117321121224528,"[1, 0, 1, 0, 0, 1, 1, 0, 1, 0]"
19144,1,1,2,0.9113672561476425,"[0, 0, 1, 0, 1, 0, 0, 0, 0, 0]"
19145,1,1,2,0.3730870706686622,"[1, 1, 1, 0, 0, 0, 1, 1, 1, 0]"
19146,1,1,2,0.2895805148033339,"[0, 0, 1, 1, 1, 0, 0, 1, 0, 1]"
19147,1,1,2,0.8289283299383493,"[1, 0, 0, 0, 0, 0, 0, 0, 1, 0]"
19148,1,1,2,0.6898095303126925,"[1, 0, 0, 1, 0, 1, 1, 0, 0, 0]"
19149,1,1,2,0.4937646878595554,"[0, 1, 1, 0, 0, 0, 0, 1, 0, 1]"
19150,1,1,2,0.41076464936852497,"[1, 1, 0, 1, 1, 1, 1, 0, 1, 1]"
19151,1,1,2,0.08240225579600202,"[1, 0, 1, 0, 1, 0, 0, 0, 0, 0]"
19152,1,1,2,0.41670000728927903,"[0, 1, 0, 0, 1, 0, 0, 0, 1, 0]"
19153,1,1,2,0.6350649435186274,"[0, 1, 1, 0, 0, 0, 1, 0, 1, 1]"
19154,1,1,2,0.28795957587159515,"[1, 1, 1, 0, 0, 1, 1, 1, 1, 1]"
19155,1,1,2,0.13690157387630508,"[1, 0, 1, 0, 1, 1, 1, 1, 1, 0]"
19156,1,1,2,0.34596554488162123,"[1, 0, 1, 1, 1, 1, 1, 1, 1, 0]"
19157,1,1,2,0.06878068929184133,"[1, 1, 0, 0, 0, 0, 0, 0, 1, 1]"
19158,2,2,4,0.6958907183215197,"[1, 1, 0, 1, 1, 1, 0, 0, 0, 0]"
19159,1,1,2,0.1633959258868386,"[1, 0, 0, 1, 1, 1, 1, 0, 0, 1]"
19160,1,1,2,0.21295247154036778,"[1, 0, 1, 0, 1, 0, 0, 1, 0, 1]"
19161,1,1,2,0.16852068095206119,"[0, 1, 0, 1, 1, 1, 0, 0, 0, 1]"
19162,1,1,2,0.5980013114022473,"[1, 0, 0, 1, 1, 1, 1, 1, 0, 1]"
19163,1,1,2,0.45037668274972287,"[0, 0, 0, 0, 1, 0, 0, 0, 1, 1]"
19164,2,2,4,0.5915228792199106,"[1, 1, 0, 0, 0, 0, 0, 1, 0, 0]"
19165,1,1,2,0.8389810034252829,"[1, 0, 0, 0, 0, 0, 1, 1, 1, 1]"
19166,1,1,2,0.2583992072143927,"[0, 1, 0, 1, 0, 1, 0, 0, 1, 0]"
19167,1,1,2,0.9171698623780542,"[0, 1, 1, 0, 1, 1, 1, 0, 1, 1]"
19168,1,1,2,0.7392110076775945,"[1, 0, 1, 0, 1, 0, 1, 0, 1, 1]"
19169,1,1,2,0.37057350129953515,"[1, 1, 1, 0, 1, 1, 1, 0, 0, 1]"
19170,1,1,2,0.4885377494683375,"[1, 1, 1, 1, 0, 1, 1, 1, 0, 1]"
19171,1,1,2,0.6983728922207996,"[1, 1, 1, 1, 0, 0, 1, 0, 1, 1]"
19172,1,1,2,0.43364717441312317,"[1, 0, 0, 0, 0, 0, 1, 1, 0, 1]"
19173,1,1,2,0.24785658145485123,"[1, 0, 1, 1, 0, 1, 1, 0, 0, 1]"
19174,1,1,2,0.3263605967257036,"[0, 0, 1, 0, 1, 0, 0, 0, 1, 0]"
19175,1,1,2,0.2876754614815963,"[0, 0, 1, 0, 0, 0, 1, 0, 1, 0]"
19176,1,1,2,0.892529437717523,"[1, 0, 0, 1, 1, 0, 0, 0, 0, 1]"
19177,1,1,2,0.4724719060867587,"[0, 0, 0, 0, 0, 1, 1, 0, 1, 1]"
19178,1,1,2,0.16615336745400178,"[0, 0, 0, 0, 1, 1, 1, 0, 1, 1]"
19179,1,1,2,0.45782364095820705,"[0, 0, 1, 0, 1, 1, 1, 0, 1, 0]"
19180,1,1,2,0.6516226101880114,"[0, 0, 1, 1, 0, 0, 1, 1, 0, 0]"
19181,1,1,2,0.45129821066486875,"[0, 0, 0, 0, 0, 0, 1, 1, 0, 1]"
19182,2,2,4,0.9644695636794974,"[1, 0, 1, 0, 1, 0, 0, 0, 1, 0]"
19183,1,1,2,0.5932918533379684,"[0, 1, 0, 0, 0, 1, 1, 0, 0, 1]"
19184,1,1,2,0.9007999338882816,"[0, 1, 0, 0, 0, 0, 0, 1, 0, 1]"
19185,1,1,2,0.962996748752493,"[0, 0, 1, 1, 0, 1, 0, 1, 0, 1]"
19186,1,1,2,0.25914318712866036,"[1, 1, 1, 1, 1, 1, 0, 0, 1, 0]"
19187,1,1,2,0.24402183342285655,"[1, 1, 1, 1, 0, 1, 1, 1, 1, 0]"
19188,1,1,2,0.9104669206436097,"[1, 0, 1, 1, 1, 1, 1, 0, 0, 0]"
19189,1,1,2,0.860223394788937,"[0, 1, 1, 0, 1, 1, 0, 1, 0, 0]"
19190,1,1,2,0.052492490449900675,"[0, 0, 0, 1, 0, 1, 1, 1, 0, 0]"
19191,1,1,2,0.3685515029264983,"[1, 1, 0, 1, 0, 0, 0, 1, 0, 1]"
19192,1,1,2,0.7517442306098817,"[0, 0, 0, 1, 0, 0, 0, 1, 1, 0]"
19193,1,1,2,0.038469095701923806,"[1, 1, 0, 0, 1, 0, 1, 1, 1, 1]"
19194,1,1,2,0.3768557213386641,"[1, 0, 0, 0, 1, 1, 1, 1, 0, 0]"
19195,1,1,2,0.07480439820389029,"[0, 1, 0, 0, 1, 1, 0, 1, 0, 1]"
19196,1,1,2,0.3080655517720672,"[1, 0, 0, 1, 1, 0, 0, 0, 0, 1]"
19197,1,1,2,0.935073429150842,"[1, 0, 0, 0, 1, 0, 0, 0, 0, 0]"
19198,1,1,2,0.637043940264264,"[0, 0, 1, 1, 0, 1, 0, 0, 0, 1]"
19199,1,1,2,0.3185697050108188,"[1, 1, 1, 0, 0, 1, 0, 0, 1, 0]"
19200,1,1,2,0.9488362085232931,"[0, 1, 1, 0, 0, 1, 1, 1, 0, 1]"
19201,1,1,2,0.5026077629696704,"[1, 0, 0, 1, 1, 0, 1, 0, 1, 0]"
19202,1,1,2,0.3140941852466659,"[0, 1, 0, 0, 0, 1, 0, 1, 1, 1]"
19203,1,1,2,0.6519046287341255,"[0, 0, 0, 0, 0, 1, 0, 1, 1, 0]"
19204,1,1,2,0.37268013040281356,"[0, 1, 1, 1, 1, 0, 1, 1, 0, 1]"
19205,1,1,2,0.7241115697307263,"[0, 0, 1, 1, 0, 0, 0, 1, 1, 1]"
19206,1,1,2,0.7237905236984532,"[0, 1, 1, 1, 0, 0, 0, 1, 0, 0]"
19207,1,1,2,0.441404904083304,"[1, 0, 0, 1, 0, 1, 0, 1, 1, 0]"
19208,1,1,2,0.8213340761378412,"[1, 1, 0, 1, 0, 1, 0, 0, 0, 0]"
19209,1,1,2,0.8204844931442787,"[0, 1, 1, 1, 1, 0, 0, 0, 0, 0]"
19210,1,1,2,0.006304464656809783,"[0, 1, 1, 0, 0, 1, 1, 1, 0, 0]"
19211,1,1,2,0.6159225162778712,"[1, 0, 1, 0, 1, 0, 0, 0, 1, 1]"
19212,1,1,2,0.39180995366673865,"[0, 1, 0, 0, 1, 0, 1, 1, 0, 0]"
19213,1,1,2,0.9969123883947173,"[0, 1, 1, 0, 1, 1, 0, 0, 1, 1]"
19214,1,1,2,0.2655410273931923,"[0, 1, 0, 0, 0, 0, 1, 0, 0, 1]"
19215,1,1,2,0.9820935703622609,"[0, 0, 1, 1, 1, 1, 1, 1, 1, 0]"
19216,1,1,2,0.010607811900316344,"[1, 1, 0, 0, 1, 1, 1, 1, 1, 1]"
19217,1,1,2,0.37769770780311407,"[0, 0, 0, 1, 0, 0, 0, 1, 1, 1]"
19218,1,1,2,0.9708388863734422,"[0, 1, 1, 1, 0, 1, 1, 0, 1, 1]"
19219,1,1,2,0.3449628141784422,"[0, 0, 1, 1, 0, 0, 0, 0, 1, 1]"
19220,1,1,2,0.6735595899939174,"[1, 1, 1, 0, 1, 0, 0, 0, 0, 0]"
19221,1,1,2,0.519437388698439,"[1, 1, 1, 0, 1, 0, 1, 0, 0, 0]"
19222,1,1,2,0.006646377666097436,"[1, 0, 0, 1, 1, 0, 0, 1, 0, 0]"
19223,1,1,2,0.6297694134451972,"[1, 1, 0, 1, 1, 0, 1, 1, 1, 1]"
19224,1,1,2,0.96745561489996,"[0, 0, 1, 1, 1, 1, 0, 1, 0, 0]"
19225,1,1,2,0.6402631427747881,"[0, 1, 0, 1, 0, 0, 0, 1, 0, 1]"
19226,1,1,2,0.8932776762337455,"[1, 0, 0, 1, 1, 1, 0, 0, 0, 0]"
19227,1,1,2,0.5523364222941424,"[1, 1, 0, 1, 0, 0, 0, 1, 1, 0]"
19228,1,1,2,0.07381805784958217,"[0, 0, 0, 0, 1, 0, 0, 0, 0, 0]"
19229,1,1,2,0.048550386271536294,"[0, 1, 1, 1, 1, 1, 1, 0, 1, 0]"
19230,1,1,2,0.009572938001822684,"[0, 1, 1, 0, 1, 0, 1, 1, 0, 1]"
19231,1,1,2,0.00422663885415997,"[1, 1, 1, 1, 0, 0, 1, 0, 1, 0]"
19232,1,1,2,0.4248172221081896,"[0, 1, 1, 1, 1, 1, 1, 0, 0, 1]"
19233,1,1,2,0.020664088233798728,"[1, 1, 1, 0, 1, 1, 1, 1, 1, 1]"
19234,1,1,2,0.7446146492179094,"[1, 0, 1, 0, 0, 0, 1, 0, 1, 0]"
19235,1,1,2,0.1815815757527044,"[1, 0, 1, 1, 1, 0, 1, 0, 0, 0]"
19236,1,1,2,0.640798265070454,"[1, 1, 0, 1, 1, 1, 1, 0, 1, 0]"
19237,1,1,2,0.7492050045757671,"[0, 0, 0, 1, 1, 0, 1, 0, 0, 1]"
19238,1,1,2,0.9959198600700407,"[0, 0, 1, 1, 0, 1, 0, 0, 1, 1]"
19239,1,1,2,0.5470139607161391,"[0, 1, 1, 1, 1, 1, 0, 1, 0, 0]"
19240,1,1,2,0.8314753305680205,"[1, 0, 0, 0, 1, 0, 0, 1, 1, 0]"
19241,1,1,2,0.4348095971504694,"[1, 1, 1, 1, 1, 1, 1, 1, 0, 1]"
19242,1,1,2,0.36241435322619686,"[1, 1, 0, 1, 1, 0, 1, 1, 1, 0]"
19243,1,1,2,0.8379678712263056,"[0, 0, 1, 0, 0, 0, 0, 0, 0, 0]"
19244,1,1,2,0.7580653994383026,"[0, 0, 1, 1, 1, 0, 0, 0, 0, 0]"
19245,1,1,2,0.8484166344975919,"[0, 1, 0, 0, 1, 0, 1, 0, 0, 0]"
19246,1,1,2,0.3824081487393861,"[0, 0, 0, 1, 1, 1, 0, 0, 0, 1]"
19247,1,1,2,0.5748942792914966,"[1, 1, 0, 0, 1, 1, 0, 0, 1, 1]"
19248,1,1,2,0.7750071128601568,"[0, 0, 1, 0, 1, 0, 0, 0, 1, 0]"
19249,1,1,2,0.5271507260364772,"[0, 1, 0, 1, 0, 1, 1, 1, 0, 1]"
19250,1,1,2,0.5219315474261185,"[1, 0, 1, 1, 0, 0, 0, 1, 0, 1]"
19251,1,1,2,0.12820524115987242,"[0, 0, 0, 1, 1, 1, 1, 0, 1, 1]"
19252,1,1,2,0.5721030867062842,"[1, 1, 0, 0, 1, 1, 0, 0, 1, 1]"
19253,1,1,2,0.023908854649145717,"[1, 0, 1, 1, 0, 1, 0, 1, 1, 0]"
19254,1,1,2,0.3149884096996295,"[0, 1, 1, 0, 1, 0, 1, 1, 1, 0]"
19255,1,1,2,0.3576032563871221,"[1, 0, 0, 1, 0, 0, 0, 0, 0, 1]"
19256,1,1,2,0.054715290673854944,"[0, 0, 1, 1, 1, 1, 1, 0, 1, 1]"
19257,1,1,2,0.17021920869493234,"[1, 0, 1, 0, 0, 0, 0, 1, 0, 1]"
19258,1,1,2,0.45714033232208395,"[1, 1, 1, 0, 1, 1, 1, 1, 0, 1]"
19259,1,1,2,0.6233296108767515,"[1, 0, 0, 0, 0, 0, 0, 1, 0, 1]"
19260,1,1,2,0.7424378994243439,"[1, 0, 1, 0, 0, 0, 1, 1, 0, 0]"
19261,1,1,2,0.5556106995168058,"[1, 0, 0, 0, 1, 0, 0, 0, 0, 0]"
19262,1,1,2,0.895913110809437,"[1, 1, 0, 1, 1, 0, 1, 0, 1, 0]"
19263,1,1,2,0.691188696902595,"[1, 1, 1, 1, 0, 1, 0, 1, 0, 1]"
19264,1,1,2,0.6075550270456966,"[1, 0, 0, 0, 0, 0, 1, 1, 1, 0]"
19265,1,1,2,0.02851146761552059,"[0, 1, 0, 1, 1, 1, 0, 0, 0, 1]"
19266,1,1,2,0.9621305293706257,"[1, 1, 0, 1, 1, 0, 1, 0, 0, 0]"
19267,1,1,2,0.06681498682842524,"[1, 1, 0, 0, 1, 0, 1, 1, 0, 0]"
19268,1,1,2,0.9827751712974752,"[1, 0, 1, 0, 0, 1, 0, 0, 1, 1]"
19269,1,1,2,0.7509142615007972,"[1, 0, 1, 1, 1, 1, 1, 0, 1, 1]"
19270,1,1,2,0.390666542811013,"[0, 0, 0, 1, 1, 0, 0, 1, 0, 0]"
19271,1,1,2,0.22010626299439473,"[0, 0, 0, 0, 0, 1, 0, 0, 1, 1]"
19272,1,1,2,0.06093107814231613,"[1, 1, 0, 1, 1, 0, 1, 0, 1, 1]"
19273,1,1,2,0.7930941836039538,"[0, 0, 1, 1, 0, 1, 0, 1, 0, 0]"
19274,1,1,2,0.42189203281732257,"[0, 0, 1, 1, 1, 1, 1, 1, 1, 1]"
19275,1,1,2,0.321727361343773,"[1, 1, 1, 1, 1, 0, 0, 0, 0, 1]"
19276,1,1,2,0.9015228195334984,"[0, 1, 0, 0, 0, 1, 1, 1, 1, 0]"
19277,1,1,2,0.20013109701962517,"[0, 0, 0, 1, 0, 0, 0, 1, 1, 0]"
19278,1,1,2,0.1184508725766491,"[1, 0, 0, 0, 0, 1, 1, 0, 0, 1]"
19279,1,1,2,0.05721577355882257,"[0, 0, 1, 1, 0, 0, 1, 0, 0, 1]"
19280,1,1,2,0.8205342284579998,"[1, 0, 0, 0, 0, 1, 0, 1, 0, 1]"
19281,1,1,2,0.9450062441661888,"[1, 0, 0, 0, 1, 0, 0, 0, 1, 0]"
19282,1,1,2,0.18263107181545302,"[1, 0, 0, 0, 0, 0, 0, 0, 0, 1]"
19283,1,1,2,0.7671775545065564,"[1, 0, 0, 0, 1, 0, 1, 1, 0, 0]"
19284,1,1,2,0.9721496331799812,"[1, 0, 1, 0, 1, 1, 1, 1, 1, 0]"
19285,1,1,2,0.5643865421767784,"[1, 0, 0, 1, 1, 1, 0, 0, 0, 0]"
19286,1,1,2,0.08449629184944474,"[0, 1, 1, 0, 1, 0, 0, 1, 0, 0]"
19287,1,1,2,0.015201185114221194,"[1, 1, 0, 1, 0, 0, 0, 1, 1, 0]"
19288,1,1,2,0.46872441987967495,"[1, 0, 1, 1, 0, 0, 1, 0, 0, 0]"
19289,1,1,2,0.9124694247682749,"[1, 0, 0, 1, 1, 1, 1, 0, 1, 0]"
19290,1,1,2,0.10736760585590055,"[0, 1, 1, 1, 1, 1, 1, 0, 0, 0]"
19291,1,1,2,0.5768730627042228,"[0, 0, 0, 1, 0, 1, 1, 0, 1, 1]"
19292,1,1,2,0.019861978356576326,"[1, 1, 1, 1, 0, 0, 0, 0, 0, 0]"
19293,1,1,2,0.20904312604312136,"[0, 0, 1, 1, 1, 0, 0, 0, 0, 1]"
19294,1,1,2,0.7489157229760075,"[1, 0, 0, 0, 1, 0, 1, 1, 0, 1]"
19295,1,1,2,0.15150892569089824,"[0, 1, 1, 0, 0, 1, 1, 1, 0, 1]"
19296,1,1,2,0.845237172055254,"[0, 1, 0, 1, 1, 0, 0, 0, 1, 0]"
19297,1,1,2,0.2340812679672739,"[1, 0, 1, 1, 1, 0, 0, 1, 0, 1]"
19298,1,1,2,0.03558029516963723,"[0, 1, 1, 0, 0, 0, 1, 1, 0, 0]"
19299,1,1,2,0.04861157895298229,"[1, 0, 1, 1, 1, 1, 0, 1, 0, 1]"
19300,1,1,2,0.2964237844697779,"[0, 1, 0, 1, 1, 1, 1, 0, 1, 1]"
19301,1,1,2,0.4541157037457606,"[1, 0, 0, 1, 0, 0, 1, 0, 0, 0]"
19302,1,1,2,0.5491564401570533,"[0, 1, 1, 1, 0, 0, 0, 0, 1, 0]"
19303,1,1,2,0.46490245415141396,"[1, 0, 0, 1, 0, 0, 0, 0, 0, 0]"
19304,1,1,2,0.9056951342106405,"[0, 0, 1, 1, 1, 1, 0, 0, 1, 1]"
19305,1,1,2,0.6896909279246753,"[0, 0, 0, 0, 1, 1, 1, 0, 1, 1]"
19306,1,1,2,0.7174591092287331,"[0, 0, 1, 1, 0, 1, 0, 1, 0, 0]"
19307,3,3,6,0.5320921506548111,"[1, 1, 0, 1, 1, 0, 1, 0, 1, 1]"
19308,1,1,2,0.8316711269128321,"[1, 0, 0, 0, 1, 0, 1, 0, 0, 0]"
19309,1,1,2,0.27970044089486445,"[0, 1, 1, 0, 1, 0, 0, 1, 0, 0]"
19310,1,1,2,0.22761799561164797,"[0, 0, 1, 1, 0, 0, 0, 1, 1, 0]"
19311,1,1,2,0.5058035750057654,"[0, 0, 1, 0, 1, 1, 1, 1, 0, 0]"
19312,1,1,2,0.15132544590940356,"[1, 0, 0, 0, 1, 1, 0, 0, 1, 1]"
19313,1,1,2,0.6559532102561176,"[0, 0, 0, 1, 0, 1, 1, 1, 1, 1]"
19314,1,1,2,0.9635954276402582,"[0, 1, 1, 1, 0, 1, 0, 1, 0, 0]"
19315,1,1,2,0.925554949387296,"[0, 0, 1, 1, 1, 0, 1, 0, 1, 1]"
19316,1,1,2,0.5914508634951382,"[0, 1, 1, 1, 0, 0, 1, 1, 1, 0]"
19317,1,1,2,0.34418536423341994,"[0, 0, 1, 1, 1, 1, 0, 0, 0, 0]"
19318,1,1,2,0.6045843881025622,"[0, 1, 1, 1, 1, 0, 1, 1, 1, 1]"
19319,1,1,2,0.34257843633439755,"[0, 1, 1, 0, 0, 1, 0, 1, 1, 1]"
19320,1,1,2,0.8564648940830794,"[0, 0, 1, 0, 1, 0, 0, 1, 0, 1]"
19321,1,1,2,0.12699789124743532,"[0, 1, 0, 1, 1, 1, 1, 1, 0, 0]"
19322,1,1,2,0.5897150270319963,"[1, 1, 0, 0, 1, 1, 1, 0, 0, 1]"
19323,1,1,2,0.2215409618322891,"[0, 1, 0, 1, 0, 0, 0, 0, 1, 0]"
19324,1,1,2,0.4843399090594035,"[0, 1, 1, 1, 0, 1, 1, 1, 0, 1]"
19325,1,1,2,0.6699142567251603,"[1, 0, 0, 1, 0, 1, 0, 1, 0, 1]"
19326,1,1,2,0.5341633265677971,"[1, 0, 1, 0, 0, 1, 0, 0, 1, 0]"
19327,1,1,2,0.888062268153952,"[1, 0, 1, 1, 1, 0, 1, 1, 0, 1]"
19328,1,1,2,0.15124012575143286,"[0, 0, 1, 1, 0, 1, 1, 1, 0, 1]"
19329,1,1,2,0.19740650616031896,"[0, 1, 1, 0, 0, 1, 1, 0, 1, 0]"
19330,1,1,2,0.9195373891564486,"[0, 0, 1, 0, 0, 0, 0, 1, 1, 0]"
19331,1,1,2,0.9283233140047362,"[0, 0, 0, 0, 1, 0, 0, 0, 1, 0]"
19332,1,1,2,0.679494982866358,"[0, 1, 0, 1, 0, 0, 1, 1, 0, 0]"
19333,1,1,2,0.2605513253064956,"[0, 0, 0, 1, 0, 1, 0, 1, 0, 1]"
19334,1,1,2,0.777603144939798,"[1, 0, 1, 1, 0, 0, 1, 0, 1, 0]"
19335,2,2,4,0.3606531616092422,"[0, 0, 0, 0, 0, 1, 0, 0, 1, 0]"
19336,1,1,2,0.1342435950680544,"[1, 0, 1, 1, 0, 1, 1, 1, 1, 1]"
19337,1,1,2,0.525620437228335,"[1, 0, 0, 0, 1, 1, 0, 1, 1, 1]"
19338,1,1,2,0.09419443516475923,"[1, 0, 1, 0, 0, 0, 0, 0, 0, 0]"
19339,1,1,2,0.5214931521671705,"[1, 0, 1, 0, 0, 1, 1, 0, 0, 0]"
19340,1,1,2,0.07116118023688212,"[0, 0, 1, 0, 1, 1, 1, 1, 0, 0]"
19341,1,1,2,0.5331968776997106,"[0, 0, 0, 1, 0, 0, 1, 1, 1, 1]"
19342,1,1,2,0.050097974392118716,"[0, 1, 0, 0, 0, 0, 1, 1, 1, 0]"
19343,1,1,2,0.9527448252897235,"[1, 0, 0, 1, 1, 0, 1, 1, 1, 0]"
19344,1,1,2,0.2929973450421718,"[1, 0, 0, 1, 0, 1, 1, 0, 0, 0]"
19345,1,1,2,0.4301117412976313,"[0, 1, 0, 1, 0, 1, 0, 1, 1, 1]"
19346,1,1,2,0.10713575363987227,"[1, 1, 1, 1, 0, 0, 1, 0, 0, 1]"
19347,1,1,2,0.5029998144834195,"[0, 0, 1, 0, 1, 0, 0, 0, 1, 1]"
19348,1,1,2,0.9225354492951857,"[1, 1, 0, 1, 0, 1, 1, 1, 0, 0]"
19349,1,1,2,0.783412694636852,"[0, 0, 1, 1, 1, 0, 0, 0, 1, 0]"
19350,1,1,2,0.7342632419891106,"[1, 0, 0, 1, 1, 1, 1, 1, 0, 1]"
19351,1,1,2,0.28273544700199926,"[0, 0, 0, 1, 1, 1, 0, 0, 0, 0]"
19352,1,1,2,0.5597422716480689,"[1, 0, 0, 1, 1, 0, 0, 0, 0, 0]"
19353,1,1,2,0.2560409677438873,"[0, 1, 0, 1, 0, 1, 0, 0, 0, 1]"
19354,1,1,2,0.8771568198130175,"[1, 0, 1, 0, 0, 1, 0, 0, 0, 0]"
19355,1,1,2,0.2715982721106679,"[1, 1, 0, 1, 1, 0, 1, 1, 1, 0]"
19356,1,1,2,0.4685972773073367,"[1, 1, 1, 0, 0, 0, 1, 0, 0, 1]"
19357,1,1,2,0.5986616263979487,"[1, 0, 0, 1, 0, 0, 0, 1, 1, 0]"
19358,1,1,2,0.676157060522013,"[0, 0, 0, 1, 1, 0, 1, 0, 1, 0]"
19359,1,1,2,0.0005244147556984213,"[0, 1, 1, 1, 0, 1, 0, 1, 1, 0]"
19360,1,1,2,0.9481541325145942,"[1, 1, 1, 0, 1, 1, 0, 1, 0, 1]"
19361,1,1,2,0.9175958673657371,"[1, 1, 1, 0, 0, 1, 1, 0, 0, 1]"
19362,1,1,2,0.29481206864222376,"[1, 0, 0, 1, 1, 0, 0, 0, 0, 1]"
19363,1,1,2,0.32073492406883697,"[1, 0, 1, 1, 0, 0, 1, 1, 1, 1]"
19364,1,1,2,0.8409436023812545,"[1, 1, 1, 0, 0, 0, 1, 0, 1, 1]"
19365,1,1,2,0.8595623150129703,"[0, 1, 1, 0, 1, 0, 1, 1, 1, 1]"
19366,2,2,4,0.9707052344989586,"[1, 0, 1, 0, 0, 0, 1, 0, 1, 1]"
19367,1,1,2,0.7857704556828374,"[0, 0, 1, 0, 0, 0, 0, 0, 0, 1]"
19368,1,1,2,0.16226421901844412,"[1, 1, 1, 1, 1, 0, 1, 1, 0, 0]"
19369,1,1,2,0.11190722945994291,"[1, 0, 1, 0, 0, 0, 1, 1, 1, 0]"
19370,1,1,2,0.6710255042507122,"[0, 0, 1, 1, 1, 0, 1, 1, 0, 1]"
19371,1,1,2,0.4036446140913609,"[0, 0, 1, 0, 0, 0, 1, 0, 1, 0]"
19372,1,1,2,0.8674681156760312,"[1, 1, 1, 1, 1, 1, 0, 0, 0, 0]"
19373,1,1,2,0.1172508983033902,"[1, 1, 0, 1, 0, 0, 0, 0, 1, 1]"
19374,1,1,2,0.03228144937765354,"[1, 1, 1, 1, 0, 0, 1, 0, 1, 1]"
19375,1,1,2,0.6016942240630243,"[1, 1, 0, 1, 0, 0, 0, 1, 1, 0]"
19376,1,1,2,0.5020517524893083,"[0, 1, 0, 1, 0, 0, 0, 0, 1, 1]"
19377,1,1,2,0.38939331809289557,"[0, 1, 1, 0, 0, 1, 0, 0, 1, 0]"
19378,1,1,2,0.7301292146972653,"[0, 1, 0, 0, 1, 1, 1, 1, 1, 0]"
19379,1,1,2,0.4511964758871587,"[0, 0, 0, 1, 1, 0, 0, 1, 1, 0]"
19380,1,1,2,0.2152456153639981,"[0, 0, 0, 0, 1, 1, 1, 0, 1, 1]"
19381,1,1,2,0.6353384609230468,"[0, 0, 1, 0, 0, 1, 0, 1, 0, 1]"
19382,1,1,2,0.7038817598151229,"[1, 0, 0, 1, 1, 1, 1, 1, 1, 0]"
19383,1,1,2,0.6967093912075317,"[1, 1, 1, 0, 1, 1, 1, 0, 0, 0]"
19384,1,1,2,0.4625938149351666,"[0, 0, 1, 0, 1, 0, 1, 1, 0, 0]"
19385,1,1,2,0.8248444322246843,"[1, 0, 0, 0, 0, 0, 1, 1, 1, 1]"
19386,1,1,2,0.2700243366432412,"[0, 1, 0, 0, 0, 0, 0, 0, 1, 0]"
19387,1,1,2,0.1360206669548183,"[0, 0, 1, 0, 1, 1, 1, 1, 0, 1]"
19388,1,1,2,0.32646890119041105,"[1, 0, 1, 0, 0, 1, 0, 1, 1, 0]"
19389,1,1,2,0.9859566456709945,"[1, 1, 1, 0, 1, 1, 1, 1, 1, 1]"
19390,1,1,2,0.9771893216188223,"[0, 1, 1, 0, 1, 1, 0, 0, 0, 0]"
19391,1,1,2,0.15493256672272315,"[1, 1, 0, 1, 1, 1, 1, 1, 1, 1]"
19392,1,1,2,0.5106714586281399,"[1, 0, 1, 0, 1, 0, 0, 0, 1, 1]"
19393,1,1,2,0.1928381006333113,"[0, 1, 0, 1, 1, 1, 0, 1, 0, 0]"
19394,1,1,2,0.24801575176993518,"[0, 0, 0, 0, 0, 1, 0, 1, 0, 1]"
19395,1,1,2,0.036039138583024544,"[1, 0, 1, 0, 1, 1, 1, 0, 0, 1]"
19396,1,1,2,0.2845228639004237,"[1, 0, 1, 1, 0, 0, 1, 0, 0, 0]"
19397,1,1,2,0.12070958311614033,"[1, 1, 0, 0, 1, 0, 1, 1, 0, 1]"
19398,1,1,2,0.7500197920373001,"[0, 1, 1, 1, 0, 1, 1, 1, 1, 1]"
19399,1,1,2,0.054401048836259736,"[1, 0, 0, 1, 0, 1, 1, 1, 1, 1]"
19400,1,1,2,0.8649116952265241,"[0, 0, 0, 0, 1, 1, 1, 1, 0, 0]"
19401,1,1,2,0.2257166509757349,"[0, 1, 0, 1, 1, 1, 1, 0, 1, 1]"
19402,1,1,2,0.4356659755412059,"[1, 1, 1, 1, 1, 1, 1, 1, 1, 0]"
19403,1,1,2,0.7872252389031948,"[0, 1, 1, 1, 1, 0, 1, 1, 1, 1]"
19404,1,1,2,0.5688685371514117,"[1, 1, 0, 1, 0, 1, 0, 0, 0, 0]"
19405,1,1,2,0.7245226507147502,"[1, 0, 0, 1, 0, 0, 0, 0, 0, 1]"
19406,1,1,2,0.6371167864901072,"[1, 1, 0, 1, 1, 0, 1, 1, 0, 1]"
19407,1,1,2,0.45739475211212854,"[1, 0, 0, 1, 0, 0, 1, 0, 1, 0]"
19408,1,1,2,0.8306784889893666,"[1, 0, 1, 0, 1, 0, 1, 0, 1, 0]"
19409,1,1,2,0.5613254917286032,"[0, 1, 0, 1, 0, 1, 0, 0, 1, 1]"
19410,1,1,2,0.7761120139498209,"[0, 0, 1, 1, 1, 0, 0, 1, 1, 1]"
19411,1,1,2,0.9112524087452664,"[0, 1, 1, 0, 1, 0, 0, 1, 1, 1]"
19412,1,1,2,0.1719021938279991,"[0, 0, 0, 1, 0, 1, 0, 0, 0, 0]"
19413,1,1,2,0.8912950814871177,"[0, 0, 0, 1, 0, 0, 0, 1, 1, 1]"
19414,1,1,2,0.4238005316709891,"[1, 0, 0, 1, 1, 0, 1, 1, 0, 1]"
19415,1,1,2,0.24310652378299957,"[0, 1, 0, 0, 1, 0, 1, 1, 1, 1]"
19416,1,1,2,0.6915259421138469,"[1, 1, 0, 1, 0, 1, 1, 1, 1, 1]"
19417,1,1,2,0.011059327078662085,"[1, 1, 1, 0, 0, 0, 1, 1, 0, 0]"
19418,1,1,2,0.41282548873035363,"[0, 0, 1, 1, 1, 1, 1, 0, 0, 0]"
19419,1,1,2,0.8445276768336593,"[0, 0, 0, 1, 1, 1, 1, 0, 1, 0]"
19420,1,1,2,0.478782658910746,"[1, 1, 1, 0, 1, 1, 1, 0, 0, 1]"
19421,2,2,4,0.2574497180556097,"[0, 1, 0, 1, 1, 1, 1, 1, 0, 0]"
19422,1,1,2,0.5595827167303011,"[1, 0, 1, 0, 0, 1, 0, 0, 0, 1]"
19423,1,1,2,0.3996785381154815,"[1, 0, 0, 0, 0, 0, 1, 0, 1, 1]"
19424,1,1,2,0.2797734641633698,"[0, 0, 0, 0, 1, 0, 0, 1, 0, 0]"
19425,1,1,2,0.7020701827837508,"[1, 0, 1, 1, 0, 0, 1, 0, 1, 0]"
19426,1,1,2,0.613195634182257,"[1, 1, 0, 1, 1, 0, 1, 0, 0, 1]"
19427,1,1,2,0.0696011230907545,"[0, 1, 1, 0, 1, 1, 0, 0, 1, 0]"
19428,1,1,2,0.42246386021727955,"[0, 1, 1, 1, 1, 1, 0, 0, 0, 1]"
19429,1,1,2,0.38156029640001043,"[0, 0, 1, 0, 1, 0, 0, 0, 0, 0]"
19430,1,1,2,0.4446533047567356,"[0, 1, 1, 1, 0, 0, 1, 1, 0, 0]"
19431,1,1,2,0.2911397000165987,"[1, 0, 0, 1, 0, 0, 0, 0, 1, 0]"
19432,1,1,2,0.3352721876629189,"[0, 1, 1, 0, 0, 1, 0, 0, 1, 0]"
19433,1,1,2,0.6682937875893111,"[0, 0, 1, 1, 1, 0, 1, 1, 0, 0]"
19434,1,1,2,0.21683032479729736,"[1, 0, 0, 0, 0, 1, 0, 0, 1, 0]"
19435,1,1,2,0.5392603999811355,"[0, 0, 0, 1, 1, 0, 1, 1, 0, 1]"
19436,1,1,2,0.5357561630469393,"[0, 1, 1, 1, 0, 1, 0, 1, 0, 1]"
19437,1,1,2,0.6018510291044477,"[1, 0, 1, 1, 0, 0, 0, 0, 1, 1]"
19438,1,1,2,0.004806309922708474,"[1, 0, 1, 0, 0, 1, 0, 0, 0, 1]"
19439,1,1,2,0.13222441228820636,"[1, 1, 0, 0, 0, 1, 0, 0, 0, 0]"
19440,1,1,2,0.3645848845079006,"[0, 1, 1, 1, 1, 1, 1, 1, 0, 1]"
19441,1,1,2,0.450882014367206,"[1, 1, 0, 0, 1, 0, 0, 0, 1, 1]"
19442,1,1,2,0.06409582097921718,"[0, 1, 1, 1, 0, 1, 1, 1, 1, 1]"
19443,1,1,2,0.8571985047044853,"[0, 1, 0, 0, 0, 1, 1, 0, 0, 0]"
19444,1,1,2,0.22869560786513443,"[1, 0, 0, 1, 1, 1, 0, 0, 0, 0]"
19445,1,1,2,0.773428330314936,"[0, 0, 1, 1, 0, 1, 0, 0, 1, 1]"
19446,1,1,2,0.8978659374948939,"[0, 0, 1, 1, 0, 0, 1, 0, 0, 1]"
19447,1,1,2,0.259660115678896,"[0, 0, 0, 0, 1, 0, 0, 1, 1, 1]"
19448,1,1,2,0.5939421986060511,"[0, 1, 1, 0, 1, 0, 0, 1, 0, 0]"
19449,1,1,2,0.22027320940633144,"[1, 0, 0, 0, 0, 1, 0, 1, 0, 1]"
19450,1,1,2,0.7816008649371201,"[0, 0, 0, 0, 1, 0, 0, 0, 1, 1]"
19451,1,1,2,0.7780454922732324,"[1, 1, 1, 1, 1, 0, 1, 0, 1, 0]"
19452,1,1,2,0.20615104273907414,"[1, 1, 1, 0, 1, 0, 0, 0, 1, 0]"
19453,1,1,2,0.340155115028695,"[0, 0, 1, 1, 0, 0, 0, 0, 0, 0]"
19454,1,1,2,0.07586304224126428,"[1, 0, 1, 0, 0, 1, 1, 0, 1, 0]"
19455,1,1,2,0.4826622481718731,"[0, 1, 1, 1, 1, 0, 1, 0, 1, 0]"
19456,1,1,2,0.005495952615453881,"[0, 1, 0, 0, 1, 0, 1, 1, 1, 0]"
19457,1,1,2,0.28439670885854074,"[0, 0, 1, 1, 0, 1, 1, 1, 0, 1]"
19458,1,1,2,0.2832763880109985,"[0, 1, 1, 0, 1, 0, 0, 1, 1, 0]"
19459,1,1,2,0.42779401257394944,"[0, 0, 0, 1, 0, 1, 1, 1, 1, 0]"
19460,1,1,2,0.45411099781806197,"[0, 1, 0, 0, 0, 0, 0, 1, 1, 0]"
19461,1,1,2,0.2975895510528367,"[0, 0, 1, 0, 1, 0, 0, 1, 1, 1]"
19462,1,1,2,0.016060004795163008,"[1, 1, 0, 1, 0, 1, 1, 0, 0, 1]"
19463,1,1,2,0.9629222957309322,"[0, 0, 1, 0, 0, 1, 0, 0, 1, 1]"
19464,1,1,2,0.708421297954119,"[0, 0, 0, 1, 1, 0, 1, 1, 1, 0]"
19465,1,1,2,0.6051427894224111,"[0, 1, 1, 0, 0, 1, 0, 1, 0, 0]"
19466,1,1,2,0.12831299868233093,"[1, 1, 0, 1, 0, 1, 0, 0, 1, 1]"
19467,1,1,2,0.027426987218344356,"[1, 0, 0, 1, 1, 1, 0, 0, 1, 0]"
19468,1,1,2,0.830157916769322,"[1, 1, 1, 0, 1, 1, 1, 1, 1, 0]"
19469,1,1,2,0.08755457130292565,"[0, 1, 0, 0, 1, 1, 1, 0, 1, 1]"
19470,1,1,2,0.3245667924300354,"[0, 0, 1, 1, 1, 0, 1, 1, 1, 0]"
19471,1,1,2,0.17596483591967027,"[0, 0, 0, 1, 0, 1, 0, 0, 1, 1]"
19472,1,1,2,0.788012679245351,"[0, 0, 0, 1, 1, 0, 0, 1, 1, 1]"
19473,1,1,2,0.3987610838503216,"[0, 0, 1, 0, 0, 0, 0, 0, 0, 0]"
19474,1,1,2,0.4132205617866468,"[1, 1, 0, 1, 0, 1, 0, 1, 0, 1]"
19475,1,1,2,0.550405312585162,"[1, 1, 0, 0, 1, 1, 1, 0, 0, 1]"
19476,1,1,2,0.8572322681417271,"[1, 0, 1, 0, 1, 0, 1, 1, 1, 0]"
19477,1,1,2,0.9299512272187369,"[0, 1, 1, 0, 0, 0, 0, 1, 1, 1]"
19478,1,1,2,0.02928781552959414,"[0, 1, 1, 0, 0, 0, 0, 1, 0, 1]"
19479,1,1,2,0.34295695199435217,"[1, 0, 1, 0, 1, 1, 1, 0, 0, 1]"
19480,1,1,2,0.4810601486738585,"[1, 1, 0, 0, 0, 1, 1, 0, 0, 1]"
19481,1,1,2,0.6555021580706031,"[1, 1, 1, 1, 0, 1, 0, 1, 1, 1]"
19482,1,1,2,0.29000576280037227,"[1, 0, 1, 0, 1, 0, 1, 1, 0, 0]"
19483,1,1,2,0.16386921231773866,"[0, 1, 0, 0, 1, 1, 0, 0, 1, 1]"
19484,1,1,2,0.9198011170690386,"[1, 0, 1, 0, 0, 1, 1, 0, 0, 1]"
19485,1,1,2,0.7411003770165606,"[0, 0, 1, 1, 0, 0, 0, 0, 1, 0]"
19486,1,1,2,0.6693117140673435,"[0, 0, 1, 0, 0, 0, 1, 0, 1, 1]"
19487,1,1,2,0.5469265593302157,"[0, 0, 1, 0, 1, 1, 0, 0, 1, 1]"
19488,1,1,2,0.08462536957066502,"[1, 1, 1, 1, 1, 0, 0, 0, 1, 1]"
19489,1,1,2,0.7964442916177606,"[0, 0, 1, 1, 1, 1, 0, 1, 1, 1]"
19490,1,1,2,0.37393359537922555,"[1, 0, 1, 1, 0, 1, 1, 1, 1, 0]"
19491,1,1,2,0.7709316688871412,"[0, 0, 0, 1, 0, 0, 1, 0, 1, 1]"
19492,1,1,2,0.49940581434387976,"[1, 0, 0, 1, 0, 0, 1, 1, 0, 0]"
19493,1,1,2,0.5955243529507201,"[0, 1, 1, 1, 1, 1, 1, 1, 1, 1]"
19494,1,1,2,0.8014913108372419,"[0, 1, 0, 1, 0, 0, 0, 0, 1, 1]"
19495,1,1,2,0.07605489003656996,"[1, 1, 1, 1, 0, 0, 0, 1, 0, 1]"
19496,1,1,2,0.20799012253379467,"[1, 0, 1, 0, 1, 1, 1, 0, 1, 1]"
19497,1,1,2,0.921135042198835,"[0, 0, 1, 0, 1, 1, 0, 1, 1, 1]"
19498,1,1,2,0.31688591839879854,"[0, 0, 0, 1, 0, 1, 1, 1, 1, 0]"
19499,1,1,2,0.08167771484663766,"[0, 0, 1, 0, 0, 0, 1, 1, 0, 0]"
19500,1,1,2,0.3031360917192619,"[0, 1, 0, 1, 1, 0, 1, 0, 1, 1]"
19501,1,1,2,0.6686962683833567,"[0, 0, 0, 1, 1, 1, 1, 0, 0, 1]"
19502,1,1,2,0.8168322059354307,"[1, 1, 0, 1, 1, 1, 1, 0, 1, 0]"
19503,1,1,2,0.9656610598482047,"[0, 1, 0, 0, 0, 1, 1, 0, 1, 0]"
19504,1,1,2,0.2468294780296324,"[0, 0, 1, 0, 1, 1, 0, 0, 1, 0]"
19505,1,1,2,0.7676874226414798,"[0, 1, 0, 1, 1, 0, 1, 1, 1, 1]"
19506,1,1,2,0.6033570233223897,"[1, 1, 1, 0, 1, 1, 0, 1, 0, 0]"
19507,1,1,2,0.5699991517245053,"[0, 0, 1, 0, 0, 1, 0, 0, 1, 0]"
19508,1,1,2,0.8448589385315634,"[1, 1, 0, 1, 0, 0, 1, 1, 1, 1]"
19509,1,1,2,0.6338369589708011,"[0, 0, 1, 1, 1, 0, 0, 0, 0, 0]"
19510,1,1,2,0.3886219558408496,"[0, 1, 0, 0, 0, 0, 0, 1, 0, 1]"
19511,1,1,2,0.5991944965421732,"[1, 0, 1, 1, 0, 1, 1, 0, 1, 0]"
19512,1,1,2,0.2846881326076611,"[1, 0, 1, 0, 0, 1, 0, 0, 1, 1]"
19513,1,1,2,0.6356648615414681,"[0, 0, 0, 1, 1, 1, 1, 1, 1, 1]"
19514,1,1,2,0.6786665252067317,"[0, 1, 1, 0, 0, 1, 1, 1, 0, 0]"
19515,1,1,2,0.32655110542820454,"[0, 1, 1, 1, 1, 0, 0, 0, 1, 1]"
19516,1,1,2,0.33016861134361464,"[0, 0, 0, 1, 1, 0, 1, 1, 1, 1]"
19517,1,1,2,0.7546880219914137,"[1, 1, 1, 0, 0, 0, 0, 1, 0, 1]"
19518,1,1,2,0.45920266695386525,"[1, 1, 0, 1, 0, 0, 1, 1, 1, 1]"
19519,1,1,2,0.3139415291420615,"[1, 0, 0, 0, 0, 1, 1, 0, 1, 1]"
19520,1,1,2,0.38101107044732163,"[0, 1, 1, 0, 1, 0, 1, 1, 0, 0]"
19521,1,1,2,0.10043064135995183,"[1, 0, 0, 1, 0, 1, 0, 0, 0, 0]"
19522,1,1,2,0.45334478019473623,"[0, 0, 0, 0, 1, 0, 0, 0, 0, 0]"
19523,1,1,2,0.3102489081382024,"[1, 0, 1, 1, 0, 0, 1, 1, 1, 0]"
19524,1,1,2,0.5316989128342673,"[0, 0, 1, 1, 0, 1, 1, 0, 1, 0]"
19525,1,1,2,0.7023715848430905,"[1, 0, 0, 0, 0, 1, 0, 1, 0, 0]"
19526,1,1,2,0.9360011039609276,"[1, 0, 0, 1, 1, 1, 1, 1, 0, 1]"
19527,1,1,2,0.484190483956493,"[1, 1, 1, 0, 0, 1, 1, 0, 0, 1]"
19528,1,1,2,0.6699553618985836,"[1, 1, 0, 1, 0, 0, 1, 0, 1, 0]"
19529,1,1,2,0.060019425014537386,"[1, 0, 0, 0, 0, 1, 1, 1, 1, 0]"
19530,1,1,2,0.193319786250282,"[0, 1, 1, 0, 1, 1, 1, 0, 0, 1]"
19531,1,1,2,0.2491783436528111,"[1, 0, 1, 1, 0, 0, 0, 0, 1, 0]"
19532,1,1,2,0.3942328448342697,"[0, 1, 0, 1, 0, 0, 1, 0, 1, 1]"
19533,1,1,2,0.600653031882637,"[1, 0, 1, 1, 1, 0, 0, 0, 1, 0]"
19534,1,1,2,0.412937721478824,"[0, 0, 0, 0, 1, 0, 0, 1, 1, 1]"
19535,1,1,2,0.47777023992758305,"[0, 1, 1, 1, 0, 0, 0, 0, 0, 0]"
19536,1,1,2,0.28943548263151175,"[0, 1, 0, 0, 0, 0, 0, 0, 1, 0]"
19537,1,1,2,0.23069835970784136,"[1, 0, 1, 1, 1, 1, 0, 1, 0, 0]"
19538,1,1,2,0.8142832496239938,"[1, 0, 0, 1, 1, 0, 1, 0, 1, 1]"
19539,1,1,2,0.8669778380297392,"[1, 1, 1, 0, 1, 1, 0, 1, 1, 1]"
19540,1,1,2,0.8519845764280023,"[1, 1, 1, 0, 1, 0, 1, 1, 0, 1]"
19541,1,1,2,0.29935847865167964,"[0, 1, 0, 0, 1, 1, 0, 0, 1, 0]"
19542,1,1,2,0.17168186461898083,"[0, 0, 1, 0, 0, 1, 0, 0, 0, 0]"
19543,1,1,2,0.9669577206043403,"[0, 0, 1, 0, 1, 0, 1, 1, 1, 1]"
19544,1,1,2,0.9032772832938574,"[1, 1, 0, 0, 0, 1, 1, 1, 1, 0]"
19545,1,1,2,0.16419892447468465,"[0, 1, 0, 0, 0, 0, 0, 1, 1, 1]"
19546,1,1,2,0.6788739653124177,"[1, 1, 0, 0, 0, 1, 0, 1, 1, 0]"
19547,1,1,2,0.4130814188675419,"[1, 0, 1, 0, 0, 0, 0, 1, 0, 0]"
19548,1,1,2,0.001422069576155649,"[1, 0, 1, 0, 0, 0, 1, 0, 1, 0]"
19549,1,1,2,0.3940392458206031,"[0, 1, 0, 1, 1, 1, 1, 1, 0, 1]"
19550,1,1,2,0.5675889688511879,"[0, 1, 1, 1, 1, 0, 1, 0, 0, 1]"
19551,1,1,2,0.31774282886648386,"[0, 0, 0, 1, 0, 1, 0, 1, 1, 0]"
19552,1,1,2,0.7803556390990257,"[1, 1, 1, 1, 0, 0, 1, 0, 1, 1]"
19553,1,1,2,0.4385789817790611,"[1, 1, 1, 1, 0, 0, 0, 0, 0, 0]"
19554,1,1,2,0.9260808977939118,"[1, 1, 0, 1, 0, 1, 1, 0, 0, 0]"
19555,1,1,2,0.3471724244652282,"[1, 1, 1, 0, 0, 1, 1, 0, 0, 0]"
19556,1,1,2,0.9802753334232478,"[0, 0, 1, 0, 1, 1, 0, 0, 1, 1]"
19557,1,1,2,0.5628221074555756,"[0, 0, 0, 0, 0, 1, 1, 1, 1, 0]"
19558,1,1,2,0.09992058348938826,"[1, 0, 0, 1, 1, 1, 0, 1, 0, 1]"
19559,1,1,2,0.4472719663100345,"[1, 0, 1, 0, 0, 1, 0, 0, 0, 1]"
19560,1,1,2,0.9643082438050267,"[1, 0, 1, 1, 0, 1, 0, 1, 0, 1]"
19561,1,1,2,0.3523090875924104,"[1, 0, 1, 1, 0, 0, 0, 0, 0, 0]"
19562,1,1,2,0.7510637349401726,"[1, 0, 1, 1, 1, 0, 0, 0, 1, 0]"
19563,1,1,2,0.13026489451302303,"[0, 0, 1, 0, 1, 0, 0, 1, 1, 0]"
19564,1,1,2,0.6589276122851335,"[0, 0, 0, 1, 1, 1, 0, 0, 1, 0]"
19565,1,1,2,0.21203420278251284,"[0, 0, 0, 1, 0, 1, 1, 0, 1, 1]"
19566,1,1,2,0.21364196719250272,"[1, 1, 1, 1, 0, 1, 1, 0, 0, 0]"
19567,1,1,2,0.29982322131772343,"[0, 1, 0, 1, 0, 0, 0, 0, 1, 0]"
19568,1,1,2,0.27408333522878925,"[1, 1, 1, 1, 1, 0, 0, 1, 1, 0]"
19569,1,1,2,0.09584920116054907,"[0, 1, 0, 0, 1, 1, 1, 1, 0, 0]"
19570,1,1,2,0.3118577620095784,"[0, 1, 1, 1, 1, 0, 1, 1, 0, 1]"
19571,1,1,2,0.03826243410156194,"[1, 1, 0, 0, 1, 1, 0, 1, 0, 1]"
19572,1,1,2,0.08335307844199324,"[1, 0, 0, 1, 0, 0, 1, 0, 0, 0]"
19573,1,1,2,0.527660504516639,"[0, 1, 1, 0, 1, 0, 0, 0, 1, 1]"
19574,1,1,2,0.17739632402041505,"[0, 1, 0, 0, 1, 1, 0, 0, 1, 0]"
19575,1,1,2,0.5348470466387893,"[0, 1, 1, 0, 1, 1, 1, 1, 1, 1]"
19576,1,1,2,0.9489578082761511,"[0, 0, 1, 0, 0, 1, 0, 0, 1, 1]"
19577,1,1,2,0.8577635388792569,"[0, 0, 0, 0, 1, 1, 1, 1, 1, 1]"
19578,1,1,2,0.6142695268641255,"[1, 1, 0, 0, 1, 1, 0, 0, 1, 1]"
19579,1,1,2,0.15257005148501734,"[0, 0, 0, 1, 0, 1, 0, 0, 1, 1]"
19580,1,1,2,0.8582615433969876,"[0, 0, 1, 0, 0, 1, 0, 1, 1, 1]"
19581,1,1,2,0.5042250203069304,"[1, 0, 0, 0, 0, 0, 1, 0, 1, 1]"
19582,1,1,2,0.5604550353352677,"[1, 0, 0, 1, 1, 1, 1, 0, 0, 1]"
19583,1,1,2,0.5749222285354173,"[1, 1, 1, 0, 1, 1, 0, 0, 1, 0]"
19584,1,1,2,0.7617562525254912,"[1, 0, 1, 1, 0, 1, 0, 1, 0, 1]"
19585,1,1,2,0.7461667251910367,"[0, 0, 0, 0, 1, 1, 0, 0, 0, 1]"
19586,1,1,2,0.9301575326375991,"[0, 1, 0, 0, 0, 0, 0, 0, 1, 1]"
19587,1,1,2,0.5265978268627138,"[0, 0, 0, 0, 0, 0, 0, 1, 1, 1]"
19588,1,1,2,0.22195666865150532,"[0, 1, 1, 1, 0, 0, 0, 1, 1, 0]"
19589,1,1,2,0.22105317412665237,"[1, 0, 1, 0, 1, 0, 0, 1, 0, 0]"
19590,1,1,2,0.05247818865661913,"[1, 0, 1, 0, 0, 0, 1, 0, 1, 1]"
19591,1,1,2,0.9316089679684415,"[1, 0, 1, 0, 0, 1, 0, 0, 0, 1]"
19592,1,1,2,0.47060153195416354,"[0, 1, 1, 0, 1, 1, 0, 0, 1, 1]"
19593,1,1,2,0.07833242474734226,"[0, 1, 1, 0, 0, 1, 0, 0, 1, 0]"
19594,1,1,2,0.5276883839882095,"[0, 0, 0, 0, 0, 0, 1, 1, 1, 0]"
19595,1,1,2,0.07201682764726691,"[0, 1, 1, 1, 1, 0, 0, 0, 0, 1]"
19596,1,1,2,0.5920119487074377,"[1, 1, 1, 1, 0, 0, 1, 1, 0, 0]"
19597,1,1,2,0.9358589098010499,"[0, 1, 0, 0, 0, 1, 0, 1, 0, 0]"
19598,1,1,2,0.22175380418012136,"[0, 0, 0, 1, 1, 1, 1, 0, 0, 1]"
19599,1,1,2,0.007381499323549479,"[1, 1, 1, 0, 1, 0, 0, 1, 1, 0]"
19600,1,1,2,0.41040311847741595,"[0, 0, 1, 1, 1, 1, 1, 0, 0, 1]"
19601,1,1,2,0.7304550638793187,"[0, 0, 0, 1, 1, 0, 1, 0, 1, 1]"
19602,1,1,2,0.8778798579333144,"[1, 0, 0, 1, 0, 0, 1, 1, 1, 1]"
19603,1,1,2,0.9932098356800758,"[0, 1, 1, 0, 0, 0, 1, 0, 1, 0]"
19604,1,1,2,0.5033720652595624,"[0, 1, 0, 1, 0, 1, 1, 0, 1, 1]"
19605,1,1,2,0.5067295432101561,"[0, 0, 0, 0, 1, 1, 1, 0, 0, 0]"
19606,1,1,2,0.24518946270972197,"[0, 0, 1, 1, 1, 0, 0, 1, 1, 0]"
19607,1,1,2,0.7916961549090852,"[1, 1, 1, 1, 0, 1, 1, 0, 0, 0]"
19608,1,1,2,0.72227306935348,"[1, 1, 0, 1, 0, 0, 0, 1, 1, 0]"
19609,1,1,2,0.3618438368753918,"[0, 0, 0, 1, 0, 1, 0, 1, 0, 1]"
19610,1,1,2,0.9310793391094572,"[0, 1, 0, 1, 0, 1, 0, 0, 0, 0]"
19611,1,1,2,0.23824801532340179,"[1, 0, 0, 0, 1, 1, 1, 0, 0, 1]"
19612,1,1,2,0.11089960452982806,"[1, 1, 0, 1, 0, 1, 0, 0, 0, 1]"
19613,1,1,2,0.7264620574635428,"[1, 1, 0, 0, 1, 1, 0, 0, 1, 0]"
19614,1,1,2,0.3025618790877793,"[0, 1, 1, 1, 1, 0, 0, 0, 1, 0]"
19615,1,1,2,0.165876987832976,"[0, 1, 0, 1, 1, 1, 0, 0, 1, 1]"
19616,1,1,2,0.8368145604246249,"[1, 0, 1, 0, 1, 1, 0, 0, 0, 1]"
19617,1,1,2,0.5741497867283833,"[1, 1, 1, 1, 0, 0, 1, 0, 0, 0]"
19618,1,1,2,0.005910036812906028,"[1, 0, 1, 0, 0, 0, 1, 1, 1, 1]"
19619,1,1,2,0.324713705114303,"[1, 0, 0, 1, 0, 0, 0, 1, 1, 1]"
19620,1,1,2,0.9512662162407501,"[1, 0, 0, 1, 0, 1, 0, 1, 0, 0]"
19621,1,1,2,0.016264324497671234,"[1, 1, 1, 1, 0, 1, 0, 1, 0, 0]"
19622,1,1,2,0.9086639096946089,"[1, 1, 1, 1, 1, 1, 1, 1, 1, 1]"
19623,1,1,2,0.5975240498652469,"[1, 1, 1, 1, 0, 0, 1, 0, 1, 0]"
19624,1,1,2,0.00353386460608629,"[1, 0, 1, 1, 1, 1, 0, 1, 1, 0]"
19625,1,1,2,0.6160092221943327,"[0, 0, 0, 1, 1, 1, 0, 1, 0, 0]"
19626,1,1,2,0.15538549291018156,"[1, 0, 0, 1, 0, 1, 0, 1, 0, 1]"
19627,1,1,2,0.8671611889038158,"[1, 0, 1, 1, 0, 0, 1, 0, 0, 1]"
19628,1,1,2,0.5144153485928642,"[0, 1, 1, 0, 1, 1, 0, 0, 0, 1]"
19629,1,1,2,0.6902813970974752,"[0, 1, 1, 1, 1, 1, 1, 0, 1, 1]"
19630,1,1,2,0.04107755077277653,"[0, 0, 1, 1, 1, 0, 0, 0, 0, 0]"
19631,1,1,2,0.9581919182800078,"[1, 0, 1, 0, 0, 0, 0, 0, 1, 1]"
19632,1,1,2,0.5709344360508416,"[1, 1, 0, 1, 0, 1, 0, 1, 0, 1]"
19633,1,1,2,0.2868475508298953,"[1, 1, 0, 0, 1, 1, 0, 1, 0, 0]"
19634,1,1,2,0.7390285836908549,"[1, 1, 0, 0, 1, 0, 1, 1, 1, 1]"
19635,1,1,2,0.9696887295797872,"[0, 0, 1, 0, 1, 1, 1, 0, 0, 1]"
19636,1,1,2,0.6018775618450599,"[0, 1, 1, 0, 1, 0, 0, 1, 1, 1]"
19637,1,1,2,0.2899808032122586,"[1, 1, 0, 0, 0, 1, 0, 1, 0, 1]"
19638,1,1,2,0.12160462121176774,"[0, 0, 0, 1, 1, 1, 0, 0, 0, 1]"
19639,1,1,2,0.7827666668747457,"[1, 1, 1, 1, 1, 1, 0, 0, 1, 0]"
19640,1,1,2,0.3028305229926368,"[1, 0, 0, 0, 1, 1, 0, 1, 1, 1]"
19641,1,1,2,0.8758086906976998,"[0, 0, 0, 0, 0, 1, 0, 1, 1, 0]"
19642,1,1,2,0.13961422982596094,"[0, 0, 0, 1, 1, 1, 1, 0, 1, 0]"
19643,1,1,2,0.9776688567443834,"[0, 1, 0, 0, 0, 0, 0, 0, 0, 1]"
19644,1,1,2,0.22086019148655744,"[0, 0, 0, 0, 1, 1, 0, 0, 0, 0]"
19645,1,1,2,0.7995722251327664,"[1, 0, 1, 1, 0, 1, 0, 0, 1, 0]"
19646,1,1,2,0.3907090218754464,"[0, 1, 1, 0, 1, 0, 0, 0, 1, 1]"
19647,1,1,2,0.3263638199437151,"[1, 0, 1, 0, 0, 1, 0, 1, 0, 0]"
19648,1,1,2,0.3220748128891314,"[1, 1, 1, 1, 0, 0, 0, 1, 0, 1]"
19649,1,1,2,0.23423979390702032,"[0, 1, 0, 1, 1, 1, 1, 0, 0, 1]"
19650,1,1,2,0.06745788635691041,"[0, 0, 1, 0, 0, 1, 0, 1, 0, 0]"
19651,1,1,2,0.22941191228231572,"[1, 0, 1, 1, 0, 1, 0, 1, 1, 1]"
19652,1,1,2,0.37677840707209864,"[0, 1, 1, 0, 0, 0, 1, 0, 0, 0]"
19653,1,1,2,0.1364801658413879,"[0, 0, 0, 1, 0, 0, 1, 1, 1, 1]"
19654,1,1,2,0.471325281905437,"[1, 0, 1, 0, 1, 1, 0, 1, 0, 1]"
19655,1,1,2,0.7264205233494154,"[1, 1, 0, 0, 0, 0, 1, 0, 0, 1]"
19656,1,1,2,0.07189182451848708,"[0, 0, 1, 0, 1, 1, 1, 1, 0, 1]"
19657,1,1,2,0.08417841868764941,"[1, 0, 1, 1, 0, 1, 0, 0, 0, 1]"
19658,1,1,2,0.9271990460690682,"[1, 1, 1, 1, 0, 0, 0, 0, 0, 0]"
19659,1,1,2,0.3679374811601016,"[1, 1, 0, 0, 1, 0, 0, 0, 0, 1]"
19660,1,1,2,0.47798197717894353,"[0, 1, 0, 1, 0, 1, 1, 1, 1, 0]"
19661,1,1,2,0.13935287766609683,"[0, 0, 0, 0, 0, 0, 0, 0, 1, 1]"
19662,1,1,2,0.42343387147218037,"[1, 1, 0, 0, 0, 0, 1, 0, 0, 0]"
19663,1,1,2,0.8862728766146996,"[0, 1, 0, 1, 1, 1, 1, 0, 0, 0]"
19664,1,1,2,0.23300493613327655,"[0, 0, 0, 0, 1, 1, 0, 1, 1, 0]"
19665,1,1,2,0.16504022615125202,"[0, 0, 0, 0, 0, 1, 0, 0, 0, 1]"
19666,1,1,2,0.7990786284010345,"[1, 0, 1, 0, 1, 1, 1, 1, 1, 0]"
19667,1,1,2,0.45353122274002033,"[1, 1, 0, 1, 0, 1, 1, 0, 0, 0]"
19668,1,1,2,0.29190897661218507,"[1, 0, 1, 0, 0, 1, 1, 0, 1, 0]"
19669,1,1,2,0.7050481923970539,"[1, 0, 1, 0, 0, 1, 1, 0, 0, 0]"
19670,1,1,2,0.8775301221787285,"[0, 1, 1, 0, 1, 1, 1, 0, 0, 0]"
19671,1,1,2,0.7140570495846508,"[0, 0, 0, 1, 1, 0, 0, 0, 1, 1]"
19672,1,1,2,0.5319836715327407,"[0, 1, 0, 1, 0, 1, 1, 1, 0, 1]"
19673,1,1,2,0.683936999144523,"[0, 1, 1, 0, 1, 0, 1, 0, 1, 1]"
19674,1,1,2,0.48379509351705463,"[1, 1, 0, 1, 0, 1, 1, 1, 1, 1]"
19675,1,1,2,0.9599978680827088,"[0, 1, 0, 0, 1, 1, 1, 0, 1, 0]"
19676,1,1,2,0.40722060728445675,"[0, 1, 0, 0, 1, 1, 0, 0, 1, 0]"
19677,1,1,2,0.7622100281031409,"[1, 1, 0, 1, 1, 1, 0, 1, 1, 1]"
19678,1,1,2,0.6117521464727043,"[1, 1, 0, 1, 1, 1, 1, 0, 1, 1]"
19679,1,1,2,0.06929876299624149,"[0, 0, 1, 0, 1, 1, 0, 0, 1, 1]"
19680,1,1,2,0.220387973995833,"[1, 0, 0, 0, 1, 0, 1, 1, 0, 0]"
19681,1,1,2,0.27283589316094436,"[0, 0, 1, 0, 0, 1, 1, 1, 1, 1]"
19682,1,1,2,0.2771651855340115,"[0, 0, 0, 1, 0, 1, 1, 1, 0, 0]"
19683,1,1,2,0.010669214728240894,"[1, 1, 0, 1, 1, 0, 1, 0, 1, 0]"
19684,1,1,2,0.7333642683238317,"[0, 1, 1, 0, 1, 0, 1, 1, 0, 1]"
19685,1,1,2,0.7296889586355786,"[0, 0, 1, 0, 1, 1, 0, 0, 1, 0]"
19686,1,1,2,0.8639081360514697,"[0, 0, 0, 1, 1, 0, 1, 1, 1, 1]"
19687,1,1,2,0.35491217254023744,"[1, 1, 1, 1, 0, 0, 1, 1, 1, 1]"
19688,1,1,2,0.42495770066995064,"[0, 1, 1, 0, 1, 0, 1, 0, 1, 1]"
19689,1,1,2,0.8079776815961344,"[1, 1, 0, 1, 1, 0, 0, 0, 0, 1]"
19690,1,1,2,0.07076365545922625,"[1, 1, 0, 0, 0, 0, 0, 0, 0, 0]"
19691,1,1,2,0.7544962351322453,"[0, 1, 1, 0, 1, 1, 0, 1, 1, 1]"
19692,1,1,2,0.8510384429870155,"[0, 0, 1, 0, 0, 0, 1, 0, 0, 0]"
19693,1,1,2,0.3421156222368884,"[0, 1, 1, 1, 0, 1, 1, 0, 0, 0]"
19694,1,1,2,0.6547960923004359,"[0, 0, 1, 1, 1, 0, 0, 0, 0, 1]"
19695,1,1,2,0.12502237255554982,"[1, 1, 0, 0, 1, 0, 0, 1, 0, 0]"
19696,1,1,2,0.04083511403762918,"[1, 0, 1, 0, 1, 1, 1, 0, 0, 0]"
19697,1,1,2,0.3536973545405986,"[1, 0, 1, 0, 0, 0, 1, 1, 0, 1]"
19698,1,1,2,0.33369623032481555,"[1, 0, 1, 1, 1, 0, 1, 1, 1, 0]"
19699,1,1,2,0.6797261191876666,"[0, 0, 1, 0, 0, 1, 1, 0, 0, 1]"
19700,1,1,2,0.8433244515256911,"[0, 0, 0, 1, 1, 1, 0, 0, 0, 0]"
19701,1,1,2,0.0510754130167127,"[1, 0, 1, 0, 1, 1, 0, 1, 1, 0]"
19702,1,1,2,0.7709374665408405,"[0, 0, 1, 1, 1, 0, 0, 1, 0, 0]"
19703,1,1,2,0.35832265001691677,"[0, 1, 0, 0, 0, 0, 1, 0, 0, 1]"
19704,1,1,2,0.9134274992442311,"[0, 0, 1, 1, 0, 1, 0, 0, 0, 1]"
19705,1,1,2,0.9697201692058455,"[0, 0, 1, 1, 0, 0, 0, 1, 0, 0]"
19706,1,1,2,0.9881189747218204,"[0, 0, 1, 0, 0, 0, 1, 1, 0, 1]"
19707,1,1,2,0.07769125802128984,"[0, 0, 1, 1, 0, 1, 1, 1, 0, 0]"
19708,1,1,2,0.6717880822794516,"[0, 0, 0, 1, 0, 1, 0, 1, 1, 1]"
19709,1,1,2,0.8764034652543464,"[1, 1, 0, 0, 0, 1, 0, 0, 1, 1]"
19710,1,1,2,0.52105987754649,"[1, 1, 0, 0, 0, 1, 0, 0, 1, 1]"
19711,1,1,2,0.22435205328208097,"[1, 0, 1, 1, 1, 1, 0, 0, 1, 1]"
19712,1,1,2,0.6847517039401532,"[0, 0, 1, 1, 1, 0, 0, 0, 0, 0]"
19713,1,1,2,0.9997914296291385,"[1, 1, 0, 0, 1, 0, 0, 1, 1, 1]"
19714,1,1,2,0.2904576543086266,"[0, 0, 0, 1, 0, 0, 0, 1, 1, 1]"
19715,1,1,2,0.9005599054126514,"[0, 0, 0, 1, 0, 1, 1, 0, 1, 1]"
19716,1,1,2,0.16166054344273884,"[0, 1, 1, 1, 1, 1, 1, 1, 1, 1]"
19717,1,1,2,0.9675475547607424,"[1, 1, 1, 1, 0, 0, 1, 0, 1, 0]"
19718,1,1,2,0.9395208228287735,"[0, 1, 0, 1, 1, 0, 1, 0, 1, 1]"
19719,1,1,2,0.8912709224864896,"[1, 1, 1, 1, 1, 1, 1, 1, 0, 1]"
19720,1,1,2,0.8698561299299418,"[0, 1, 1, 0, 0, 0, 1, 1, 1, 0]"
19721,1,1,2,0.18226535880134342,"[0, 0, 1, 0, 0, 0, 1, 0, 1, 1]"
19722,1,1,2,0.8091972118328373,"[0, 1, 1, 0, 0, 0, 1, 0, 0, 1]"
19723,1,1,2,0.6171988397838353,"[0, 1, 1, 1, 0, 1, 1, 0, 0, 1]"
19724,1,1,2,0.4220519842441791,"[1, 0, 0, 1, 1, 1, 1, 1, 1, 1]"
19725,1,1,2,0.708433918114524,"[1, 0, 1, 1, 1, 0, 0, 0, 0, 0]"
19726,1,1,2,0.7791623050190796,"[0, 0, 1, 0, 0, 1, 0, 0, 0, 0]"
19727,1,1,2,0.5966440306135423,"[1, 1, 0, 0, 0, 0, 1, 1, 0, 1]"
19728,1,1,2,0.21657345086746016,"[0, 0, 0, 0, 1, 1, 1, 0, 0, 0]"
19729,1,1,2,0.1867440668758784,"[1, 1, 0, 0, 0, 1, 1, 1, 1, 1]"
19730,1,1,2,0.7079330730734674,"[1, 1, 0, 1, 0, 0, 0, 0, 1, 0]"
19731,1,1,2,0.9990887357506881,"[0, 0, 1, 0, 1, 0, 1, 1, 1, 1]"
19732,1,1,2,0.305890303834501,"[0, 1, 1, 1, 1, 0, 0, 0, 0, 1]"
19733,1,1,2,0.9607755351551651,"[1, 1, 0, 0, 1, 1, 1, 0, 0, 1]"
19734,1,1,2,0.31521632603912075,"[0, 0, 1, 1, 0, 0, 1, 1, 0, 1]"
19735,1,1,2,0.09922804808723407,"[0, 0, 1, 0, 1, 1, 0, 1, 1, 1]"
19736,1,1,2,0.3330102589469728,"[1, 0, 0, 1, 0, 0, 0, 0, 0, 1]"
19737,1,1,2,0.27475470056190143,"[1, 1, 1, 1, 1, 0, 0, 1, 0, 1]"
19738,1,1,2,0.8152747125503637,"[1, 0, 0, 1, 0, 0, 0, 0, 1, 0]"
19739,1,1,2,0.08349330272750288,"[0, 0, 1, 1, 0, 0, 0, 0, 1, 1]"
19740,1,1,2,0.4610498154598711,"[1, 1, 0, 1, 0, 1, 1, 0, 0, 0]"
19741,1,1,2,0.5079860092266042,"[1, 0, 0, 1, 0, 0, 1, 1, 0, 1]"
19742,1,1,2,0.3250908706600584,"[1, 1, 1, 1, 0, 1, 1, 0, 0, 0]"
19743,1,1,2,0.3049104135593729,"[0, 1, 1, 1, 0, 0, 0, 0, 1, 1]"
19744,1,1,2,0.2330491202912479,"[0, 1, 1, 0, 0, 1, 0, 1, 0, 1]"
19745,1,1,2,0.8940792736873511,"[1, 1, 1, 1, 0, 0, 0, 1, 1, 0]"
19746,1,1,2,0.14442472197847978,"[0, 1, 0, 0, 1, 1, 1, 0, 0, 0]"
19747,1,1,2,0.6883349987696982,"[1, 1, 1, 1, 1, 0, 0, 0, 1, 0]"
19748,1,1,2,0.15214727934541694,"[1, 1, 1, 1, 1, 1, 1, 0, 0, 1]"
19749,1,1,2,0.2730849324025879,"[1, 1, 1, 1, 1, 1, 0, 0, 1, 0]"
19750,1,1,2,0.09832473517689544,"[0, 1, 0, 1, 0, 0, 0, 0, 0, 0]"
19751,1,1,2,0.06216043357084866,"[1, 1, 1, 1, 1, 1, 0, 1, 0, 1]"
19752,1,1,2,0.9654190352990711,"[1, 1, 1, 1, 0, 0, 0, 1, 0, 0]"
19753,1,1,2,0.47091054298820567,"[0, 0, 1, 1, 0, 1, 0, 1, 1, 0]"
19754,1,1,2,0.18558383662643918,"[0, 1, 0, 1, 1, 0, 1, 0, 1, 1]"
19755,1,1,2,0.34767440803486516,"[0, 1, 1, 0, 1, 1, 0, 1, 1, 1]"
19756,1,1,2,0.0003171056266760841,"[1, 0, 1, 1, 1, 1, 1, 1, 0, 0]"
19757,1,1,2,0.33264675984807845,"[1, 0, 0, 1, 0, 1, 0, 1, 1, 1]"
19758,1,1,2,0.018662426310519398,"[0, 1, 1, 1, 1, 1, 1, 0, 1, 0]"
19759,1,1,2,0.6915637735833686,"[0, 1, 1, 1, 0, 1, 1, 0, 1, 1]"
19760,1,1,2,0.9961920674358656,"[0, 1, 1, 1, 1, 1, 1, 0, 0, 0]"
19761,1,1,2,0.25951421394681395,"[0, 0, 1, 1, 1, 1, 1, 0, 0, 1]"
19762,1,1,2,0.6595425153994187,"[1, 0, 1, 0, 0, 1, 0, 1, 1, 1]"
19763,1,1,2,0.998830714888518,"[0, 1, 1, 1, 1, 0, 1, 0, 0, 1]"
19764,1,1,2,0.7075834817165804,"[1, 1, 0, 1, 1, 0, 1, 0, 1, 0]"
19765,1,1,2,0.03737946730703745,"[1, 1, 0, 1, 1, 0, 1, 1, 0, 0]"
19766,1,1,2,0.6289530344252187,"[1, 1, 1, 0, 0, 1, 0, 1, 0, 0]"
19767,1,1,2,0.9742655348223207,"[1, 0, 1, 1, 0, 0, 1, 0, 0, 0]"
19768,1,1,2,0.8341764469936285,"[1, 0, 1, 1, 0, 1, 0, 0, 0, 0]"
19769,1,1,2,0.7865146256533279,"[1, 1, 0, 1, 0, 1, 1, 1, 1, 0]"
19770,1,1,2,0.3374646002218359,"[0, 0, 1, 1, 1, 0, 1, 1, 0, 0]"
19771,1,1,2,0.2340640582414888,"[1, 0, 1, 0, 0, 1, 0, 1, 1, 0]"
19772,1,1,2,0.8235364157057642,"[1, 1, 1, 0, 0, 1, 1, 0, 1, 0]"
19773,1,1,2,0.8947730719177336,"[1, 0, 1, 1, 0, 0, 1, 1, 0, 1]"
19774,1,1,2,0.44117030861205264,"[1, 0, 0, 0, 1, 0, 0, 0, 1, 0]"
19775,1,1,2,0.05470936988809916,"[1, 0, 1, 1, 1, 1, 0, 0, 0, 0]"
19776,1,1,2,0.8479132221675977,"[1, 0, 1, 0, 1, 1, 0, 0, 0, 0]"
19777,1,1,2,0.5715594998693656,"[1, 1, 1, 0, 1, 1, 1, 0, 0, 1]"
19778,1,1,2,0.28785139508685387,"[0, 0, 1, 1, 1, 0, 0, 1, 1, 1]"
19779,1,1,2,0.6466033654784763,"[0, 0, 0, 1, 0, 0, 0, 0, 1, 0]"
19780,1,1,2,0.36184168195085653,"[0, 1, 1, 1, 1, 0, 0, 1, 0, 1]"
19781,1,1,2,0.8521966593125361,"[0, 1, 0, 1, 0, 0, 1, 0, 1, 0]"
19782,1,1,2,0.5096084003062794,"[0, 0, 0, 0, 1, 1, 0, 1, 0, 1]"
19783,1,1,2,0.7299496358848032,"[1, 1, 1, 0, 0, 0, 1, 0, 0, 0]"
19784,1,1,2,0.6507812575933047,"[0, 0, 0, 1, 0, 1, 0, 1, 0, 0]"
19785,1,1,2,0.30576451585880615,"[1, 1, 0, 1, 1, 1, 1, 0, 1, 0]"
19786,1,1,2,0.023708780765670734,"[1, 1, 0, 0, 1, 0, 1, 1, 1, 0]"
19787,1,1,2,0.780494502167713,"[0, 1, 0, 0, 0, 0, 0, 0, 1, 0]"
19788,1,1,2,0.17217066183873486,"[1, 0, 1, 0, 0, 1, 0, 1, 0, 0]"
19789,1,1,2,0.5611475828811856,"[1, 1, 0, 0, 1, 1, 1, 1, 1, 1]"
19790,1,1,2,0.8077178470498255,"[1, 0, 0, 1, 1, 1, 1, 0, 1, 1]"
19791,1,1,2,0.23532551819769598,"[0, 0, 0, 0, 1, 1, 1, 0, 1, 0]"
19792,1,1,2,0.4981514519055914,"[0, 0, 0, 0, 0, 1, 0, 0, 1, 0]"
19793,1,1,2,0.33639405430893077,"[1, 1, 1, 0, 0, 0, 1, 0, 0, 1]"
19794,1,1,2,0.07193723987741485,"[0, 1, 1, 1, 1, 1, 1, 0, 1, 0]"
19795,1,1,2,0.8940172498585076,"[0, 1, 1, 0, 1, 0, 0, 0, 0, 0]"
19796,1,1,2,0.47464487230640184,"[1, 1, 0, 1, 0, 1, 1, 0, 0, 0]"
19797,1,1,2,0.37680728091143323,"[0, 0, 0, 0, 1, 1, 1, 0, 0, 1]"
19798,1,1,2,0.6257319641750679,"[1, 1, 0, 0, 0, 0, 0, 1, 1, 0]"
19799,1,1,2,0.3904362567171442,"[1, 0, 1, 0, 0, 0, 0, 0, 0, 1]"
19800,1,1,2,0.21905572461045164,"[0, 1, 0, 0, 1, 0, 1, 1, 1, 0]"
19801,1,1,2,0.5299371914185174,"[1, 1, 1, 1, 1, 1, 1, 0, 1, 1]"
19802,1,1,2,0.8644343811639512,"[1, 1, 0, 1, 0, 0, 0, 0, 0, 0]"
19803,1,1,2,0.07483145705236949,"[1, 1, 0, 0, 1, 0, 0, 0, 1, 1]"
19804,1,1,2,0.3405943925291076,"[1, 1, 0, 0, 0, 0, 1, 1, 0, 1]"
19805,1,1,2,0.7605205780210267,"[0, 0, 1, 0, 1, 0, 0, 1, 1, 0]"
19806,1,1,2,0.7924738978298884,"[0, 1, 1, 0, 1, 1, 0, 0, 0, 1]"
19807,1,1,2,0.10927886771956441,"[0, 0, 1, 0, 0, 1, 0, 1, 0, 1]"
19808,1,1,2,0.8761219945631171,"[0, 1, 0, 1, 0, 0, 0, 0, 1, 0]"
19809,1,1,2,0.23822617189408268,"[0, 1, 0, 1, 0, 1, 1, 0, 0, 0]"
19810,1,1,2,0.5129866150990438,"[0, 1, 1, 0, 0, 0, 1, 0, 1, 0]"
19811,1,1,2,0.8156231407778909,"[1, 1, 0, 0, 0, 0, 1, 1, 1, 1]"
19812,1,1,2,0.7061742338952458,"[0, 0, 1, 0, 0, 0, 1, 0, 1, 0]"
19813,1,1,2,0.8543625692225354,"[1, 0, 1, 0, 1, 1, 0, 0, 0, 1]"
19814,1,1,2,0.2795946612044109,"[0, 1, 0, 0, 0, 1, 0, 0, 0, 0]"
19815,1,1,2,0.6509673013917912,"[1, 1, 1, 0, 1, 0, 1, 0, 0, 1]"
19816,1,1,2,0.3617636824936452,"[1, 1, 0, 1, 1, 1, 1, 1, 0, 0]"
19817,1,1,2,0.3738236718200818,"[0, 1, 1, 0, 0, 1, 1, 1, 1, 1]"
19818,1,1,2,0.9511215001109712,"[0, 0, 1, 0, 1, 1, 0, 0, 1, 0]"
19819,1,1,2,0.9909025095110773,"[0, 1, 0, 0, 1, 1, 0, 1, 1, 1]"
19820,1,1,2,0.24926629896432106,"[0, 0, 0, 1, 1, 0, 1, 1, 1, 1]"
19821,1,1,2,0.6865470705114348,"[0, 0, 1, 0, 1, 0, 0, 0, 1, 1]"
19822,1,1,2,0.25833723634743133,"[1, 1, 1, 1, 0, 0, 1, 0, 0, 1]"
19823,1,1,2,0.2368115869141807,"[1, 0, 1, 1, 0, 1, 0, 1, 1, 1]"
19824,1,1,2,0.9562424409913318,"[0, 0, 1, 1, 0, 1, 0, 0, 1, 0]"
19825,1,1,2,0.6945441256230506,"[1, 1, 0, 1, 1, 0, 1, 0, 1, 0]"
19826,1,1,2,0.5592316062612951,"[0, 1, 1, 1, 1, 0, 0, 1, 0, 1]"
19827,1,1,2,0.6194967102353478,"[0, 0, 0, 1, 1, 1, 1, 1, 1, 0]"
19828,1,1,2,0.0749474852809181,"[0, 0, 0, 1, 0, 1, 0, 1, 0, 1]"
19829,1,1,2,0.59314810725455,"[0, 1, 0, 1, 0, 1, 0, 0, 1, 0]"
19830,1,1,2,0.5202078899804933,"[1, 1, 0, 1, 1, 0, 1, 1, 0, 0]"
19831,1,1,2,0.7651716795237873,"[1, 0, 0, 0, 1, 1, 0, 1, 0, 1]"
19832,1,1,2,0.0834435753123488,"[1, 0, 1, 1, 1, 1, 0, 1, 0, 0]"
19833,1,1,2,0.16264758696395798,"[0, 0, 0, 0, 0, 1, 0, 1, 0, 1]"
19834,1,1,2,0.46809062163353954,"[0, 0, 0, 1, 0, 0, 1, 0, 1, 1]"
19835,1,1,2,0.9680961791306554,"[1, 1, 0, 1, 1, 1, 1, 1, 0, 0]"
19836,1,1,2,0.12278930970102808,"[0, 1, 1, 0, 0, 0, 0, 1, 0, 0]"
19837,1,1,2,0.30119308622246543,"[1, 1, 0, 1, 0, 0, 1, 0, 0, 0]"
19838,1,1,2,0.11208629290821348,"[0, 1, 1, 1, 0, 0, 0, 0, 1, 0]"
19839,1,1,2,0.9585347329315045,"[1, 1, 0, 1, 0, 1, 1, 1, 1, 1]"
19840,1,1,2,0.864692153725572,"[1, 0, 0, 1, 0, 0, 0, 0, 1, 0]"
19841,1,1,2,0.5839120836535869,"[1, 0, 0, 1, 1, 0, 0, 1, 1, 0]"
19842,1,1,2,0.3164087748634272,"[0, 0, 1, 1, 0, 1, 1, 1, 0, 1]"
19843,1,1,2,0.9175766339980409,"[0, 1, 1, 0, 0, 0, 0, 1, 1, 0]"
19844,1,1,2,0.538809316772742,"[0, 1, 0, 0, 1, 1, 0, 0, 0, 0]"
19845,1,1,2,0.31114312494295915,"[0, 0, 1, 0, 0, 0, 1, 1, 1, 1]"
19846,1,1,2,0.37423967162587624,"[1, 1, 0, 0, 0, 1, 1, 0, 1, 1]"
19847,1,1,2,0.6624578818304752,"[0, 1, 0, 1, 0, 0, 1, 1, 1, 1]"
19848,1,1,2,0.3586372862512719,"[0, 1, 0, 1, 1, 0, 0, 0, 1, 1]"
19849,1,1,2,0.7798096680283964,"[1, 1, 0, 1, 1, 1, 1, 1, 1, 1]"
19850,1,1,2,0.32582388910708293,"[1, 0, 1, 1, 0, 0, 0, 0, 0, 1]"
19851,1,1,2,0.4374370641286358,"[0, 0, 0, 1, 0, 0, 1, 0, 0, 1]"
19852,1,1,2,0.9739142273500566,"[0, 0, 0, 0, 0, 1, 1, 1, 0, 1]"
19853,1,1,2,0.6784895474934047,"[1, 0, 0, 1, 1, 0, 0, 0, 0, 0]"
19854,1,1,2,0.8121552020648926,"[1, 0, 0, 0, 0, 0, 1, 0, 0, 0]"
19855,1,1,2,0.16758698405783579,"[0, 1, 0, 1, 1, 1, 1, 1, 1, 1]"
19856,1,1,2,0.7099826334501892,"[0, 0, 1, 0, 1, 1, 0, 0, 1, 0]"
19857,1,1,2,0.18219802237642801,"[1, 1, 1, 0, 0, 0, 1, 1, 1, 1]"
19858,1,1,2,0.13221275059781834,"[0, 1, 1, 0, 0, 1, 0, 1, 0, 1]"
19859,1,1,2,0.6956690172137093,"[1, 1, 0, 0, 0, 0, 0, 1, 0, 1]"
19860,1,1,2,0.41245687531436503,"[0, 1, 0, 0, 0, 0, 0, 0, 0, 0]"
19861,1,1,2,0.020581396722186507,"[1, 1, 0, 1, 1, 0, 1, 0, 0, 0]"
19862,1,1,2,0.9013425247434412,"[1, 1, 0, 0, 1, 0, 0, 1, 1, 1]"
19863,1,1,2,0.9497445675258731,"[0, 0, 0, 1, 1, 1, 1, 1, 1, 0]"
19864,1,1,2,0.6736626290306484,"[0, 0, 0, 1, 0, 0, 1, 1, 1, 0]"
19865,1,1,2,0.5700319852279248,"[0, 1, 0, 1, 0, 0, 0, 1, 0, 0]"
19866,1,1,2,0.5852096111262615,"[0, 1, 1, 1, 1, 0, 1, 1, 0, 0]"
19867,1,1,2,0.2715534080554931,"[1, 1, 1, 0, 0, 1, 1, 1, 0, 1]"
19868,1,1,2,0.25756028705787326,"[0, 0, 1, 0, 0, 1, 0, 0, 1, 0]"
19869,1,1,2,0.17834811904063863,"[1, 1, 1, 1, 1, 1, 0, 1, 0, 0]"
19870,1,1,2,0.9590562662023342,"[0, 0, 1, 0, 1, 0, 1, 0, 0, 1]"
19871,1,1,2,0.7001953163534295,"[0, 0, 0, 1, 1, 1, 1, 1, 1, 1]"
19872,1,1,2,0.5521113754235485,"[0, 0, 0, 1, 0, 0, 0, 0, 0, 1]"
19873,1,1,2,0.7816653992470973,"[1, 1, 0, 0, 1, 1, 0, 0, 1, 0]"
19874,1,1,2,0.45433285569158677,"[1, 1, 0, 1, 1, 0, 0, 0, 1, 1]"
19875,1,1,2,0.13044631491710945,"[1, 0, 1, 0, 0, 1, 0, 0, 1, 0]"
19876,1,1,2,0.2648163674874071,"[0, 0, 1, 0, 1, 0, 0, 0, 0, 0]"
19877,1,1,2,0.30324294499456006,"[0, 1, 1, 0, 1, 1, 1, 1, 1, 1]"
19878,1,1,2,0.34757914183685457,"[0, 1, 1, 1, 1, 1, 1, 1, 1, 1]"
19879,1,1,2,0.271039520035549,"[1, 1, 1, 1, 0, 0, 0, 0, 1, 1]"
19880,1,1,2,0.197894792445364,"[0, 1, 1, 1, 1, 1, 0, 0, 1, 1]"
19881,1,1,2,0.8766707041364028,"[1, 0, 1, 0, 1, 1, 0, 1, 1, 1]"
19882,1,1,2,0.8444096816309242,"[1, 1, 1, 1, 1, 0, 0, 1, 0, 1]"
19883,1,1,2,0.890589527661935,"[0, 1, 1, 1, 1, 1, 1, 0, 0, 0]"
19884,1,1,2,0.1981284055437441,"[1, 1, 1, 1, 1, 1, 0, 1, 1, 1]"
19885,1,1,2,0.6998255605136096,"[0, 0, 1, 0, 0, 0, 0, 1, 0, 1]"
19886,1,1,2,0.27883730949634256,"[0, 0, 1, 1, 0, 1, 1, 1, 0, 0]"
19887,1,1,2,0.15108479105635142,"[0, 1, 0, 0, 1, 1, 0, 0, 0, 0]"
19888,1,1,2,0.077344746353048,"[0, 0, 1, 0, 0, 0, 1, 1, 1, 0]"
19889,1,1,2,0.8841972931533219,"[1, 0, 0, 1, 1, 1, 0, 1, 0, 0]"
19890,1,1,2,0.02261425074179224,"[1, 0, 1, 1, 1, 0, 0, 0, 0, 1]"
19891,1,1,2,0.7405862067461196,"[1, 1, 1, 1, 0, 1, 1, 1, 0, 0]"
19892,1,1,2,0.23426622562099464,"[0, 0, 0, 0, 0, 0, 0, 1, 0, 0]"
19893,1,1,2,0.2394802459248475,"[0, 1, 0, 0, 0, 1, 1, 1, 0, 0]"
19894,1,1,2,0.2260106714370067,"[0, 0, 0, 0, 0, 0, 0, 1, 1, 1]"
19895,1,1,2,0.7839975242851971,"[0, 1, 0, 0, 0, 1, 0, 0, 0, 1]"
19896,1,1,2,0.9327807766362262,"[1, 0, 1, 0, 0, 1, 1, 0, 1, 0]"
19897,1,1,2,0.6607880056873792,"[0, 0, 0, 1, 1, 0, 1, 1, 0, 1]"
19898,1,1,2,0.4895724257907974,"[0, 1, 1, 1, 0, 0, 1, 0, 0, 1]"
19899,1,1,2,0.08099491327171005,"[0, 0, 0, 1, 0, 1, 1, 1, 1, 0]"
19900,1,1,2,0.21584973000210084,"[1, 1, 1, 1, 1, 1, 1, 1, 0, 0]"
19901,1,1,2,0.32250422479141583,"[0, 1, 1, 0, 0, 1, 0, 0, 1, 1]"
19902,1,1,2,0.9350495467588805,"[0, 1, 0, 0, 1, 1, 0, 0, 1, 0]"
19903,1,1,2,0.8967131318200421,"[1, 1, 1, 1, 0, 1, 0, 1, 1, 0]"
19904,1,1,2,0.6885725169478849,"[1, 0, 0, 0, 1, 1, 0, 0, 1, 1]"
19905,1,1,2,0.5684858270790228,"[1, 1, 1, 0, 1, 1, 1, 1, 1, 1]"
19906,1,1,2,0.48131859205631733,"[0, 1, 1, 0, 1, 0, 0, 0, 0, 0]"
19907,1,1,2,0.702995341880971,"[0, 0, 1, 1, 1, 0, 0, 0, 0, 1]"
19908,1,1,2,0.49733224753035754,"[1, 1, 0, 0, 1, 0, 1, 1, 0, 1]"
19909,1,1,2,0.6302015507858748,"[0, 0, 1, 1, 0, 0, 0, 1, 0, 1]"
19910,1,1,2,0.46887280166947043,"[1, 0, 1, 0, 1, 0, 0, 1, 1, 0]"
19911,1,1,2,0.8486377999986582,"[0, 0, 1, 1, 0, 1, 0, 1, 1, 1]"
19912,1,1,2,0.7394510398885706,"[0, 1, 0, 1, 1, 1, 0, 1, 1, 0]"
19913,1,1,2,0.44975212612890947,"[0, 1, 0, 0, 1, 1, 0, 0, 0, 1]"
19914,1,1,2,0.8291411910451152,"[1, 0, 0, 1, 0, 0, 0, 0, 0, 0]"
19915,1,1,2,0.46306057290930314,"[1, 0, 1, 1, 0, 0, 1, 1, 0, 0]"
19916,1,1,2,0.06950710185292996,"[1, 0, 0, 1, 1, 0, 1, 0, 1, 1]"
19917,1,1,2,0.18165308453632856,"[0, 1, 1, 1, 0, 0, 0, 0, 0, 1]"
19918,1,1,2,0.8486045023080638,"[0, 1, 0, 1, 0, 0, 0, 1, 0, 0]"
19919,1,1,2,0.6956669722718329,"[1, 0, 1, 0, 0, 1, 1, 0, 0, 0]"
19920,1,1,2,0.1355249464239403,"[0, 1, 0, 0, 1, 0, 1, 0, 0, 0]"
19921,1,1,2,0.15106485671563796,"[1, 1, 0, 1, 0, 0, 0, 0, 0, 1]"
19922,1,1,2,0.9754111013406409,"[0, 0, 1, 0, 0, 1, 1, 1, 0, 1]"
19923,1,1,2,0.16626292402388942,"[1, 1, 1, 0, 0, 0, 1, 0, 1, 1]"
19924,1,1,2,0.9454730832221383,"[1, 1, 1, 0, 0, 0, 1, 0, 1, 0]"
19925,1,1,2,0.42654758362492695,"[0, 0, 0, 1, 0, 0, 1, 0, 1, 0]"
19926,1,1,2,0.9579563728883623,"[0, 1, 1, 0, 1, 0, 0, 0, 0, 1]"
19927,1,1,2,0.8549846853924205,"[1, 0, 0, 1, 0, 0, 0, 0, 0, 1]"
19928,1,1,2,0.7304154835864124,"[1, 1, 0, 1, 1, 1, 0, 1, 0, 1]"
19929,1,1,2,0.12244314179273041,"[0, 0, 0, 1, 1, 1, 1, 1, 0, 1]"
19930,1,1,2,0.9992439219432274,"[0, 1, 0, 0, 0, 1, 1, 1, 0, 1]"
19931,1,1,2,0.2066922791243021,"[1, 0, 0, 1, 0, 1, 0, 0, 1, 0]"
19932,1,1,2,0.06025059208981276,"[0, 0, 0, 1, 0, 1, 1, 1, 0, 0]"
19933,1,1,2,0.1838855565962837,"[1, 0, 0, 1, 0, 1, 1, 0, 1, 1]"
19934,1,1,2,0.6684242789129705,"[0, 1, 0, 1, 1, 0, 1, 1, 1, 0]"
19935,1,1,2,0.04783063125653175,"[1, 0, 0, 0, 0, 0, 0, 1, 0, 1]"
19936,1,1,2,0.5008029431910934,"[0, 0, 1, 0, 0, 1, 0, 1, 1, 1]"
19937,1,1,2,0.4378310779876914,"[0, 1, 1, 1, 1, 1, 1, 1, 0, 1]"
19938,1,1,2,0.0695584351652887,"[1, 1, 0, 1, 0, 1, 0, 1, 1, 1]"
19939,1,1,2,0.18232337439780621,"[1, 0, 0, 0, 1, 0, 0, 0, 0, 0]"
19940,1,1,2,0.02020764195070035,"[0, 0, 1, 1, 1, 0, 1, 0, 1, 1]"
19941,1,1,2,0.0763564054591166,"[1, 1, 1, 1, 0, 0, 0, 1, 0, 1]"
19942,1,1,2,0.8157136934138185,"[1, 1, 0, 0, 1, 0, 1, 1, 1, 1]"
19943,1,1,2,0.7580220225347674,"[1, 1, 1, 1, 0, 1, 1, 1, 1, 0]"
19944,1,1,2,0.6641579471451718,"[0, 0, 0, 0, 1, 1, 1, 0, 1, 1]"
19945,1,1,2,0.7151642019915103,"[0, 1, 0, 1, 0, 0, 0, 0, 1, 0]"
19946,1,1,2,0.32581782483411814,"[0, 0, 0, 0, 0, 1, 0, 1, 0, 1]"
19947,1,1,2,0.3868641105189732,"[0, 0, 1, 1, 0, 1, 0, 1, 1, 0]"
19948,1,1,2,0.6199816820819051,"[0, 1, 1, 0, 1, 0, 0, 1, 1, 0]"
19949,1,1,2,0.15813803907235702,"[0, 1, 0, 0, 1, 0, 1, 0, 1, 0]"
19950,1,1,2,0.22181128360543056,"[1, 0, 0, 0, 0, 0, 0, 1, 0, 0]"
19951,1,1,2,0.4407752228876959,"[0, 1, 1, 0, 1, 1, 0, 1, 1, 1]"
19952,1,1,2,0.2633103346645477,"[1, 1, 0, 1, 0, 0, 1, 0, 1, 0]"
19953,1,1,2,0.5543149808261838,"[0, 0, 1, 1, 0, 0, 1, 1, 1, 1]"
19954,1,1,2,0.47758055078375594,"[0, 0, 0, 0, 1, 1, 0, 0, 1, 0]"
19955,1,1,2,0.7256939832998826,"[1, 1, 0, 0, 0, 0, 1, 1, 1, 0]"
19956,1,1,2,0.5332940127238767,"[1, 1, 0, 1, 0, 1, 0, 0, 1, 1]"
19957,1,1,2,0.3823342781065998,"[0, 1, 1, 1, 1, 0, 0, 0, 0, 0]"
19958,1,1,2,0.20904630602095997,"[1, 0, 1, 1, 0, 0, 1, 0, 1, 0]"
19959,1,1,2,0.2201127253597469,"[0, 1, 0, 0, 1, 1, 0, 1, 0, 0]"
19960,1,1,2,0.6025400252122816,"[1, 1, 0, 1, 0, 1, 1, 1, 0, 1]"
19961,1,1,2,0.2649529822213782,"[0, 1, 0, 1, 1, 0, 1, 1, 0, 1]"
19962,1,1,2,0.9089456553481671,"[0, 1, 1, 0, 1, 1, 1, 0, 1, 0]"
19963,1,1,2,0.49830665701838206,"[1, 0, 0, 0, 1, 0, 0, 1, 0, 0]"
19964,1,1,2,0.859958140787812,"[0, 1, 0, 1, 0, 1, 1, 1, 1, 1]"
19965,1,1,2,0.6007535610530965,"[0, 0, 1, 1, 1, 1, 0, 0, 1, 1]"
19966,1,1,2,0.608032652787389,"[1, 1, 1, 1, 0, 1, 0, 0, 0, 1]"
19967,1,1,2,0.4058401568473773,"[0, 1, 1, 0, 1, 1, 0, 1, 1, 0]"
19968,1,1,2,0.7546364807155516,"[1, 1, 0, 1, 1, 0, 1, 1, 1, 1]"
19969,1,1,2,0.38472727212039126,"[1, 1, 0, 1, 1, 1, 0, 1, 1, 1]"
19970,1,1,2,0.40450529089278353,"[1, 1, 1, 1, 1, 0, 0, 0, 1, 0]"
19971,1,1,2,0.5151787589396153,"[1, 1, 1, 0, 1, 1, 0, 0, 0, 0]"
19972,1,1,2,0.05466431897720814,"[1, 0, 1, 1, 0, 1, 0, 0, 1, 0]"
19973,1,1,2,0.05424163503042756,"[1, 0, 0, 0, 0, 1, 0, 0, 0, 1]"
19974,1,1,2,0.31754645339275056,"[0, 1, 1, 0, 1, 1, 0, 1, 0, 0]"
19975,1,1,2,0.6876468035963267,"[0, 1, 1, 1, 1, 0, 1, 1, 0, 1]"
19976,1,1,2,0.24376357157150141,"[1, 0, 0, 1, 1, 0, 1, 1, 0, 0]"
19977,1,1,2,0.7043105122796671,"[0, 0, 1, 0, 1, 1, 0, 1, 0, 0]"
19978,1,1,2,0.8828251009115301,"[1, 0, 0, 1, 0, 0, 1, 0, 1, 1]"
19979,1,1,2,0.002910122047691921,"[0, 1, 1, 0, 0, 1, 0, 1, 1, 1]"
19980,1,1,2,0.9837645806503388,"[0, 0, 0, 0, 0, 1, 0, 0, 1, 1]"
19981,1,1,2,0.6003988946181377,"[0, 1, 0, 1, 0, 0, 1, 0, 0, 1]"
19982,1,1,2,0.8322138782706191,"[0, 1, 0, 0, 1, 1, 1, 0, 0, 0]"
19983,1,1,2,0.3524068929960561,"[1, 0, 1, 0, 1, 1, 0, 1, 0, 0]"
19984,1,1,2,0.10795016200996232,"[0, 0, 0, 0, 1, 1, 0, 1, 0, 1]"
19985,1,1,2,0.13063867681849672,"[1, 1, 1, 1, 0, 1, 0, 0, 0, 0]"
19986,1,1,2,0.2294233772613401,"[1, 1, 1, 0, 1, 0, 0, 0, 1, 1]"
19987,1,1,2,0.28108188096768594,"[0, 1, 1, 1, 1, 1, 0, 0, 0, 1]"
19988,1,1,2,0.42827116212225647,"[0, 1, 1, 0, 1, 0, 1, 1, 0, 0]"
19989,1,1,2,0.23947136960212645,"[1, 1, 0, 1, 1, 0, 0, 0, 1, 0]"
19990,1,1,2,0.1178375354827228,"[1, 0, 1, 1, 1, 0, 1, 0, 1, 1]"
19991,1,1,2,0.9801683900082371,"[1, 1, 0, 1, 1, 1, 0, 0, 0, 0]"
19992,1,1,2,0.38455149712922565,"[1, 1, 1, 1, 0, 0, 0, 1, 0, 0]"
19993,1,1,2,0.615862748370237,"[0, 1, 1, 1, 0, 1, 1, 1, 1, 1]"
19994,1,1,2,0.7715546995587488,"[0, 1, 0, 0, 0, 0, 0, 0, 0, 0]"
19995,1,1,2,0.822832020309588,"[0, 1, 0, 1, 1, 1, 1, 0, 0, 0]"
19996,1,1,2,0.3658965389018157,"[0, 1, 0, 1, 0, 1, 0, 1, 0, 0]"
19997,1,1,2,0.33284036124456784,"[1, 1, 0, 1, 1, 1, 0, 1, 0, 0]"
19998,1,1,2,0.1797225164621279,"[1, 1, 0, 0, 1, 0, 0, 0, 1, 0]"
19999,1,1,2,0.5882991253062977,"[0, 1, 1, 1, 1, 1, 1, 1, 1, 1]"
